納品数,販売数,時系列インデックス,タイトル,累積販売数,消化率
66,1778,0,一番くじディズニーサプライズパーティー,1778,0.0020408608346409152
430717,26211,1,一番くじディズニーサプライズパーティー,27989,0.032126914454873215
440220,54614,2,一番くじディズニーサプライズパーティー,82603,0.09481508859608748
0,52526,3,一番くじディズニーサプライズパーティー,135129,0.15510657127344896
0,43324,4,一番くじディズニーサプライズパーティー,178453,0.20483562346691522
0,33439,5,一番くじディズニーサプライズパーティー,211892,0.24321826995148077
0,30467,6,一番くじディズニーサプライズパーティー,242359,0.2781895337585701
66,28382,7,一番くじディズニーサプライズパーティー,270741,0.31076754962402475
0,28975,8,一番くじディズニーサプライズパーティー,299716,0.34402623504793955
0,33564,9,一番くじディズニーサプライズパーティー,333280,0.3825523616249293
66,27721,10,一番くじディズニーサプライズパーティー,361001,0.4143716547616451
0,17611,11,一番くじディズニーサプライズパーティー,378612,0.43458627802309685
0,16957,12,一番くじディズニーサプライズパーティー,395569,0.4540502134409855
0,15704,13,一番くじディズニーサプライズパーティー,411273,0.4720759044124146
0,13112,14,一番くじディズニーサプライズパーティー,424385,0.4871263921873368
0,15973,15,一番くじディズニーサプライズパーティー,440358,0.5054608523176626
66,19166,16,一番くじディズニーサプライズパーティー,459524,0.5274603679288706
0,14625,17,一番くじディズニーサプライズパーティー,474149,0.5442475387424945
0,11859,18,一番くじディズニーサプライズパーティー,486008,0.5578597820709572
0,11010,19,一番くじディズニーサプライズパーティー,497018,0.5704975086116751
0,11813,20,一番くじディズニーサプライズパーティー,508831,0.5840569512661258
0,11638,21,一番くじディズニーサプライズパーティー,520469,0.5974155217911825
0,12175,22,一番くじディズニーサプライズパーティー,532644,0.6113904827932934
0,14346,23,一番くじディズニーサプライズパーティー,546990,0.6278574060406267
0,11319,24,一番くじディズニーサプライズパーティー,558309,0.6408498153698171
0,8259,25,一番くじディズニーサプライズパーティー,566568,0.6503298320364646
0,8851,26,一番くじディズニーサプライズパーティー,575419,0.6604893704208329
0,8746,27,一番くじディズニーサプライズパーティー,584165,0.6705283855275648
0,9009,28,一番くじディズニーサプライズパーティー,593174,0.6808692827487571
0,10685,29,一番くじディズニーサプライズパーティー,603859,0.6931339610491724
0,9311,30,一番くじディズニーサプライズパーティー,613170,0.7038215061736615
0,8362,31,一番くじディズニーサプライズパーティー,621532,0.7134197504364664
0,5410,32,一番くじディズニーサプライズパーティー,626942,0.719629568836583
0,5119,33,一番くじディズニーサプライズパーティー,632061,0.7255053655815363
0,4967,34,一番くじディズニーサプライズパーティー,637028,0.7312066905341018
0,4669,35,一番くじディズニーサプライズパーティー,641697,0.7365659589463281
0,5352,36,一番くじディズニーサプライズパーティー,647049,0.74270920258356
0,6794,37,一番くじディズニーサプライズパーティー,653843,0.7505076325669966
0,6065,38,一番くじディズニーサプライズパーティー,659908,0.7574692866514157
0,3866,39,一番くじディズニーサプライズパーティー,663774,0.7619068389499094
0,3805,40,一番くじディズニーサプライズパーティー,667579,0.7662743729633001
0,3828,41,一番くじディズニーサプライズパーティー,671407,0.7706683073136968
0,3166,42,一番くじディズニーサプライズパーティー,674573,0.7743023710946154
0,3474,43,一番くじディズニーサプライズパーティー,678047,0.7782899698232669
0,4440,44,一番くじディズニーサプライズパーティー,682487,0.7833863827061723
0,4422,45,一番くじディズニーサプライズパーティー,686909,0.7884621344557685
0,2661,46,一番くじディズニーサプライズパーティー,689570,0.7915165386632935
0,2647,47,一番くじディズニーサプライズパーティー,692217,0.794554873100467
0,2760,48,一番くじディズニーサプライズパーティー,694977,0.797722913541192
0,3435,49,一番くじディズニーサプライズパーティー,698412,0.8016657464810073
0,3358,50,一番くじディズニーサプライズパーティー,701770,0.8055201956838892
0,4073,51,一番くじディズニーサプライズパーティー,705843,0.8101953510154373
0,3705,52,一番くじディズニーサプライズパーティー,709548,0.8144481009548887
0,2581,53,一番くじディズニーサプライズパーティー,712129,0.8174106779032623
0,2467,54,一番くじディズニーサプライズパーティー,714596,0.820242401007345
0,2364,55,一番くじディズニーサプライズパーティー,716960,0.8229558965152703
0,2190,56,一番くじディズニーサプライズパーティー,719150,0.8254696677345411
0,2330,57,一番くじディズニーサプライズパーティー,721480,0.8281441366573271
0,2982,58,一番くじディズニーサプライズパーティー,724462,0.8315669977421972
0,2711,59,一番くじディズニーサプライズパーティー,727173,0.834678793986692
0,25,0,一番くじプレミアムＴｏＬＯＶＥる＊,25,0.00125
5200,626,1,一番くじプレミアムＴｏＬＯＶＥる＊,651,0.03255
4800,493,2,一番くじプレミアムＴｏＬＯＶＥる＊,1144,0.0572
0,581,3,一番くじプレミアムＴｏＬＯＶＥる＊,1725,0.08625
0,343,4,一番くじプレミアムＴｏＬＯＶＥる＊,2068,0.1034
0,390,5,一番くじプレミアムＴｏＬＯＶＥる＊,2458,0.1229
4600,388,6,一番くじプレミアムＴｏＬＯＶＥる＊,2846,0.1423
1800,385,7,一番くじプレミアムＴｏＬＯＶＥる＊,3231,0.16155
3600,523,8,一番くじプレミアムＴｏＬＯＶＥる＊,3754,0.1877
0,360,9,一番くじプレミアムＴｏＬＯＶＥる＊,4114,0.2057
0,379,10,一番くじプレミアムＴｏＬＯＶＥる＊,4493,0.22465
0,340,11,一番くじプレミアムＴｏＬＯＶＥる＊,4833,0.24165
0,379,12,一番くじプレミアムＴｏＬＯＶＥる＊,5212,0.2606
0,387,13,一番くじプレミアムＴｏＬＯＶＥる＊,5599,0.27995
0,402,14,一番くじプレミアムＴｏＬＯＶＥる＊,6001,0.30005
0,340,15,一番くじプレミアムＴｏＬＯＶＥる＊,6341,0.31705
0,342,16,一番くじプレミアムＴｏＬＯＶＥる＊,6683,0.33415
0,273,17,一番くじプレミアムＴｏＬＯＶＥる＊,6956,0.3478
0,337,18,一番くじプレミアムＴｏＬＯＶＥる＊,7293,0.36465
0,295,19,一番くじプレミアムＴｏＬＯＶＥる＊,7588,0.3794
0,285,20,一番くじプレミアムＴｏＬＯＶＥる＊,7873,0.39365
0,228,21,一番くじプレミアムＴｏＬＯＶＥる＊,8101,0.40505
0,277,22,一番くじプレミアムＴｏＬＯＶＥる＊,8378,0.4189
0,219,23,一番くじプレミアムＴｏＬＯＶＥる＊,8597,0.42985
0,222,24,一番くじプレミアムＴｏＬＯＶＥる＊,8819,0.44095
0,185,25,一番くじプレミアムＴｏＬＯＶＥる＊,9004,0.4502
0,215,26,一番くじプレミアムＴｏＬＯＶＥる＊,9219,0.46095
0,173,27,一番くじプレミアムＴｏＬＯＶＥる＊,9392,0.4696
0,128,28,一番くじプレミアムＴｏＬＯＶＥる＊,9520,0.476
0,155,29,一番くじプレミアムＴｏＬＯＶＥる＊,9675,0.48375
0,160,30,一番くじプレミアムＴｏＬＯＶＥる＊,9835,0.49175
0,155,31,一番くじプレミアムＴｏＬＯＶＥる＊,9990,0.4995
0,140,32,一番くじプレミアムＴｏＬＯＶＥる＊,10130,0.5065
0,145,33,一番くじプレミアムＴｏＬＯＶＥる＊,10275,0.51375
0,165,34,一番くじプレミアムＴｏＬＯＶＥる＊,10440,0.522
0,91,35,一番くじプレミアムＴｏＬＯＶＥる＊,10531,0.52655
0,152,36,一番くじプレミアムＴｏＬＯＶＥる＊,10683,0.53415
0,127,37,一番くじプレミアムＴｏＬＯＶＥる＊,10810,0.5405
0,70,38,一番くじプレミアムＴｏＬＯＶＥる＊,10880,0.544
0,62,39,一番くじプレミアムＴｏＬＯＶＥる＊,10942,0.5471
0,75,40,一番くじプレミアムＴｏＬＯＶＥる＊,11017,0.55085
0,61,41,一番くじプレミアムＴｏＬＯＶＥる＊,11078,0.5539
0,46,42,一番くじプレミアムＴｏＬＯＶＥる＊,11124,0.5562
0,26,43,一番くじプレミアムＴｏＬＯＶＥる＊,11150,0.5575
0,33,44,一番くじプレミアムＴｏＬＯＶＥる＊,11183,0.55915
0,48,45,一番くじプレミアムＴｏＬＯＶＥる＊,11231,0.56155
0,38,46,一番くじプレミアムＴｏＬＯＶＥる＊,11269,0.56345
0,38,47,一番くじプレミアムＴｏＬＯＶＥる＊,11307,0.56535
0,48,48,一番くじプレミアムＴｏＬＯＶＥる＊,11355,0.56775
0,24,49,一番くじプレミアムＴｏＬＯＶＥる＊,11379,0.56895
0,34,50,一番くじプレミアムＴｏＬＯＶＥる＊,11413,0.57065
0,14,51,一番くじプレミアムＴｏＬＯＶＥる＊,11427,0.57135
0,50,52,一番くじプレミアムＴｏＬＯＶＥる＊,11477,0.57385
0,48,53,一番くじプレミアムＴｏＬＯＶＥる＊,11525,0.57625
0,32,54,一番くじプレミアムＴｏＬＯＶＥる＊,11557,0.57785
0,22,55,一番くじプレミアムＴｏＬＯＶＥる＊,11579,0.57895
0,20,56,一番くじプレミアムＴｏＬＯＶＥる＊,11599,0.57995
0,27,57,一番くじプレミアムＴｏＬＯＶＥる＊,11626,0.5813
0,25,58,一番くじプレミアムＴｏＬＯＶＥる＊,11651,0.58255
0,20,59,一番くじプレミアムＴｏＬＯＶＥる＊,11671,0.58355
0,1443,0,一番くじタヌキとキツネお山のパン屋さん,1443,0.007239614689945816
103752,19926,1,一番くじタヌキとキツネお山のパン屋さん,21369,0.10720951234196267
95568,22514,2,一番くじタヌキとキツネお山のパン屋さん,43883,0.2201635560907084
0,15724,3,一番くじタヌキとキツネお山のパン屋さん,59607,0.299051776038531
0,13275,4,一番くじタヌキとキツネお山のパン屋さん,72882,0.3656532209512342
0,11101,5,一番くじタヌキとキツネお山のパン屋さん,83983,0.4213475817780454
0,9813,6,一番くじタヌキとキツネお山のパン屋さん,93796,0.4705799719044752
0,9875,7,一番くじタヌキとキツネお山のパン屋さん,103671,0.5201234196267309
0,10834,8,一番くじタヌキとキツネお山のパン屋さん,114505,0.5744782259682922
0,7877,9,一番くじタヌキとキツネお山のパン屋さん,122382,0.6139975918121614
0,4603,10,一番くじタヌキとキツネお山のパン屋さん,126985,0.637091109773229
0,4616,11,一番くじタヌキとキツネお山のパン屋さん,131601,0.66024984948826
0,4004,12,一番くじタヌキとキツネお山のパン屋さん,135605,0.6803381497090106
0,3717,13,一番くじタヌキとキツネお山のパン屋さん,139322,0.6989865542845676
0,3688,14,一番くじタヌキとキツネお山のパン屋さん,143010,0.7174894641782059
0,4274,15,一番くじタヌキとキツネお山のパン屋さん,147284,0.7389323700581979
0,3417,16,一番くじタヌキとキツネお山のパン屋さん,150701,0.7560756572345977
0,2359,17,一番くじタヌキとキツネお山のパン屋さん,153060,0.7679108970499698
0,2094,18,一番くじタヌキとキツネお山のパン屋さん,155154,0.7784166164960867
0,2072,19,一番くじタヌキとキツネお山のパン屋さん,157226,0.7888119606662654
0,1722,20,一番くじタヌキとキツネお山のパン屋さん,158948,0.7974513345374272
0,1856,21,一番くじタヌキとキツネお山のパン屋さん,160804,0.8067629941802127
0,2426,22,一番くじタヌキとキツネお山のパン屋さん,163230,0.8189343768813967
0,2070,23,一番くじタヌキとキツネお山のパン屋さん,165300,0.829319686935581
0,1421,24,一番くじタヌキとキツネお山のパン屋さん,166721,0.8364489263495886
0,1047,25,一番くじタヌキとキツネお山のパン屋さん,167768,0.841701786072647
0,1325,26,一番くじタヌキとキツネお山のパン屋さん,169093,0.8483493879189243
0,1437,27,一番くじタヌキとキツネお山のパン屋さん,170530,0.855558900260887
0,1085,28,一番くじタヌキとキツネお山のパン屋さん,171615,0.8610024081878387
0,1157,29,一番くじタヌキとキツネお山のパン屋さん,172772,0.866807144290588
0,1165,30,一番くじタヌキとキツネお山のパン屋さん,173937,0.8726520168573149
0,967,31,一番くじタヌキとキツネお山のパン屋さん,174904,0.8775035119405981
0,974,32,一番くじタヌキとキツネお山のパン屋さん,175878,0.8823901264298615
0,853,33,一番くじタヌキとキツネお山のパン屋さん,176731,0.886669676901465
0,930,34,一番くじタヌキとキツネお山のパン屋さん,177661,0.8913355408388521
0,781,35,一番くじタヌキとキツネお山のパン屋さん,178442,0.8952538631346578
0,1092,36,一番くじタヌキとキツネお山のパン屋さん,179534,0.9007324904675899
0,747,37,一番くじタヌキとキツネお山のパン屋さん,180281,0.904480232791491
0,546,38,一番くじタヌキとキツネお山のパン屋さん,180827,0.9072195464579571
0,504,39,一番くじタヌキとキツネお山のパン屋さん,181331,0.9097481436885411
0,455,40,一番くじタヌキとキツネお山のパン屋さん,181786,0.9120309050772627
0,442,41,一番くじタヌキとキツネお山のパン屋さん,182228,0.9142484447120208
0,520,42,一番くじタヌキとキツネお山のパン屋さん,182748,0.9168573148705599
0,605,43,一番くじタヌキとキツネお山のパン屋さん,183353,0.9198926349588601
0,417,44,一番くじタヌキとキツネお山のパン屋さん,183770,0.9219847481436886
0,313,45,一番くじタヌキとキツネお山のパン屋さん,184083,0.9235550872968091
0,277,46,一番くじタヌキとキツネお山のパン屋さん,184360,0.9249448123620309
0,323,47,一番くじタヌキとキツネお山のパン屋さん,184683,0.9265653220951234
0,250,48,一番くじタヌキとキツネお山のパン屋さん,184933,0.927819586594421
0,281,49,一番くじタヌキとキツネお山のパン屋さん,185214,0.9292293798916316
0,310,50,一番くじタヌキとキツネお山のパン屋さん,185524,0.9307846678707606
0,300,51,一番くじタヌキとキツネお山のパン屋さん,185824,0.9322897852699177
0,286,52,一番くじタヌキとキツネお山のパン屋さん,186110,0.9337246638571142
0,202,53,一番くじタヌキとキツネお山のパン屋さん,186312,0.9347381095725467
0,198,54,一番くじタヌキとキツネお山のパン屋さん,186510,0.9357314870559904
0,170,55,一番くじタヌキとキツネお山のパン屋さん,186680,0.9365843869155127
0,266,56,一番くじタヌキとキツネお山のパン屋さん,186946,0.9379189243427654
0,239,57,一番くじタヌキとキツネお山のパン屋さん,187185,0.9391180012040939
0,311,58,一番くじタヌキとキツネお山のパン屋さん,187496,0.9406783062412202
0,162,59,一番くじタヌキとキツネお山のパン屋さん,187658,0.941491069636765
3710,35826,0,一番くじツイステッドワンダーランド第二弾,35826,0.058020632581339986
304850,296399,1,一番くじツイステッドワンダーランド第二弾,332225,0.5380423340405202
308770,178199,2,一番くじツイステッドワンダーランド第二弾,510424,0.8266377313877598
70,46437,3,一番くじツイステッドワンダーランド第二弾,556861,0.9018430045184381
70,19180,4,一番くじツイステッドワンダーランド第二弾,576041,0.9329052423599528
0,9688,5,一番くじツイステッドワンダーランド第二弾,585729,0.9485950734448637
0,5696,6,一番くじツイステッドワンダーランド第二弾,591425,0.9578198131083292
0,4603,7,一番くじツイステッドワンダーランド第二弾,596028,0.9652744262879168
0,3479,8,一番くじツイステッドワンダーランド第二弾,599507,0.970908708115374
0,3196,9,一番くじツイステッドワンダーランド第二弾,602703,0.9760846680810403
0,1464,10,一番くじツイステッドワンダーランド第二弾,604167,0.9784556334720715
0,1233,11,一番くじツイステッドワンダーランド第二弾,605400,0.980452491619026
0,990,12,一番くじツイステッドワンダーランド第二弾,606390,0.9820558083793545
0,1065,13,一番くじツイステッドワンダーランド第二弾,607455,0.9837805885306169
0,661,14,一番くじツイステッドワンダーランド第二弾,608116,0.984851085882715
0,822,15,一番くじツイステッドワンダーランド第二弾,608938,0.9861823246473513
0,525,16,一番くじツイステッドワンダーランド第二弾,609463,0.9870325683838891
0,402,17,一番くじツイステッドワンダーランド第二弾,609865,0.9876836121592952
0,272,18,一番くじツイステッドワンダーランド第二弾,610137,0.9881241193904158
0,229,19,一番くじツイステッドワンダーランド第二弾,610366,0.9884949876107342
0,356,20,一番くじツイステッドワンダーランド第二弾,610722,0.9890715338397007
0,434,21,一番くじツイステッドワンダーランド第二弾,611156,0.9897744019952386
0,407,22,一番くじツイステッドワンダーランド第二弾,611563,0.9904335433300403
0,466,23,一番くじツイステッドワンダーランド第二弾,612029,0.99118823586571
0,335,24,一番くじツイステッドワンダーランド第二弾,612364,0.9917307723452151
0,109,25,一番くじツイステッドワンダーランド第二弾,612473,0.9919072991400392
0,122,26,一番くじツイステッドワンダーランド第二弾,612595,0.9921048795892918
0,172,27,一番くじツイステッドワンダーランド第二弾,612767,0.9923834356325003
0,278,28,一番くじツイステッドワンダーランド第二弾,613045,0.9928336599348956
0,389,29,一番くじツイステッドワンダーランド第二弾,613434,0.9934636500558731
0,70,30,一番くじツイステッドワンダーランド第二弾,613504,0.9935770158874115
0,71,31,一番くじツイステッドワンダーランド第二弾,613575,0.993692001230829
0,56,32,一番くじツイステッドワンダーランド第二弾,613631,0.9937826938960598
0,41,33,一番くじツイステッドワンダーランド第二弾,613672,0.9938490938831036
0,92,34,一番くじツイステッドワンダーランド第二弾,613764,0.9939980889759826
0,109,35,一番くじツイステッドワンダーランド第二弾,613873,0.9941746157708067
0,32,36,一番くじツイステッドワンダーランド第二弾,613905,0.9942264401509385
0,53,37,一番くじツイステッドワンダーランド第二弾,613958,0.9943122742805318
0,54,38,一番くじツイステッドワンダーランド第二弾,614012,0.9943997279220043
0,137,39,一番くじツイステッドワンダーランド第二弾,614149,0.9946216010494437
0,61,40,一番くじツイステッドワンダーランド第二弾,614210,0.99472039127407
0,11,41,一番くじツイステッドワンダーランド第二弾,614221,0.9947382059047403
0,18,42,一番くじツイステッドワンダーランド第二弾,614239,0.9947673571185645
0,31,43,一番くじツイステッドワンダーランド第二弾,614270,0.9948175619868171
0,88,44,一番くじツイステッドワンダーランド第二弾,614358,0.9949600790321798
0,80,45,一番くじツイステッドワンダーランド第二弾,614438,0.9950896399825093
0,11,46,一番くじツイステッドワンダーランド第二弾,614449,0.9951074546131796
0,22,47,一番くじツイステッドワンダーランド第二弾,614471,0.9951430838745202
0,2,48,一番くじツイステッドワンダーランド第二弾,614473,0.9951463228982784
0,7,49,一番くじツイステッドワンダーランド第二弾,614480,0.9951576594814323
0,53,50,一番くじツイステッドワンダーランド第二弾,614533,0.9952434936110256
0,30,51,一番くじツイステッドワンダーランド第二弾,614563,0.9952920789673992
0,4,52,一番くじツイステッドワンダーランド第二弾,614567,0.9952985570149157
0,11,53,一番くじツイステッドワンダーランド第二弾,614578,0.9953163716455861
0,92,54,一番くじツイステッドワンダーランド第二弾,614670,0.995465366738465
0,79,55,一番くじツイステッドワンダーランド第二弾,614749,0.9955933081769155
0,9,56,一番くじツイステッドワンダーランド第二弾,614758,0.9956078837838276
0,73,57,一番くじツイステッドワンダーランド第二弾,614831,0.9957261081510033
0,36,58,一番くじツイステッドワンダーランド第二弾,614867,0.9957844105786516
0,69,59,一番くじツイステッドワンダーランド第二弾,614936,0.9958961568983109
0,5885,0,一番くじツイステッドワンダーランド第二弾,5885,0.01112053832097823
256691,62616,1,一番くじツイステッドワンダーランド第二弾,68501,0.12944231019971617
272440,75459,2,一番くじツイステッドワンダーランド第二弾,143960,0.27203274370229835
0,55233,3,一番くじツイステッドワンダーランド第二弾,199193,0.37640329477835455
0,47888,4,一番くじツイステッドワンダーランド第二弾,247081,0.46689443141641834
0,33910,5,一番くじツイステッドワンダーランド第二弾,280991,0.5309721636958358
0,24022,6,一番くじツイステッドワンダーランド第二弾,305013,0.5763651240265986
0,19368,7,一番くじツイステッドワンダーランド第二弾,324381,0.6129636943240848
0,13824,8,一番くじツイステッドワンダーランド第二弾,338205,0.6390860939416214
0,15101,9,一番くじツイステッドワンダーランド第二弾,353306,0.6676215653409574
0,13666,10,一番くじツイステッドワンダーランド第二弾,366972,0.6934454016526802
0,13770,11,一番くじツイステッドワンダーランド第二弾,380742,0.7194657606467108
0,10858,12,一番くじツイステッドワンダーランド第二弾,391600,0.7399834845361214
0,7978,13,一番くじツイステッドワンダーランド第二弾,399578,0.7550590418385453
0,5170,14,一番くじツイステッドワンダーランド第二弾,404748,0.764828486718657
0,5627,15,一番くじツイステッドワンダーランド第二弾,410375,0.7754614976162176
0,5147,16,一番くじツイステッドワンダーランド第二弾,415522,0.7851874807492805
0,4253,17,一番くじツイステッドワンダーランド第二弾,419775,0.7932241246709663
0,5626,18,一番くじツイステッドワンダーランド第二弾,425401,0.8038552459273508
0,4672,19,一番くじツイステッドワンダーランド第二弾,430073,0.8126836495017961
0,3086,20,一番くじツイステッドワンダーランド第二弾,433159,0.8185150821710465
0,3267,21,一番くじツイステッドワンダーランド第二弾,436426,0.8246885398931597
0,3353,22,一番くじツイステッドワンダーランド第二弾,439779,0.831024506756412
0,3305,23,一番くじツイステッドワンダーランド第二弾,443084,0.8372697708432146
0,3007,24,一番くじツイステッドワンダーランド第二弾,446091,0.8429519218595581
0,2667,25,一番くじツイステッドワンダーランド第二弾,448758,0.847991594876049
0,3322,26,一番くじツイステッドワンダーランド第二弾,452080,0.8542689828628441
0,2588,27,一番くじツイステッドワンダーランド第二弾,454668,0.8591593742264282
0,2421,28,一番くじツイステッドワンダーランド第二弾,457089,0.863734195513614
0,2267,29,一番くじツイステッドワンダーランド第二弾,459356,0.86801801205969
0,2572,30,一番くじツイステッドワンダーランド第二弾,461928,0.8728781691644574
0,2629,31,一番くじツイステッドワンダーランド第二弾,464557,0.8778460358162589
0,5882,32,一番くじツイステッドワンダーランド第二弾,470439,0.888960905213709
70,2246,33,一番くじツイステッドワンダーランド第二弾,472685,0.8932050392950882
0,2218,34,一番くじツイステッドワンダーランド第二弾,474903,0.8973962634235385
0,1930,35,一番くじツイステッドワンダーランド第二弾,476833,0.9010432708932901
0,1989,36,一番くじツイステッドワンダーランド第二弾,478822,0.9048017671924278
0,1621,37,一番くじツイステッドワンダーランド第二弾,480443,0.9078648755387839
0,1759,38,一番くじツイステッドワンダーランド第二弾,482202,0.9111887543674332
0,1733,39,一番くじツイステッドワンダーランド第二弾,483935,0.9144635025255055
0,1214,40,一番くじツイステッドワンダーランド第二弾,485149,0.9167575269132144
0,1164,41,一番くじツイステッドワンダーランド第二弾,486313,0.9189570692421216
0,920,42,一番くじツイステッドワンダーランド第二弾,487233,0.9206955391240758
0,940,43,一番くじツイステッドワンダーランド第二弾,488173,0.9224718018295506
0,849,44,一番くじツイステッドワンダーランド第二弾,489022,0.924076107188006
0,839,45,一番くじツイステッドワンダーランド第二弾,489861,0.9256615161347012
0,744,46,一番くじツイステッドワンダーランド第二弾,490605,0.9270674091696728
0,635,47,一番くじツイステッドワンダーランド第二弾,491240,0.9282673313164563
0,593,48,一番くじツイステッドワンダーランド第二弾,491833,0.9293878885338464
0,475,49,一番くじツイステッドワンダーランド第二弾,492308,0.9302854680924639
0,560,50,一番くじツイステッドワンダーランド第二弾,492868,0.9313436671510447
0,459,51,一番くじツイステッドワンダーランド第二弾,493327,0.9322110124508457
0,494,52,一番くじツイステッドワンダーランド第二弾,493821,0.933144495191808
0,675,53,一番くじツイステッドワンダーランド第二弾,494496,0.9344200029856331
0,451,54,一番くじツイステッドワンダーランド第二弾,494947,0.9352722311560258
0,431,55,一番くじツイステッドワンダーランド第二弾,495378,0.9360866665028977
0,357,56,一番くじツイステッドワンダーランド第二弾,495735,0.936761268402743
0,285,57,一番くじツイステッドワンダーランド第二弾,496020,0.9372998161379136
0,432,58,一番くじツイステッドワンダーランド第二弾,496452,0.9381161411259616
0,426,59,一番くじツイステッドワンダーランド第二弾,496878,0.9389211282669534
0,0,0,一番くじマクロスＦランカ・リー●,0,0.0
360,14,1,一番くじマクロスＦランカ・リー●,14,0.021021021021021023
306,14,2,一番くじマクロスＦランカ・リー●,28,0.042042042042042045
0,9,3,一番くじマクロスＦランカ・リー●,37,0.05555555555555555
0,4,4,一番くじマクロスＦランカ・リー●,41,0.06156156156156156
0,10,5,一番くじマクロスＦランカ・リー●,51,0.07657657657657657
0,20,6,一番くじマクロスＦランカ・リー●,71,0.1066066066066066
0,24,7,一番くじマクロスＦランカ・リー●,95,0.14264264264264265
0,9,8,一番くじマクロスＦランカ・リー●,104,0.15615615615615616
0,13,9,一番くじマクロスＦランカ・リー●,117,0.17567567567567569
0,4,10,一番くじマクロスＦランカ・リー●,121,0.1816816816816817
0,1,11,一番くじマクロスＦランカ・リー●,122,0.1831831831831832
0,11,12,一番くじマクロスＦランカ・リー●,133,0.1996996996996997
0,1,13,一番くじマクロスＦランカ・リー●,134,0.2012012012012012
0,5,14,一番くじマクロスＦランカ・リー●,139,0.2087087087087087
0,3,15,一番くじマクロスＦランカ・リー●,142,0.2132132132132132
0,2,16,一番くじマクロスＦランカ・リー●,144,0.21621621621621623
0,4,17,一番くじマクロスＦランカ・リー●,148,0.2222222222222222
0,3,18,一番くじマクロスＦランカ・リー●,151,0.22672672672672672
0,1,19,一番くじマクロスＦランカ・リー●,152,0.22822822822822822
0,0,20,一番くじマクロスＦランカ・リー●,152,0.22822822822822822
0,4,21,一番くじマクロスＦランカ・リー●,156,0.23423423423423423
0,2,22,一番くじマクロスＦランカ・リー●,158,0.23723723723723725
0,5,23,一番くじマクロスＦランカ・リー●,163,0.24474474474474475
0,6,24,一番くじマクロスＦランカ・リー●,169,0.25375375375375375
0,0,25,一番くじマクロスＦランカ・リー●,169,0.25375375375375375
0,4,26,一番くじマクロスＦランカ・リー●,173,0.25975975975975973
0,9,27,一番くじマクロスＦランカ・リー●,182,0.2732732732732733
0,0,28,一番くじマクロスＦランカ・リー●,182,0.2732732732732733
0,1,29,一番くじマクロスＦランカ・リー●,183,0.2747747747747748
0,3,30,一番くじマクロスＦランカ・リー●,186,0.27927927927927926
0,6,31,一番くじマクロスＦランカ・リー●,192,0.2882882882882883
0,3,32,一番くじマクロスＦランカ・リー●,195,0.2927927927927928
0,1,33,一番くじマクロスＦランカ・リー●,196,0.29429429429429427
0,1,34,一番くじマクロスＦランカ・リー●,197,0.2957957957957958
0,1,35,一番くじマクロスＦランカ・リー●,198,0.2972972972972973
0,8,36,一番くじマクロスＦランカ・リー●,206,0.30930930930930933
0,2,37,一番くじマクロスＦランカ・リー●,208,0.3123123123123123
0,1,38,一番くじマクロスＦランカ・リー●,209,0.3138138138138138
0,5,39,一番くじマクロスＦランカ・リー●,214,0.3213213213213213
0,2,40,一番くじマクロスＦランカ・リー●,216,0.32432432432432434
0,1,41,一番くじマクロスＦランカ・リー●,217,0.3258258258258258
0,2,42,一番くじマクロスＦランカ・リー●,219,0.32882882882882886
0,0,43,一番くじマクロスＦランカ・リー●,219,0.32882882882882886
0,3,44,一番くじマクロスＦランカ・リー●,222,0.3333333333333333
0,0,45,一番くじマクロスＦランカ・リー●,222,0.3333333333333333
0,1,46,一番くじマクロスＦランカ・リー●,223,0.33483483483483484
0,1,47,一番くじマクロスＦランカ・リー●,224,0.33633633633633636
0,3,48,一番くじマクロスＦランカ・リー●,227,0.3408408408408408
0,6,49,一番くじマクロスＦランカ・リー●,233,0.34984984984984985
0,1,50,一番くじマクロスＦランカ・リー●,234,0.35135135135135137
0,1,51,一番くじマクロスＦランカ・リー●,235,0.35285285285285284
0,14,52,一番くじマクロスＦランカ・リー●,249,0.3738738738738739
0,1,53,一番くじマクロスＦランカ・リー●,250,0.37537537537537535
0,1,54,一番くじマクロスＦランカ・リー●,251,0.3768768768768769
0,10,55,一番くじマクロスＦランカ・リー●,261,0.3918918918918919
0,9,56,一番くじマクロスＦランカ・リー●,270,0.40540540540540543
0,1,57,一番くじマクロスＦランカ・リー●,271,0.4069069069069069
0,0,58,一番くじマクロスＦランカ・リー●,271,0.4069069069069069
0,2,59,一番くじマクロスＦランカ・リー●,273,0.4099099099099099
0,2810,0,一番くじカピバラさんふんわりフラワ～ン,2810,0.003546144041594629
395473,41686,1,一番くじカピバラさんふんわりフラワ～ン,44496,0.05615274920811196
396858,91029,2,一番くじカピバラさんふんわりフラワ～ン,135525,0.17102888656124987
66,80042,3,一番くじカピバラさんふんわりフラワ～ン,215567,0.2720397269090496
0,60260,4,一番くじカピバラさんふんわりフラワ～ン,275827,0.3480862179932106
0,55562,5,一番くじカピバラさんふんわりフラワ～ン,331389,0.4182039600711753
0,59500,6,一番くじカピバラさんふんわりフラワ～ン,390889,0.4932913516992466
0,49759,7,一番くじカピバラさんふんわりフラワ～ン,440648,0.5560858646407794
0,48146,8,一番くじカピバラさんふんわりフラワ～ン,488794,0.6168448151840588
0,51251,9,一番くじカピバラさんふんわりフラワ～ン,540045,0.6815221917946518
0,40626,10,一番くじカピバラさんふんわりフラワ～ン,580671,0.7327911056145178
0,30176,11,一番くじカピバラさんふんわりフラワ～ン,610847,0.770872401913151
0,19977,12,一番くじカピバラさんふんわりフラワ～ン,630824,0.7960828359056549
0,17358,13,一番くじカピバラさんふんわりフラワ～ン,648182,0.8179881626935551
0,18675,14,一番くじカピバラさんふんわりフラワ～ン,666857,0.8415555078810212
0,16618,15,一番くじカピバラさんふんわりフラワ～ン,683475,0.8625269746722025
0,14583,16,一番くじカピバラさんふんわりフラワ～ン,698058,0.880930326472407
0,10672,17,一番くじカピバラさんふんわりフラワ～ン,708730,0.8943981019926553
0,6878,18,一番くじカピバラさんふんわりフラワ～ン,715608,0.9030779520702666
0,6142,19,一番くじカピバラさんふんわりフラワ～ン,721750,0.9108289900430333
0,5217,20,一番くじカピバラさんふんわりフラワ～ン,726967,0.9174127030199013
0,4980,21,一番くじカピバラさんふんわりフラワ～ン,731947,0.9236973284032256
0,4918,22,一番くじカピバラさんふんわりフラワ～ン,736865,0.9299037114625005
0,5950,23,一番くじカピバラさんふんわりフラワ～ン,742815,0.9374124506253076
0,5200,24,一番くじカピバラさんふんわりフラワ～ン,748015,0.9439747100617105
0,3084,25,一番くじカピバラさんふんわりフラワ～ン,751099,0.9478666346966848
0,2570,26,一番くじカピバラさんふんわりフラワ～ン,753669,0.95110990522583
0,2362,27,一番くじカピバラさんふんわりフラワ～ン,756031,0.9540906853775192
0,2097,28,一番くじカピバラさんふんわりフラワ～ン,758128,0.9567370426925456
0,2086,29,一番くじカピバラさんふんわりフラワ～ン,760214,0.9593695183049179
0,2757,30,一番くじカピバラさんふんわりフラワ～ン,762971,0.96284877777918
0,2323,31,一番くじカピバラさんふんわりフラワ～ン,765294,0.9657803409850961
0,1404,32,一番くじカピバラさんふんわりフラワ～ン,766698,0.9675521510329249
0,1034,33,一番くじカピバラさんふんわりフラワ～ン,767732,0.9688570310823942
0,1058,34,一番くじカピバラさんふんわりフラワ～ン,768790,0.9701921984831084
0,1128,35,一番くじカピバラさんふんわりフラワ～ン,769918,0.9716157039916204
0,988,36,一番くじカピバラさんふんわりフラワ～ン,770906,0.9728625332845371
0,1043,37,一番くじカピバラさんふんわりフラワ～ン,771949,0.9741787710907233
0,687,38,一番くじカピバラさんふんわりフラワ～ン,772636,0.9750457465201096
0,499,39,一番くじカピバラさんふんわりフラワ～ン,773135,0.9756754710314105
0,513,40,一番くじカピバラさんふんわりフラワ～ン,773648,0.976322863164271
13,481,41,一番くじカピバラさんふんわりフラワ～ン,774129,0.9769298721621383
0,366,42,一番くじカピバラさんふんわりフラワ～ン,774495,0.9773917542686236
0,352,43,一番くじカピバラさんふんわりフラワ～ン,774847,0.9778359687535493
0,594,44,一番くじカピバラさんふんわりフラワ～ン,775441,0.9785855806968615
0,444,45,一番くじカピバラさんふんわりフラワ～ン,775885,0.9791458966948928
0,313,46,一番くじカピバラさんふんわりフラワ～ン,776198,0.9795408942340456
0,288,47,一番くじカピバラさんふんわりフラワ～ン,776486,0.9799043424489847
0,226,48,一番くじカピバラさんふんわりフラワ～ン,776712,0.9801895483398746
0,230,49,一番くじカピバラさんふんわりフラワ～ン,776942,0.9804798021226385
0,284,50,一番くじカピバラさんふんわりフラワ～ン,777226,0.9808382024457036
0,341,51,一番くじカピバラさんふんわりフラワ～ン,777567,0.9812685352279754
0,310,52,一番くじカピバラさんふんわりフラワ～ン,777877,0.9816597468482225
0,184,53,一番くじカピバラさんふんわりフラワ～ン,778061,0.9818919498744337
0,189,54,一番くじカピバラさんふんわりフラワ～ン,778250,0.9821304627654875
0,125,55,一番くじカピバラさんふんわりフラワ～ン,778375,0.9822882093865549
0,196,56,一番くじカピバラさんふんわりフラワ～ン,778571,0.9825355560883886
0,213,57,一番くじカピバラさんふんわりフラワ～ン,778784,0.9828043563306874
0,209,58,一番くじカピバラさんふんわりフラワ～ン,778993,0.983068108681112
0,188,59,一番くじカピバラさんふんわりフラワ～ン,779181,0.9833053595991974
0,1895,0,ポケモンコレクションくじ２０１７,1895,0.0033016238065370408
281940,30956,1,ポケモンコレクションくじ２０１７,32851,0.057235695867307826
291900,56845,2,ポケモンコレクションくじ２０１７,89696,0.15627569865495852
60,59561,3,ポケモンコレクションくじ２０１７,149257,0.26004773851836366
60,65566,4,ポケモンコレクションくじ２０１７,214823,0.3742821799428532
0,53179,5,ポケモンコレクションくじ２０１７,268002,0.4669349780472507
0,33635,6,ポケモンコレクションくじ２０１７,301637,0.525536622761168
0,25750,7,ポケモンコレクションくじ２０１７,327387,0.5704003763328455
0,24712,8,ポケモンコレクションくじ２０１７,352099,0.613455641508119
0,21743,9,ポケモンコレクションくじ２０１７,373842,0.6513380723395359
0,20375,10,ポケモンコレクションくじ２０１７,394217,0.6868370618161544
0,22616,11,ポケモンコレクションくじ２０１７,416833,0.7262405045647781
0,18427,12,ポケモンコレクションくじ２０１７,435260,0.7583455293051781
0,11001,13,ポケモンコレクションくじ２０１７,446261,0.777512370200014
0,9893,14,ポケモンコレクションくじ２０１７,456154,0.7947487629799986
0,8515,15,ポケモンコレクションくじ２０１７,464669,0.809584291588264
0,7931,16,ポケモンコレクションくじ２０１７,472600,0.8234023276883407
0,10765,17,ポケモンコレクションくじ２０１７,483365,0.84215799010384
0,8778,18,ポケモンコレクションくじ２０１７,492143,0.8574517387971288
0,7964,19,ポケモンコレクションくじ２０１７,500107,0.8713272701930448
0,5882,20,ポケモンコレクションくじ２０１７,505989,0.8815753711060004
0,3678,21,ポケモンコレクションくじ２０１７,509667,0.8879834831695589
0,3356,22,ポケモンコレクションくじ２０１７,513023,0.8938305805282598
0,3241,23,ポケモンコレクションくじ２０１７,516264,0.8994773154923688
0,3713,24,ポケモンコレクションくじ２０１７,519977,0.9059464074151509
0,3411,25,ポケモンコレクションくじ２０１７,523388,0.9118893302669175
0,3095,26,ポケモンコレクションくじ２０１７,526483,0.9172816921039794
0,2135,27,ポケモンコレクションくじ２０１７,528618,0.9210014635166214
0,2539,28,ポケモンコレクションくじ２０１７,531157,0.9254251167328734
0,2518,29,ポケモンコレクションくじ２０１７,533675,0.9298121820335912
0,2006,30,ポケモンコレクションくじ２０１７,535681,0.9333071991079518
0,1940,31,ポケモンコレクションくじ２０１７,537621,0.9366872255906334
0,2219,32,ポケモンコレクションくじ２０１７,539840,0.9405533486654122
0,1799,33,ポケモンコレクションくじ２０１７,541639,0.9436877134295073
0,1392,34,ポケモンコレクションくじ２０１７,543031,0.946112969544916
0,1196,35,ポケモンコレクションくじ２０１７,544227,0.9481967384486724
0,1173,36,ポケモンコレクションくじ２０１７,545400,0.9502404348735104
0,1003,37,ポケモンコレクションくじ２０１７,546403,0.9519879434106906
0,1088,38,ポケモンコレクションくじ２０１７,547491,0.9538835458916998
0,1068,39,ポケモンコレクションくじ２０１７,548559,0.9557443027388668
0,964,40,ポケモンコレクションくじ２０１７,549523,0.957423862290055
0,618,41,ポケモンコレクションくじ２０１７,550141,0.9585005923757753
0,560,42,ポケモンコレクションくじ２０１７,550701,0.9594762701233536
0,507,43,ポケモンコレクションくじ２０１７,551208,0.9603596069412502
0,555,44,ポケモンコレクションくじ２０１７,551763,0.961326573280368
0,735,45,ポケモンコレクションくじ２０１７,552498,0.9626071503240644
0,676,46,ポケモンコレクションくじ２０１７,553174,0.9637849327479266
0,646,47,ポケモンコレクションくじ２０１７,553820,0.9649104467210259
0,555,48,ポケモンコレクションくじ２０１７,554375,0.9658774130601435
0,570,49,ポケモンコレクションくじ２０１７,554945,0.9668705136246428
0,448,50,ポケモンコレクションくじ２０１７,555393,0.9676510558227054
0,445,51,ポケモンコレクションくじ２０１７,555838,0.9684263711756916
0,374,52,ポケモンコレクションくじ２０１７,556212,0.9690779845285385
0,431,53,ポケモンコレクションくじ２０１７,556643,0.9698289079378354
0,333,54,ポケモンコレクションくじ２０１７,556976,0.970409087741306
0,251,55,ポケモンコレクションくじ２０１７,557227,0.9708464004460241
0,242,56,ポケモンコレクションくじ２０１７,557469,0.9712680326155133
0,179,57,ポケモンコレクションくじ２０１７,557648,0.9715799010383999
0,225,58,ポケモンコレクションくじ２０１７,557873,0.9719719144191232
0,180,59,ポケモンコレクションくじ２０１７,558053,0.972285525123702
1920,6593,0,一番くじエヴァンゲリオン２０２０,6593,0.009204488182710416
372720,74469,1,一番くじエヴァンゲリオン２０２０,81062,0.11317066905306716
341281,103180,2,一番くじエヴァンゲリオン２０２０,184242,0.25722028086742493
0,78105,3,一番くじエヴァンゲリオン２０２０,262347,0.3662626818245912
60,59510,4,一番くじエヴァンゲリオン２０２０,321857,0.4493446007921472
120,53789,5,一番くじエヴァンゲリオン２０２０,375646,0.5244394308937415
60,45102,6,一番くじエヴァンゲリオン２０２０,420748,0.5874063391322679
120,39333,7,一番くじエヴァンゲリオン２０２０,460081,0.6423191456984061
0,36086,8,一番くじエヴァンゲリオン２０２０,496167,0.6926988151298163
0,31212,9,一番くじエヴァンゲリオン２０２０,527379,0.7362738925086663
0,20275,10,一番くじエヴァンゲリオン２０２０,547654,0.764579822723205
0,16633,11,一番くじエヴァンゲリオン２０２０,564287,0.7878011562501309
0,13892,12,一番くじエヴァンゲリオン２０２０,578179,0.8071957793100752
0,11229,13,一番くじエヴァンゲリオン２０２０,589408,0.8228725877134812
0,12199,14,一番くじエヴァンゲリオン２０２０,601607,0.8399036132467566
0,12602,15,一番くじエヴァンゲリオン２０２０,614209,0.8574972671339879
0,10262,16,一番くじエヴァンゲリオン２０２０,624471,0.8718240467079261
0,6368,17,一番くじエヴァンゲリオン２０２０,630839,0.8807144123605122
0,4965,18,一番くじエヴァンゲリオン２０２０,635804,0.8876460495252562
0,8926,19,一番くじエヴァンゲリオン２０２０,644730,0.9001076393203226
0,4553,20,一番くじエヴァンゲリオン２０２０,649283,0.9064640832299056
0,7475,21,一番くじエヴァンゲリオン２０２０,656758,0.9168999317307035
0,5404,22,一番くじエヴァンゲリオン２０２０,662162,0.9244444568542234
0,4310,23,一番くじエヴァンゲリオン２０２０,666472,0.9304616484312721
0,2437,24,一番くじエヴァンゲリオン２０２０,668909,0.9338639444575523
0,2093,25,一番くじエヴァンゲリオン２０２０,671002,0.9367859820377756
0,2019,26,一番くじエヴァンゲリオン２０２０,673021,0.9396047082080915
0,1947,27,一番くじエヴァンゲリオン２０２０,674968,0.9423229151687675
0,1537,28,一番くじエヴァンゲリオン２０２０,676505,0.9444687210745504
0,1961,29,一番くじエヴァンゲリオン２０２０,678466,0.9472064734371008
0,1859,30,一番くじエヴァンゲリオン２０２０,680325,0.9498018235859949
0,1603,31,一番くじエヴァンゲリオン２０２０,681928,0.9520397721006142
0,1563,32,一番くじエヴァンゲリオン２０２０,683491,0.954221876609878
0,993,33,一番くじエヴァンゲリオン２０２０,684484,0.9556082040428268
0,986,34,一番くじエヴァンゲリオン２０２０,685470,0.9569847587748384
0,1101,35,一番くじエヴァンゲリオン２０２０,686571,0.9585218650222469
0,1222,36,一番くじエヴァンゲリオン２０２０,687793,0.9602278993858555
0,1153,37,一番くじエヴァンゲリオン２０２０,688946,0.9618376028402261
0,967,38,一番くじエヴァンゲリオン２０２０,689913,0.9631876316696939
0,799,39,一番くじエヴァンゲリオン２０２０,690712,0.9643031156766688
0,700,40,一番くじエヴァンゲリオン２０２０,691412,0.965280385770389
0,720,41,一番くじエヴァンゲリオン２０２０,692132,0.9662855778667869
0,733,42,一番くじエヴァンゲリオン２０２０,692865,0.9673089192649253
0,879,43,一番くじエヴァンゲリオン２０２０,693744,0.9685360912826112
0,740,44,一番くじエヴァンゲリオン２０２０,694484,0.9695692053816868
0,564,45,一番くじエヴァンゲリオン２０２０,695048,0.9703566058571985
0,789,46,一番くじエヴァンゲリオン２０２０,695837,0.9714581288628346
0,373,47,一番くじエヴァンゲリオン２０２０,696210,0.9719788742127741
0,352,48,一番くじエヴァンゲリオン２０２０,696562,0.9724703014599019
0,402,49,一番くじエヴァンゲリオン２０２０,696964,0.9730315337137241
0,542,50,一番くじエヴァンゲリオン２０２０,697506,0.9737882199862903
0,462,51,一番くじエヴァンゲリオン２０２０,697968,0.9744332182481457
0,228,52,一番くじエヴァンゲリオン２０２０,698196,0.9747515290786717
0,283,53,一番くじエヴァンゲリオン２０２０,698479,0.9751466254165614
0,236,54,一番くじエヴァンゲリオン２０２０,698715,0.9754761050481585
0,208,55,一番くじエヴァンゲリオン２０２０,698923,0.9757664938760068
0,282,56,一番くじエヴァンゲリオン２０２０,699205,0.9761601941137626
0,351,57,一番くじエヴァンゲリオン２０２０,699556,0.9766502252607566
0,203,58,一番くじエヴァンゲリオン２０２０,699759,0.9769336335879355
0,204,59,一番くじエヴァンゲリオン２０２０,699963,0.9772184380152482
0,4342,0,一番くじ機動戦士ガンダムガンプラ,4342,0.0066148589048462755
315840,71471,1,一番くじ機動戦士ガンダムガンプラ,75813,0.11549799588970766
340321,112873,2,一番くじ機動戦士ガンダムガンプラ,188686,0.28745538169503093
0,105112,3,一番くじ機動戦士ガンダムガンプラ,293798,0.447589202332111
0,93346,4,一番くじ機動戦士ガンダムガンプラ,387144,0.5897980045734239
120,61696,5,一番くじ機動戦士ガンダムガンプラ,448840,0.6837893299979738
60,36462,6,一番くじ機動戦士ガンダムガンプラ,485302,0.7393376914416645
0,28032,7,一番くじ機動戦士ガンダムガンプラ,513334,0.7820432936573832
0,20775,8,一番くじ機動戦士ガンダムガンプラ,534109,0.8136931540323674
0,15640,9,一番くじ機動戦士ガンダムガンプラ,549749,0.8375200525288657
0,13353,10,一番くじ機動戦士ガンダムガンプラ,563102,0.8578628003308952
60,11917,11,一番くじ機動戦士ガンダムガンプラ,575019,0.8760178610331185
0,9361,12,一番くじ機動戦士ガンダムガンプラ,584380,0.8902789605744049
0,5669,13,一番くじ機動戦士ガンダムガンプラ,590049,0.898915449549894
0,4010,14,一番くじ機動戦士ガンダムガンプラ,594059,0.9050245200723338
0,4034,15,一番くじ機動戦士ガンダムガンプラ,598093,0.9111701536103692
0,3105,16,一番くじ機動戦士ガンダムガンプラ,601198,0.9159004937530565
0,3013,17,一番くじ機動戦士ガンダムガンプラ,604211,0.9204906756692937
0,3443,18,一番くじ機動戦士ガンダムガンプラ,607654,0.9257359449482861
0,2763,19,一番くじ機動戦士ガンダムガンプラ,610417,0.9299452621187353
0,5465,20,一番くじ機動戦士ガンダムガンプラ,615882,0.9382709654616614
0,2051,21,一番くじ機動戦士ガンダムガンプラ,617933,0.9413955798361063
0,1596,22,一番くじ機動戦士ガンダムガンプラ,619529,0.943827020373217
0,1327,23,一番くじ機動戦士ガンダムガンプラ,620856,0.9458486504438598
0,1376,24,一番くじ機動戦士ガンダムガンプラ,622232,0.947944930004677
0,1768,25,一番くじ機動戦士ガンダムガンプラ,624000,0.9506384054868898
0,1594,26,一番くじ機動戦士ガンダムガンプラ,625594,0.9530667991060343
0,1148,27,一番くじ機動戦士ガンダムガンプラ,626742,0.9548157300186928
0,698,28,一番くじ機動戦士ガンダムガンプラ,627440,0.955879104388933
0,903,29,一番くじ機動戦士ガンダムガンプラ,628343,0.9572547878507193
0,602,30,一番くじ機動戦士ガンダムガンプラ,628945,0.9581719101585768
0,700,31,一番くじ機動戦士ガンダムガンプラ,629645,0.9592383314467833
0,819,32,一番くじ機動戦士ガンダムガンプラ,630464,0.9604860443539849
0,795,33,一番くじ機動戦士ガンダムガンプラ,631259,0.9616971942455907
0,739,34,一番くじ機動戦士ガンダムガンプラ,631998,0.9628230304341401
0,690,35,一番くじ機動戦士ガンダムガンプラ,632688,0.9638742171325151
0,551,36,一番くじ機動戦士ガンダムガンプラ,633239,0.9647136430322318
0,486,37,一番くじ機動戦士ガンダムガンプラ,633725,0.9654540440980437
0,449,38,一番くじ機動戦士ガンダムガンプラ,634174,0.966138077181479
0,415,39,一番くじ機動戦士ガンダムガンプラ,634589,0.9667703126594871
0,436,40,一番くじ機動戦士ガンダムガンプラ,635025,0.9674345407761414
0,346,41,一番くじ機動戦士ガンダムガンプラ,635371,0.9679616575843121
0,285,42,一番くじ機動戦士ガンダムガンプラ,635656,0.9683958433945103
0,396,43,一番くじ機動戦士ガンダムガンプラ,636052,0.9689991331518386
0,300,44,一番くじ機動戦士ガンダムガンプラ,636352,0.9694561708467843
0,270,45,一番くじ機動戦士ガンダムガンプラ,636622,0.9698675047722353
0,374,46,一番くじ機動戦士ガンダムガンプラ,636996,0.9704372784319342
0,296,47,一番くじ機動戦士ガンダムガンプラ,637292,0.9708882222909472
0,288,48,一番くじ機動戦士ガンダムガンプラ,637580,0.9713269784780949
0,213,49,一番くじ機動戦士ガンダムガンプラ,637793,0.9716514752415063
0,258,50,一番くじ機動戦士ガンダムガンプラ,638051,0.9720445276591596
0,158,51,一番くじ機動戦士ガンダムガンプラ,638209,0.9722852341784975
0,167,52,一番くじ機動戦士ガンダムガンプラ,638376,0.972539651828684
0,231,53,一番くじ機動戦士ガンダムガンプラ,638607,0.9728915708537921
0,202,54,一番くじ機動戦士ガンダムガンプラ,638809,0.9731993095683888
0,195,55,一番くじ機動戦士ガンダムガンプラ,639004,0.9734963840701035
0,126,56,一番くじ機動戦士ガンダムガンプラ,639130,0.9736883399019807
0,205,57,一番くじ機動戦士ガンダムガンプラ,639335,0.9740006489935268
0,190,58,一番くじ機動戦士ガンダムガンプラ,639525,0.9742901062003257
0,45,59,一番くじ機動戦士ガンダムガンプラ,639570,0.9743586618545675
0,1619,0,一番くじスーパーマリオオデッセイ,1619,0.002271643047565596
353364,24966,1,一番くじスーパーマリオオデッセイ,26585,0.0373018100182405
358710,57746,2,一番くじスーパーマリオオデッセイ,84331,0.11832608390627192
264,65360,3,一番くじスーパーマリオオデッセイ,149691,0.21003367475796267
0,44353,4,一番くじスーパーマリオオデッセイ,194044,0.27226603058790516
0,38151,5,一番くじスーパーマリオオデッセイ,232195,0.3257962677143258
0,34003,6,一番くじスーパーマリオオデッセイ,266198,0.37350638417286375
0,31917,7,一番くじスーパーマリオオデッセイ,298115,0.418289602918479
132,31674,8,一番くじスーパーマリオオデッセイ,329789,0.46273186473972217
66,44481,9,一番くじスーパーマリオオデッセイ,374270,0.5251438192787989
0,37141,10,一番くじスーパーマリオオデッセイ,411411,0.5772569103409569
0,17815,11,一番くじスーパーマリオオデッセイ,429226,0.6022534025536691
0,16753,12,一番くじスーパーマリオオデッセイ,445979,0.6257597867265329
66,15292,13,一番くじスーパーマリオオデッセイ,461271,0.6472162200084187
0,14386,14,一番くじスーパーマリオオデッセイ,475657,0.6674014311772134
0,14981,15,一番くじスーパーマリオオデッセイ,490638,0.6884214957204995
66,20453,16,一番くじスーパーマリオオデッセイ,511091,0.717119405079276
0,16456,17,一番くじスーパーマリオオデッセイ,527547,0.7402090641223517
0,8110,18,一番くじスーパーマリオオデッセイ,535657,0.7515883260839062
0,6793,19,一番くじスーパーマリオオデッセイ,542450,0.761119685702259
0,6671,20,一番くじスーパーマリオオデッセイ,549121,0.7704798653009681
0,6026,21,一番くじスーパーマリオオデッセイ,555147,0.7789350357794304
0,7300,22,一番くじスーパーマリオオデッセイ,562447,0.7891777746597446
0,9329,23,一番くじスーパーマリオオデッセイ,571776,0.8022674337028203
0,7738,24,一番くじスーパーマリオオデッセイ,579514,0.8131247369159534
0,4202,25,一番くじスーパーマリオオデッセイ,583716,0.8190206257892522
0,3643,26,一番くじスーパーマリオオデッセイ,587359,0.8241321734250036
0,3598,27,一番くじスーパーマリオオデッセイ,590957,0.8291805808895748
0,3845,28,一番くじスーパーマリオオデッセイ,594802,0.8345755577381787
0,4250,29,一番くじスーパーマリオオデッセイ,599052,0.8405387961274028
0,5291,30,一番くじスーパーマリオオデッセイ,604343,0.847962677143258
0,5614,31,一番くじスーパーマリオオデッセイ,609957,0.8558397642766943
0,3736,32,一番くじスーパーマリオオデッセイ,613693,0.861081801599551
0,3513,33,一番くじスーパーマリオオデッセイ,617206,0.8660109442963378
0,3404,34,一番くじスーパーマリオオデッセイ,620610,0.8707871474673776
0,3542,35,一番くじスーパーマリオオデッセイ,624152,0.8757569804967027
0,3995,36,一番くじスーパーマリオオデッセイ,628147,0.8813624245825733
0,3752,37,一番くじスーパーマリオオデッセイ,631899,0.8866269117440718
0,3697,38,一番くじスーパーマリオオデッセイ,635596,0.8918142275852392
0,4561,39,一番くじスーパーマリオオデッセイ,640157,0.898213834713063
0,3872,40,一番くじスーパーマリオオデッセイ,644029,0.9036466956643749
0,3137,41,一番くじスーパーマリオオデッセイ,647166,0.9080482671530798
0,2276,42,一番くじスーパーマリオオデッセイ,649442,0.9112417566998737
0,1925,43,一番くじスーパーマリオオデッセイ,651367,0.9139427529114634
0,2116,44,一番くじスーパーマリオオデッセイ,653483,0.9169117440718395
0,2151,45,一番くじスーパーマリオオデッセイ,655634,0.9199298442542444
0,1455,46,一番くじスーパーマリオオデッセイ,657089,0.9219713764557317
0,1243,47,一番くじスーパーマリオオデッセイ,658332,0.9237154482952153
0,1111,48,一番くじスーパーマリオオデッセイ,659443,0.9252743089659043
0,821,49,一番くじスーパーマリオオデッセイ,660264,0.9264262663112108
0,914,50,一番くじスーパーマリオオデッセイ,661178,0.9277087133436228
0,1530,51,一番くじスーパーマリオオデッセイ,662708,0.9298554791637436
0,1401,52,一番くじスーパーマリオオデッセイ,664109,0.9318212431598147
0,786,53,一番くじスーパーマリオオデッセイ,664895,0.9329240914830924
0,721,54,一番くじスーパーマリオオデッセイ,665616,0.9339357373368878
0,722,55,一番くじスーパーマリオオデッセイ,666338,0.9349487863055984
0,687,56,一番くじスーパーマリオオデッセイ,667025,0.9359127262522801
0,755,57,一番くじスーパーマリオオデッセイ,667780,0.9369720780131893
0,1224,58,一番くじスーパーマリオオデッセイ,669004,0.9386894906692859
0,988,59,一番くじスーパーマリオオデッセイ,669992,0.940075768205416
6880,86235,0,一番くじ僕のヒーローアカデミアヒーローＶＳ,86235,0.07461304783074038
583523,621387,1,一番くじ僕のヒーローアカデミアヒーローＶＳ,707622,0.6122552807106647
565360,348845,2,一番くじ僕のヒーローアカデミアヒーローＶＳ,1056467,0.91408619241142
0,53745,3,一番くじ僕のヒーローアカデミアヒーローＶＳ,1110212,0.9605879406072007
0,18416,4,一番くじ僕のヒーローアカデミアヒーローＶＳ,1128628,0.9765220032134616
0,7281,5,一番くじ僕のヒーローアカデミアヒーローＶＳ,1135909,0.9828217376745925
0,4053,6,一番くじ僕のヒーローアカデミアヒーローＶＳ,1139962,0.9863285119873192
0,2469,7,一番くじ僕のヒーローアカデミアヒーローＶＳ,1142431,0.9884647631045466
0,1489,8,一番くじ僕のヒーローアカデミアヒーローＶＳ,1143920,0.9897530895174875
0,1158,9,一番くじ僕のヒーローアカデミアヒーローＶＳ,1145078,0.9907550250354095
0,1178,10,一番くじ僕のヒーローアカデミアヒーローＶＳ,1146256,0.9917742651391332
0,539,11,一番くじ僕のヒーローアカデミアヒーローＶＳ,1146795,0.9922406237264907
0,586,12,一番くじ僕のヒーローアカデミアヒーローＶＳ,1147381,0.9927476480904822
0,528,13,一番くじ僕のヒーローアカデミアヒーローＶＳ,1147909,0.9932044891556487
0,535,14,一番くじ僕のヒーローアカデミアヒーローＶＳ,1148444,0.9936673868258458
0,236,15,一番くじ僕のヒーローアカデミアヒーローＶＳ,1148680,0.9938715809383065
0,343,16,一番くじ僕のヒーローアカデミアヒーローＶＳ,1149023,0.9941683545848068
0,172,17,一番くじ僕のヒーローアカデミアヒーローＶＳ,1149195,0.9943171740227019
0,254,18,一番くじ僕のヒーローアカデミアヒーローＶＳ,1149449,0.9945369422623842
0,463,19,一番くじ僕のヒーローアカデミアヒーローＶＳ,1149912,0.994937543423695
0,303,20,一番くじ僕のヒーローアカデミアヒーローＶＳ,1150215,0.9951997078985917
0,297,21,一番くじ僕のヒーローアカデミアヒーローＶＳ,1150512,0.9954566809977478
0,57,22,一番くじ僕のヒーローアカデミアヒーローＶＳ,1150569,0.9955059990672829
0,87,23,一番くじ僕のヒーローアカデミアヒーローＶＳ,1150656,0.9955812740155204
0,152,24,一番くじ僕のヒーローアカデミアヒーローＶＳ,1150808,0.9957127888676138
0,217,25,一番くじ僕のヒーローアカデミアヒーローＶＳ,1151025,0.995900543623563
0,113,26,一番くじ僕のヒーローアカデミアヒーローＶＳ,1151138,0.9959983145333429
0,133,27,一番くじ僕のヒーローアカデミアヒーローＶＳ,1151271,0.9961133900289246
0,22,28,一番くじ僕のヒーローアカデミアヒーローＶＳ,1151293,0.9961324250733066
0,25,29,一番くじ僕のヒーローアカデミアヒーローＶＳ,1151318,0.9961540558055587
0,41,30,一番くじ僕のヒーローアカデミアヒーローＶＳ,1151359,0.9961895302064524
0,128,31,一番くじ僕のヒーローアカデミアヒーローＶＳ,1151487,0.9963002795555836
0,43,32,一番くじ僕のヒーローアカデミアヒーローＶＳ,1151530,0.9963374844150574
0,87,33,一番くじ僕のヒーローアカデミアヒーローＶＳ,1151617,0.9964127593632951
0,127,34,一番くじ僕のヒーローアカデミアヒーローＶＳ,1151744,0.9965226434831362
0,19,35,一番くじ僕のヒーローアカデミアヒーローＶＳ,1151763,0.9965390828396479
0,103,36,一番くじ僕のヒーローアカデミアヒーローＶＳ,1151866,0.996628201456527
0,59,37,一番くじ僕のヒーローアカデミアヒーローＶＳ,1151925,0.9966792499846422
0,24,38,一番くじ僕のヒーローアカデミアヒーローＶＳ,1151949,0.9967000154876043
0,7,39,一番くじ僕のヒーローアカデミアヒーローＶＳ,1151956,0.996706072092635
0,23,40,一番くじ僕のヒーローアカデミアヒーローＶＳ,1151979,0.9967259723663069
0,35,41,一番くじ僕のヒーローアカデミアヒーローＶＳ,1152014,0.9967562553914601
0,21,42,一番くじ僕のヒーローアカデミアヒーローＶＳ,1152035,0.9967744252065519
0,149,43,一番くじ僕のヒーローアカデミアヒーローＶＳ,1152184,0.996903344370775
0,10,44,一番くじ僕のヒーローアカデミアヒーローＶＳ,1152194,0.9969119966636758
0,83,45,一番くじ僕のヒーローアカデミアヒーローＶＳ,1152277,0.9969838106947532
0,1,46,一番くじ僕のヒーローアカデミアヒーローＶＳ,1152278,0.9969846759240433
0,4,47,一番くじ僕のヒーローアカデミアヒーローＶＳ,1152282,0.9969881368412036
0,2,48,一番くじ僕のヒーローアカデミアヒーローＶＳ,1152284,0.9969898672997838
0,8,49,一番くじ僕のヒーローアカデミアヒーローＶＳ,1152292,0.9969967891341045
0,29,50,一番くじ僕のヒーローアカデミアヒーローＶＳ,1152321,0.9970218807835171
0,15,51,一番くじ僕のヒーローアカデミアヒーローＶＳ,1152336,0.9970348592228684
0,1,52,一番くじ僕のヒーローアカデミアヒーローＶＳ,1152337,0.9970357244521585
0,3,53,一番くじ僕のヒーローアカデミアヒーローＶＳ,1152340,0.9970383201400287
0,21,54,一番くじ僕のヒーローアカデミアヒーローＶＳ,1152361,0.9970564899551205
0,19,55,一番くじ僕のヒーローアカデミアヒーローＶＳ,1152380,0.9970729293116323
0,0,56,一番くじ僕のヒーローアカデミアヒーローＶＳ,1152380,0.9970729293116323
0,9,57,一番くじ僕のヒーローアカデミアヒーローＶＳ,1152389,0.997080716375243
0,1,58,一番くじ僕のヒーローアカデミアヒーローＶＳ,1152390,0.9970815816045331
0,1,59,一番くじ僕のヒーローアカデミアヒーローＶＳ,1152391,0.9970824468338232
0,3978,0,一番くじヒストリーオブチョッパーゴールデン,3978,0.004619243363756706
431940,53696,1,一番くじヒストリーオブチョッパーゴールデン,57674,0.06697090039248473
429120,152456,2,一番くじヒストリーオブチョッパーゴールデン,210130,0.24400241529064773
0,148989,3,一番くじヒストリーオブチョッパーゴールデン,359119,0.4170080587101419
0,110255,4,一番くじヒストリーオブチョッパーゴールデン,469374,0.5450358810004877
0,66438,5,一番くじヒストリーオブチョッパーゴールデン,535812,0.6221835156413293
60,48817,6,一番くじヒストリーオブチョッパーゴールデン,584629,0.678869690424766
0,39911,7,一番くじヒストリーオブチョッパーゴールデン,624540,0.7252142409252421
0,30718,8,一番くじヒストリーオブチョッパーゴールデン,655258,0.7608839034812699
0,28453,9,一番くじヒストリーオブチョッパーゴールデン,683711,0.7939234538656262
0,29854,10,一番くじヒストリーオブチョッパーゴールデン,713565,0.8285898418449105
0,20715,11,一番くじヒストリーオブチョッパーゴールデン,734280,0.8526440465407928
0,12812,12,一番くじヒストリーオブチョッパーゴールデン,747092,0.8675213079727815
0,10392,13,一番くじヒストリーオブチョッパーゴールデン,757484,0.8795884716319469
0,8857,14,一番くじヒストリーオブチョッパーゴールデン,766341,0.8898731972409949
0,7717,15,一番くじヒストリーオブチョッパーゴールデン,774058,0.8988341577835064
0,6687,16,一番くじヒストリーオブチョッパーゴールデン,780745,0.9065990849764277
0,5307,17,一番くじヒストリーオブチョッパーゴールデン,786052,0.9127615597203836
0,4099,18,一番くじヒストリーオブチョッパーゴールデン,790151,0.9175213079727815
0,2828,19,一番くじヒストリーオブチョッパーゴールデン,792979,0.9208051742957337
0,2474,20,一番くじヒストリーオブチョッパーゴールデン,795453,0.9236779767296036
60,2309,21,一番くじヒストリーオブチョッパーゴールデン,797762,0.9263591815880536
0,2648,22,一番くじヒストリーオブチョッパーゴールデン,800410,0.9294340323741842
0,2771,23,一番くじヒストリーオブチョッパーゴールデン,803181,0.9326517104438097
0,2546,24,一番くじヒストリーオブチョッパーゴールデン,805727,0.935608119092408
0,2115,25,一番くじヒストリーオブチョッパーゴールデン,807842,0.9380640516500616
0,1556,26,一番くじヒストリーオブチョッパーゴールデン,809398,0.9398708748461413
0,1677,27,一番くじヒストリーオブチョッパーゴールデン,811075,0.9418182029308623
0,1978,28,一番くじヒストリーオブチョッパーゴールデン,813053,0.944115051441046
0,1581,29,一番くじヒストリーオブチョッパーゴールデン,814634,0.9459509045727955
0,1705,30,一番くじヒストリーオブチョッパーゴールデン,816339,0.9479307461854665
0,1392,31,一番くじヒストリーオブチョッパーゴールデン,817731,0.9495471330035533
0,1291,32,一番くじヒストリーオブチョッパーゴールデン,819022,0.9510462388815346
0,1066,33,一番くじヒストリーオブチョッパーゴールデン,820088,0.952284075338489
0,924,34,一番くじヒストリーオブチョッパーゴールデン,821012,0.9533570217608398
0,984,35,一番くじヒストリーオブチョッパーゴールデン,821996,0.9544996400287977
0,865,36,一番くじヒストリーオブチョッパーゴールデン,822861,0.955504075802968
0,913,37,一番くじヒストリーオブチョッパーゴールデン,823774,0.9565642490536241
0,902,38,一番くじヒストリーオブチョッパーゴールデン,824676,0.9576116491325856
0,810,39,一番くじヒストリーオブチョッパーゴールデン,825486,0.9585522190482826
0,679,40,一番くじヒストリーオブチョッパーゴールデン,826165,0.9593406721010707
0,652,41,一番くじヒストリーオブチョッパーゴールデン,826817,0.9600977728233354
0,676,42,一番くじヒストリーオブチョッパーゴールデン,827493,0.9608827422838431
0,615,43,一番くじヒストリーオブチョッパーゴールデン,828108,0.9615968787013168
0,591,44,一番くじヒストリーオブチョッパーゴールデン,828699,0.9622831463805476
0,528,45,一番くじヒストリーオブチョッパーゴールデン,829227,0.9628962586218909
0,596,46,一番くじヒストリーオブチョッパーゴールデン,829823,0.9635883322882557
0,378,47,一番くじヒストリーオブチョッパーゴールデン,830201,0.964027264915581
0,377,48,一番くじヒストリーオブチョッパーゴールデン,830578,0.9644650363454794
0,262,49,一番くじヒストリーオブチョッパーゴールデン,830840,0.9647692700712975
0,302,50,一番くじヒストリーオブチョッパーゴールデン,831142,0.9651199516941871
0,345,51,一番くじヒストリーオブチョッパーゴールデン,831487,0.9655205648064283
0,346,52,一番くじヒストリーオブチョッパーゴールデン,831833,0.9659223391160965
0,307,53,一番くじヒストリーオブチョッパーゴールデン,832140,0.96627882672612
0,290,54,一番くじヒストリーオブチョッパーゴールデン,832430,0.9666155739798881
0,309,55,一番くじヒストリーオブチョッパーゴールデン,832739,0.9669743839847651
0,269,56,一番くじヒストリーオブチョッパーゴールデン,833008,0.9672867460925707
0,294,57,一番くじヒストリーオブチョッパーゴールデン,833302,0.9676281381360459
0,226,58,一番くじヒストリーオブチョッパーゴールデン,833528,0.9678905687544996
0,223,59,一番くじヒストリーオブチョッパーゴールデン,833751,0.968149515780673
0,1456,0,一番くじ仮面ライダ－2009,1456,0.00152428810720268
482900,53533,1,一番くじ仮面ライダ－2009,54989,0.057568048576214406
472000,99532,2,一番くじ仮面ライダ－2009,154521,0.161768216080402
0,81466,3,一番くじ仮面ライダ－2009,235987,0.24705506700167504
100,80452,4,一番くじ仮面ライダ－2009,316439,0.33128036013400336
0,75511,5,一番くじ仮面ライダ－2009,391950,0.4103329145728643
100,68010,6,一番くじ仮面ライダ－2009,459960,0.4815326633165829
0,80302,7,一番くじ仮面ライダ－2009,540262,0.5656009212730319
0,62193,8,一番くじ仮面ライダ－2009,602455,0.6307108458961475
0,51847,9,一番くじ仮面ライダ－2009,654302,0.6849895309882748
0,36826,10,一番くじ仮面ライダ－2009,691128,0.7235427135678392
0,25619,11,一番くじ仮面ライダ－2009,716747,0.7503632747068677
0,21128,12,一番くじ仮面ライダ－2009,737875,0.772482202680067
0,17125,13,一番くじ仮面ライダ－2009,755000,0.7904103852596315
0,15612,14,一番くじ仮面ライダ－2009,770612,0.8067546063651592
100,18904,15,一番くじ仮面ライダ－2009,789516,0.8265452261306533
0,18122,16,一番くじ仮面ライダ－2009,807638,0.8455171691792295
0,14530,17,一番くじ仮面ライダ－2009,822168,0.8607286432160804
0,7231,18,一番くじ仮面ライダ－2009,829399,0.8682987855946399
0,6696,19,一番くじ仮面ライダ－2009,836095,0.8753088358458961
0,6135,20,一番くじ仮面ライダ－2009,842230,0.8817315745393635
0,5864,21,一番くじ仮面ライダ－2009,848094,0.8878706030150754
0,7062,22,一番くじ仮面ライダ－2009,855156,0.8952638190954774
0,7091,23,一番くじ仮面ライダ－2009,862247,0.9026873953098827
0,4414,24,一番くじ仮面ライダ－2009,866661,0.9073084170854271
0,3983,25,一番くじ仮面ライダ－2009,870644,0.9114782244556114
0,3615,26,一番くじ仮面ライダ－2009,874259,0.9152627721943049
0,3175,27,一番くじ仮面ライダ－2009,877434,0.9185866834170854
0,2992,28,一番くじ仮面ライダ－2009,880426,0.9217190117252931
0,3805,29,一番くじ仮面ライダ－2009,884231,0.9257024706867671
0,3390,30,一番くじ仮面ライダ－2009,887621,0.9292514656616415
0,2342,31,一番くじ仮面ライダ－2009,889963,0.9317033082077052
0,2085,32,一番くじ仮面ライダ－2009,892048,0.9338860971524288
0,1990,33,一番くじ仮面ライダ－2009,894038,0.9359694304857622
0,1684,34,一番くじ仮面ライダ－2009,895722,0.9377324120603016
0,1740,35,一番くじ仮面ライダ－2009,897462,0.9395540201005025
0,2407,36,一番くじ仮面ライダ－2009,899869,0.9420739112227806
0,2197,37,一番くじ仮面ライダ－2009,902066,0.9443739530988274
0,1263,38,一番くじ仮面ライダ－2009,903329,0.945696189279732
0,1221,39,一番くじ仮面ライダ－2009,904550,0.9469744556113903
0,1162,40,一番くじ仮面ライダ－2009,905712,0.9481909547738694
0,1026,41,一番くじ仮面ライダ－2009,906738,0.9492650753768844
0,1072,42,一番くじ仮面ライダ－2009,907810,0.9503873534338358
0,1224,43,一番くじ仮面ライダ－2009,909034,0.9516687604690117
0,1086,44,一番くじ仮面ライダ－2009,910120,0.9528056951423786
0,811,45,一番くじ仮面ライダ－2009,910931,0.9536547319932999
0,707,46,一番くじ仮面ライダ－2009,911638,0.954394891122278
0,712,47,一番くじ仮面ライダ－2009,912350,0.9551402847571189
0,847,48,一番くじ仮面ライダ－2009,913197,0.9560270100502513
0,689,49,一番くじ仮面ライダ－2009,913886,0.956748324958124
0,750,50,一番くじ仮面ライダ－2009,914636,0.957533500837521
0,761,51,一番くじ仮面ライダ－2009,915397,0.9583301926298158
0,516,52,一番くじ仮面ライダ－2009,915913,0.9588703936348408
0,498,53,一番くじ仮面ライダ－2009,916411,0.9593917504187605
0,567,54,一番くじ仮面ライダ－2009,916978,0.9599853433835845
0,476,55,一番くじ仮面ライダ－2009,917454,0.9604836683417085
0,546,56,一番くじ仮面ライダ－2009,918000,0.9610552763819096
0,750,57,一番くじ仮面ライダ－2009,918750,0.9618404522613065
0,631,58,一番くじ仮面ライダ－2009,919381,0.9625010469011726
0,348,59,一番くじ仮面ライダ－2009,919729,0.9628653685092128
0,6840,0,一番くじアイドリッシュセブン王様プリン,6840,0.01615417316140003
203700,39147,1,一番くじアイドリッシュセブン王様プリン,45987,0.10860847385574607
219480,63833,2,一番くじアイドリッシュセブン王様プリン,109820,0.25936422464692266
180,30708,3,一番くじアイドリッシュセブン王様プリン,140528,0.3318879599452081
60,22522,4,一番くじアイドリッシュセブン王様プリン,163050,0.3850786453167068
0,16714,5,一番くじアイドリッシュセブン王様プリン,179764,0.4245524538283501
0,13688,6,一番くじアイドリッシュセブン王様プリン,193452,0.4568796939209296
0,10553,7,一番くじアイドリッシュセブン王様プリン,204005,0.4818029379812007
0,10229,8,一番くじアイドリッシュセブン王様プリン,214234,0.5059609843654055
0,9401,9,一番くじアイドリッシュセブン王様プリン,223635,0.5281635255774408
0,8062,10,一番くじアイドリッシュセブン王様プリン,231697,0.5472037220726466
0,7220,11,一番くじアイドリッシュセブン王様プリン,238917,0.5642553492985688
0,6264,12,一番くじアイドリッシュセブン王様プリン,245181,0.579049171035851
0,5290,13,一番くじアイドリッシュセブン王様プリン,250471,0.5915426763024892
0,5486,14,一番くじアイドリッシュセブン王様プリン,255957,0.6044990789287232
0,3945,15,一番くじアイドリッシュセブン王様プリン,259902,0.6138160691511974
0,3976,16,一番くじアイドリッシュセブン王様プリン,263878,0.6232062727315668
0,4791,17,一番くじアイドリッシュセブン王様プリン,268669,0.6345212791082141
0,3600,18,一番くじアイドリッシュセブン王様プリン,272269,0.6430234755089509
0,3383,19,一番くじアイドリッシュセブン王様プリン,275652,0.6510131784044212
0,3854,20,一番くじアイドリッシュセブン王様プリン,279506,0.6601152519956545
0,3413,21,一番くじアイドリッシュセブン王様プリン,282919,0.6681758065277975
0,2812,22,一番くじアイドリッシュセブン王様プリン,285731,0.6748169666052619
0,2645,23,一番くじアイドリッシュセブン王様プリン,288376,0.6810637192385811
0,2554,24,一番くじアイドリッシュセブン王様プリン,290930,0.6870955552406594
0,2340,25,一番くじアイドリッシュセブン王様プリン,293270,0.6926219829011383
0,2005,26,一番くじアイドリッシュセブン王様プリン,295275,0.6973572339521042
0,2009,27,一番くじアイドリッシュセブン王様プリン,297284,0.70210193188796
0,2361,28,一番くじアイドリッシュセブン王様プリン,299645,0.7076779556941099
0,2122,29,一番くじアイドリッシュセブン王様プリン,301767,0.7126895281280997
0,1513,30,一番くじアイドリッシュセブン王様プリン,303280,0.7162628123376317
0,1605,31,一番くじアイドリッシュセブン王様プリン,304885,0.7200533748996268
0,1754,32,一番くじアイドリッシュセブン王様プリン,306639,0.7241958339237636
0,1757,33,一番くじアイドリッシュセブン王様プリン,308396,0.7283453781115677
0,1694,34,一番くじアイドリッシュセブン王様プリン,310090,0.7323461338623589
0,2199,35,一番くじアイドリッシュセブン王様プリン,312289,0.7375395588304756
0,1955,36,一番くじアイドリッシュセブン王様プリン,314244,0.7421567238203203
0,1140,37,一番くじアイドリッシュセブン王様プリン,315384,0.7448490860138869
0,1363,38,一番くじアイドリッシュセブン王様プリン,316747,0.7480681120400547
0,1100,39,一番くじアイドリッシュセブン王様プリン,317847,0.7506660053847244
0,1021,40,一番くじアイドリッシュセブン王様プリン,318868,0.7530773227528222
0,1077,41,一番くじアイドリッシュセブン王様プリン,319945,0.755620896509376
0,1322,42,一番くじアイドリッシュセブン王様プリン,321267,0.7587430919654244
0,907,43,一番くじアイドリッシュセブン王様プリン,322174,0.7608851731141656
0,856,44,一番くじアイドリッシュセブン王様プリン,323030,0.7629068064805631
0,893,45,一番くじアイドリッシュセブン王様プリン,323923,0.7650158235321902
0,891,46,一番くじアイドリッシュセブン王様プリン,324814,0.7671201171413726
0,631,47,一番くじアイドリッシュセブン王様プリン,325445,0.768610363232724
0,830,48,一番くじアイドリッシュセブン王様プリン,326275,0.7705705918473383
0,1058,49,一番くじアイドリッシュセブン王様プリン,327333,0.7730692929006661
0,878,50,一番くじアイドリッシュセブン王様プリン,328211,0.7751428841339568
0,674,51,一番くじアイドリッシュセブン王様プリン,328885,0.7767346842378725
0,647,52,一番くじアイドリッシュセブン王様プリン,329532,0.7782627178687828
0,764,53,一番くじアイドリッシュセブン王様プリン,330296,0.7800670728827169
0,696,54,一番くじアイドリッシュセブン王様プリン,330992,0.781710830853526
0,783,55,一番くじアイドリッシュセブン王様プリン,331775,0.7835600585706863
0,804,56,一番くじアイドリッシュセブン王様プリン,332579,0.7854588824335176
0,1001,57,一番くじアイドリッシュセブン王様プリン,333580,0.7878229653771669
0,612,58,一番くじアイドリッシュセブン王様プリン,334192,0.7892683387652921
0,763,59,一番くじアイドリッシュセブン王様プリン,334955,0.7910703320580039
0,154,0,ポケモンマスコットイーブイ茶房,154,0.005800376647834275
13470,3159,1,ポケモンマスコットイーブイ茶房,3313,0.12478342749529191
13065,3655,2,ポケモンマスコットイーブイ茶房,6968,0.2624482109227872
0,2600,3,ポケモンマスコットイーブイ茶房,9568,0.360376647834275
0,1969,4,ポケモンマスコットイーブイ茶房,11537,0.4345386064030132
15,1697,5,ポケモンマスコットイーブイ茶房,13234,0.49845574387947267
0,1584,6,ポケモンマスコットイーブイ茶房,14818,0.5581167608286253
0,1462,7,ポケモンマスコットイーブイ茶房,16280,0.6131826741996234
0,1213,8,ポケモンマスコットイーブイ茶房,17493,0.6588700564971751
0,870,9,ポケモンマスコットイーブイ茶房,18363,0.6916384180790961
0,719,10,ポケモンマスコットイーブイ茶房,19082,0.7187193973634651
0,571,11,ポケモンマスコットイーブイ茶房,19653,0.740225988700565
0,458,12,ポケモンマスコットイーブイ茶房,20111,0.7574764595103578
0,375,13,ポケモンマスコットイーブイ茶房,20486,0.7716007532956686
0,448,14,ポケモンマスコットイーブイ茶房,20934,0.7884745762711864
0,442,15,ポケモンマスコットイーブイ茶房,21376,0.8051224105461393
0,366,16,ポケモンマスコットイーブイ茶房,21742,0.8189077212806026
0,231,17,ポケモンマスコットイーブイ茶房,21973,0.827608286252354
0,187,18,ポケモンマスコットイーブイ茶房,22160,0.8346516007532957
0,212,19,ポケモンマスコットイーブイ茶房,22372,0.8426365348399246
0,148,20,ポケモンマスコットイーブイ茶房,22520,0.848210922787194
0,179,21,ポケモンマスコットイーブイ茶房,22699,0.8549529190207157
0,176,22,ポケモンマスコットイーブイ茶房,22875,0.8615819209039548
0,154,23,ポケモンマスコットイーブイ茶房,23029,0.8673822975517891
0,96,24,ポケモンマスコットイーブイ茶房,23125,0.8709981167608286
0,101,25,ポケモンマスコットイーブイ茶房,23226,0.8748022598870057
0,94,26,ポケモンマスコットイーブイ茶房,23320,0.8783427495291902
0,82,27,ポケモンマスコットイーブイ茶房,23402,0.8814312617702448
0,140,28,ポケモンマスコットイーブイ茶房,23542,0.8867043314500942
0,143,29,ポケモンマスコットイーブイ茶房,23685,0.892090395480226
0,159,30,ポケモンマスコットイーブイ茶房,23844,0.8980790960451978
0,82,31,ポケモンマスコットイーブイ茶房,23926,0.9011676082862523
0,47,32,ポケモンマスコットイーブイ茶房,23973,0.9029378531073446
0,73,33,ポケモンマスコットイーブイ茶房,24046,0.9056873822975517
0,77,34,ポケモンマスコットイーブイ茶房,24123,0.9085875706214689
0,84,35,ポケモンマスコットイーブイ茶房,24207,0.9117514124293785
0,82,36,ポケモンマスコットイーブイ茶房,24289,0.9148399246704332
0,87,37,ポケモンマスコットイーブイ茶房,24376,0.9181167608286253
0,82,38,ポケモンマスコットイーブイ茶房,24458,0.9212052730696798
0,48,39,ポケモンマスコットイーブイ茶房,24506,0.9230131826741996
0,57,40,ポケモンマスコットイーブイ茶房,24563,0.9251600753295669
0,61,41,ポケモンマスコットイーブイ茶房,24624,0.9274576271186441
0,72,42,ポケモンマスコットイーブイ茶房,24696,0.9301694915254237
0,55,43,ポケモンマスコットイーブイ茶房,24751,0.9322410546139359
0,60,44,ポケモンマスコットイーブイ茶房,24811,0.9345009416195856
0,69,45,ポケモンマスコットイーブイ茶房,24880,0.9370998116760829
0,87,46,ポケモンマスコットイーブイ茶房,24967,0.940376647834275
0,68,47,ポケモンマスコットイーブイ茶房,25035,0.9429378531073447
0,72,48,ポケモンマスコットイーブイ茶房,25107,0.9456497175141243
0,49,49,ポケモンマスコットイーブイ茶房,25156,0.9474952919020716
0,73,50,ポケモンマスコットイーブイ茶房,25229,0.9502448210922787
0,44,51,ポケモンマスコットイーブイ茶房,25273,0.9519020715630885
0,21,52,ポケモンマスコットイーブイ茶房,25294,0.9526930320150659
0,24,53,ポケモンマスコットイーブイ茶房,25318,0.9535969868173259
0,16,54,ポケモンマスコットイーブイ茶房,25334,0.9541996233521657
0,30,55,ポケモンマスコットイーブイ茶房,25364,0.9553295668549906
0,15,56,ポケモンマスコットイーブイ茶房,25379,0.955894538606403
0,22,57,ポケモンマスコットイーブイ茶房,25401,0.9567231638418079
0,31,58,ポケモンマスコットイーブイ茶房,25432,0.9578907721280603
0,34,59,ポケモンマスコットイーブイ茶房,25466,0.9591713747645951
0,10422,0,一番くじプレミアム劇場版マクロスＦ,10422,0.039427987742594484
133320,59891,1,一番くじプレミアム劇場版マクロスＦ,70313,0.26600461544281767
130680,54640,2,一番くじプレミアム劇場版マクロスＦ,124953,0.47271592327772105
0,30418,3,一番くじプレミアム劇場版マクロスＦ,155371,0.5877917754322248
330,20769,4,一番くじプレミアム劇場版マクロスＦ,176140,0.6663640146786214
0,14143,5,一番くじプレミアム劇場版マクロスＦ,190283,0.7198691030151705
0,10589,6,一番くじプレミアム劇場版マクロスＦ,200872,0.7599288767828094
0,8347,7,一番くじプレミアム劇場版マクロスＦ,209219,0.7915068285854803
0,7816,8,一番くじプレミアム劇場版マクロスＦ,217035,0.8210759278175008
0,6006,9,一番くじプレミアム劇場版マクロスＦ,223041,0.8437975258199978
0,4839,10,一番くじプレミアム劇場版マクロスＦ,227880,0.8621041879468846
0,3717,11,一番くじプレミアム劇場版マクロスＦ,231597,0.8761661559414369
0,2962,12,一番くじプレミアム劇場版マクロスＦ,234559,0.8873718457988121
0,2533,13,一番くじプレミアム劇場版マクロスＦ,237092,0.8969545643702947
0,2074,14,一番くじプレミアム劇場版マクロスＦ,239166,0.9048008171603678
0,1790,15,一番くじプレミアム劇場版マクロスＦ,240956,0.9115726553928801
0,1304,16,一番くじプレミアム劇場版マクロスＦ,242260,0.9165058827980176
0,1045,17,一番くじプレミアム劇場版マクロスＦ,243305,0.9204592743918587
0,820,18,一番くじプレミアム劇場版マクロスＦ,244125,0.9235614572693225
0,900,19,一番くじプレミアム劇場版マクロスＦ,245025,0.9269662921348315
0,601,20,一番くじプレミアム劇場版マクロスＦ,245626,0.9292399651950214
0,580,21,一番くじプレミアム劇場版マクロスＦ,246206,0.9314341921083494
0,744,22,一番くじプレミアム劇場版マクロスＦ,246950,0.9342488555971702
0,576,23,一番くじプレミアム劇場版マクロスＦ,247526,0.936427949911096
0,490,24,一番くじプレミアム劇場版マクロスＦ,248016,0.9382816933378731
0,666,25,一番くじプレミアム劇場版マクロスＦ,248682,0.9408012711383498
0,626,26,一番くじプレミアム劇場版マクロスＦ,249308,0.9431695229448038
0,468,27,一番くじプレミアム劇場版マクロスＦ,249776,0.9449400370748685
0,430,28,一番くじプレミアム劇場版マクロスＦ,250206,0.9465667915106117
0,595,29,一番くじプレミアム劇場版マクロスＦ,250801,0.9488177656716983
0,518,30,一番くじプレミアム劇場版マクロスＦ,251319,0.9507774372942912
0,240,31,一番くじプレミアム劇場版マクロスＦ,251559,0.9516853932584269
0,366,32,一番くじプレミアム劇場版マクロスＦ,251925,0.9530700261037339
0,218,33,一番くじプレミアム劇場版マクロスＦ,252143,0.9538947527711573
0,241,34,一番くじプレミアム劇場版マクロスＦ,252384,0.9548064918851435
0,216,35,一番くじプレミアム劇場版マクロスＦ,252600,0.9556236522528657
0,249,36,一番くじプレミアム劇場版マクロスＦ,252849,0.9565656565656566
0,207,37,一番くじプレミアム劇場版マクロスＦ,253056,0.9573487685847236
0,352,38,一番くじプレミアム劇場版マクロスＦ,253408,0.9586804373321227
0,154,39,一番くじプレミアム劇場版マクロスＦ,253562,0.9592630424091099
0,147,40,一番くじプレミアム劇場版マクロスＦ,253709,0.959819165437143
0,87,41,一番くじプレミアム劇場版マクロスＦ,253796,0.9601482994741422
0,123,42,一番くじプレミアム劇場版マクロスＦ,253919,0.9606136269057617
0,167,43,一番くじプレミアム劇場版マクロスＦ,254086,0.9612454129308062
0,160,44,一番くじプレミアム劇場版マクロスＦ,254246,0.9618507169068967
0,117,45,一番くじプレミアム劇場版マクロスＦ,254363,0.9622933454394128
0,150,46,一番くじプレミアム劇場版マクロスＦ,254513,0.9628608179169977
0,66,47,一番くじプレミアム劇場版マクロスＦ,254579,0.963110505807135
0,125,48,一番くじプレミアム劇場版マクロスＦ,254704,0.9635833995384557
0,59,49,一番くじプレミアム劇場版マクロスＦ,254763,0.9638066053796391
0,95,50,一番くじプレミアム劇場版マクロスＦ,254858,0.9641660046154428
0,60,51,一番くじプレミアム劇場版マクロスＦ,254918,0.9643929936064768
0,66,52,一番くじプレミアム劇場版マクロスＦ,254984,0.964642681496614
0,120,53,一番くじプレミアム劇場版マクロスＦ,255104,0.965096659478682
0,52,54,一番くじプレミアム劇場版マクロスＦ,255156,0.9652933832709114
0,133,55,一番くじプレミアム劇場版マクロスＦ,255289,0.9657965422010366
0,68,56,一番くじプレミアム劇場版マクロスＦ,255357,0.9660537963908751
0,97,57,一番くじプレミアム劇場版マクロスＦ,255454,0.9664207619263799
0,80,58,一番くじプレミアム劇場版マクロスＦ,255534,0.9667234139144252
0,67,59,一番くじプレミアム劇場版マクロスＦ,255601,0.966976884954413
462,80,0,一番くじ鬼灯の冷徹ゆかいな仲間たち※,80,0.12121212121212122
198,52,1,一番くじ鬼灯の冷徹ゆかいな仲間たち※,132,0.2
0,37,2,一番くじ鬼灯の冷徹ゆかいな仲間たち※,169,0.25606060606060604
0,94,3,一番くじ鬼灯の冷徹ゆかいな仲間たち※,263,0.3984848484848485
0,21,4,一番くじ鬼灯の冷徹ゆかいな仲間たち※,284,0.4303030303030303
0,18,5,一番くじ鬼灯の冷徹ゆかいな仲間たち※,302,0.4575757575757576
0,10,6,一番くじ鬼灯の冷徹ゆかいな仲間たち※,312,0.4727272727272727
0,46,7,一番くじ鬼灯の冷徹ゆかいな仲間たち※,358,0.5424242424242425
0,4,8,一番くじ鬼灯の冷徹ゆかいな仲間たち※,362,0.5484848484848485
0,9,9,一番くじ鬼灯の冷徹ゆかいな仲間たち※,371,0.5621212121212121
0,3,10,一番くじ鬼灯の冷徹ゆかいな仲間たち※,374,0.5666666666666667
0,9,11,一番くじ鬼灯の冷徹ゆかいな仲間たち※,383,0.5803030303030303
0,2,12,一番くじ鬼灯の冷徹ゆかいな仲間たち※,385,0.5833333333333334
0,5,13,一番くじ鬼灯の冷徹ゆかいな仲間たち※,390,0.5909090909090909
0,3,14,一番くじ鬼灯の冷徹ゆかいな仲間たち※,393,0.5954545454545455
0,12,15,一番くじ鬼灯の冷徹ゆかいな仲間たち※,405,0.6136363636363636
0,17,16,一番くじ鬼灯の冷徹ゆかいな仲間たち※,422,0.6393939393939394
0,22,17,一番くじ鬼灯の冷徹ゆかいな仲間たち※,444,0.6727272727272727
0,5,18,一番くじ鬼灯の冷徹ゆかいな仲間たち※,449,0.6803030303030303
0,3,19,一番くじ鬼灯の冷徹ゆかいな仲間たち※,452,0.6848484848484848
0,4,20,一番くじ鬼灯の冷徹ゆかいな仲間たち※,456,0.6909090909090909
0,7,21,一番くじ鬼灯の冷徹ゆかいな仲間たち※,463,0.7015151515151515
0,5,22,一番くじ鬼灯の冷徹ゆかいな仲間たち※,468,0.7090909090909091
0,12,23,一番くじ鬼灯の冷徹ゆかいな仲間たち※,480,0.7272727272727273
0,6,24,一番くじ鬼灯の冷徹ゆかいな仲間たち※,486,0.7363636363636363
0,3,25,一番くじ鬼灯の冷徹ゆかいな仲間たち※,489,0.740909090909091
0,4,26,一番くじ鬼灯の冷徹ゆかいな仲間たち※,493,0.746969696969697
0,8,27,一番くじ鬼灯の冷徹ゆかいな仲間たち※,501,0.759090909090909
0,8,28,一番くじ鬼灯の冷徹ゆかいな仲間たち※,509,0.7712121212121212
0,15,29,一番くじ鬼灯の冷徹ゆかいな仲間たち※,524,0.793939393939394
0,12,30,一番くじ鬼灯の冷徹ゆかいな仲間たち※,536,0.8121212121212121
0,7,31,一番くじ鬼灯の冷徹ゆかいな仲間たち※,543,0.8227272727272728
0,11,32,一番くじ鬼灯の冷徹ゆかいな仲間たち※,554,0.8393939393939394
0,0,33,一番くじ鬼灯の冷徹ゆかいな仲間たち※,554,0.8393939393939394
0,1,34,一番くじ鬼灯の冷徹ゆかいな仲間たち※,555,0.8409090909090909
0,3,35,一番くじ鬼灯の冷徹ゆかいな仲間たち※,558,0.8454545454545455
0,9,36,一番くじ鬼灯の冷徹ゆかいな仲間たち※,567,0.8590909090909091
0,0,37,一番くじ鬼灯の冷徹ゆかいな仲間たち※,567,0.8590909090909091
0,1,38,一番くじ鬼灯の冷徹ゆかいな仲間たち※,568,0.8606060606060606
0,0,39,一番くじ鬼灯の冷徹ゆかいな仲間たち※,568,0.8606060606060606
0,7,40,一番くじ鬼灯の冷徹ゆかいな仲間たち※,575,0.8712121212121212
0,1,41,一番くじ鬼灯の冷徹ゆかいな仲間たち※,576,0.8727272727272727
0,2,42,一番くじ鬼灯の冷徹ゆかいな仲間たち※,578,0.8757575757575757
0,1,43,一番くじ鬼灯の冷徹ゆかいな仲間たち※,579,0.8772727272727273
0,2,44,一番くじ鬼灯の冷徹ゆかいな仲間たち※,581,0.8803030303030303
0,0,45,一番くじ鬼灯の冷徹ゆかいな仲間たち※,581,0.8803030303030303
0,0,46,一番くじ鬼灯の冷徹ゆかいな仲間たち※,581,0.8803030303030303
0,0,47,一番くじ鬼灯の冷徹ゆかいな仲間たち※,581,0.8803030303030303
0,2,48,一番くじ鬼灯の冷徹ゆかいな仲間たち※,583,0.8833333333333333
0,4,49,一番くじ鬼灯の冷徹ゆかいな仲間たち※,587,0.8893939393939394
0,0,50,一番くじ鬼灯の冷徹ゆかいな仲間たち※,587,0.8893939393939394
0,1,51,一番くじ鬼灯の冷徹ゆかいな仲間たち※,588,0.8909090909090909
0,4,52,一番くじ鬼灯の冷徹ゆかいな仲間たち※,592,0.896969696969697
0,0,53,一番くじ鬼灯の冷徹ゆかいな仲間たち※,592,0.896969696969697
0,1,54,一番くじ鬼灯の冷徹ゆかいな仲間たち※,593,0.8984848484848484
0,0,55,一番くじ鬼灯の冷徹ゆかいな仲間たち※,593,0.8984848484848484
0,3,56,一番くじ鬼灯の冷徹ゆかいな仲間たち※,596,0.9030303030303031
0,0,57,一番くじ鬼灯の冷徹ゆかいな仲間たち※,596,0.9030303030303031
0,3,58,一番くじ鬼灯の冷徹ゆかいな仲間たち※,599,0.9075757575757576
0,0,59,一番くじ鬼灯の冷徹ゆかいな仲間たち※,599,0.9075757575757576
0,5735,0,一番くじドラゴンボールサイヤ人超決戦,5735,0.004141855854749773
658805,79728,1,一番くじドラゴンボールサイヤ人超決戦,85463,0.061721957613684375
711440,110223,2,一番くじドラゴンボールサイヤ人超決戦,195686,0.14132575497690744
160,95712,3,一番くじドラゴンボールサイヤ人超決戦,291398,0.2104496098277898
0,126936,4,一番くじドラゴンボールサイヤ人超決戦,418334,0.3021236490219515
160,94265,5,一番くじドラゴンボールサイヤ人超決戦,512599,0.37020247066937734
0,53015,6,一番くじドラゴンボールサイヤ人超決戦,565614,0.4084902628471558
0,46251,7,一番くじドラゴンボールサイヤ人超決戦,611865,0.44189304839868704
0,43516,8,一番くじドラゴンボールサイヤ人超決戦,655381,0.47332059842053376
160,39889,9,一番くじドラゴンボールサイヤ人超決戦,695270,0.5021287044693766
0,41904,10,一番くじドラゴンボールサイヤ人超決戦,737174,0.5323920571698884
13520,37307,11,一番くじドラゴンボールサイヤ人超決戦,774481,0.559335425325625
0,47469,12,一番くじドラゴンボールサイヤ人超決戦,821950,0.5936178587291328
0,38661,13,一番くじドラゴンボールサイヤ人超決戦,860611,0.6215390948582489
0,25166,14,一番くじドラゴンボールサイヤ人超決戦,885777,0.6397141505584464
400,22010,15,一番くじドラゴンボールサイヤ人超決戦,907787,0.6556099216766752
0,20663,16,一番くじドラゴンボールサイヤ人超決戦,928450,0.6705328802689497
0,18827,17,一番くじドラゴンボールサイヤ人超決戦,947277,0.6841298672222844
0,26849,18,一番くじドラゴンボールサイヤ人超決戦,974126,0.7035203969248436
0,26407,19,一番くじドラゴンボールサイヤ人超決戦,1000533,0.722591711232843
0,15583,20,一番くじドラゴンボールサイヤ人超決戦,1016116,0.7338458594080071
0,18672,21,一番くじドラゴンボールサイヤ人超決戦,1034788,0.7473309043112133
0,11436,22,一番くじドラゴンボールサイヤ人超決戦,1046224,0.7555900609903622
0,9902,23,一番くじドラゴンボールサイヤ人超決戦,1056126,0.7627413524766276
0,11642,24,一番くじドラゴンボールサイヤ人超決戦,1067768,0.7711492837514309
0,17624,25,一番くじドラゴンボールサイヤ人超決戦,1085392,0.7838774559544143
0,15877,26,一番くじドラゴンボールサイヤ人超決戦,1101269,0.7953439329214347
0,9292,27,一番くじドラゴンボールサイヤ人超決戦,1110561,0.8020546782749369
0,7143,28,一番くじドラゴンボールサイヤ人超決戦,1117704,0.8072134012689173
0,7360,29,一番くじドラゴンボールサイヤ人超決戦,1125064,0.8125288431330774
0,7605,30,一番くじドラゴンボールサイヤ人超決戦,1132669,0.8180212256571179
0,8549,31,一番くじドラゴンボールサイヤ人超決戦,1141218,0.8241953713767789
0,11057,32,一番くじドラゴンボールサイヤ人超決戦,1152275,0.8321808116881945
0,9593,33,一番くじドラゴンボールサイヤ人超決戦,1161868,0.8391089412809781
0,7948,34,一番くじドラゴンボールサイヤ人超決戦,1169816,0.844849040728851
0,4707,35,一番くじドラゴンボールサイヤ人超決戦,1174523,0.8482484680188784
0,4298,36,一番くじドラゴンボールサイヤ人超決戦,1178821,0.851352512737922
0,4070,37,一番くじドラゴンボールサイヤ人超決戦,1182891,0.8542918943122605
0,4508,38,一番くじドラゴンボールサイヤ人超決戦,1187399,0.8575476024540586
0,6436,39,一番くじドラゴンボールサイヤ人超決戦,1193835,0.8621957252580986
0,6515,40,一番くじドラゴンボールサイヤ人超決戦,1200350,0.8669009023973654
0,3494,41,一番くじドラゴンボールサイヤ人超決戦,1203844,0.8694242928692915
0,3362,42,一番くじドラゴンボールサイヤ人超決戦,1207206,0.8718523520469146
0,3374,43,一番くじドラゴンボールサイヤ人超決戦,1210580,0.874289077705838
0,3645,44,一番くじドラゴンボールサイヤ人超決戦,1214225,0.8769215214007923
0,3458,45,一番くじドラゴンボールサイヤ人超決戦,1217683,0.8794189124288175
0,6340,46,一番くじドラゴンボールサイヤ人超決戦,1224023,0.8839977033824554
0,5419,47,一番くじドラゴンボールサイヤ人超決戦,1229442,0.8879113418962983
0,4110,48,一番くじドラゴンボールサイヤ人超決戦,1233552,0.8908796117416378
0,2219,49,一番くじドラゴンボールサイヤ人超決戦,1235771,0.8924821885754111
0,4485,50,一番くじドラゴンボールサイヤ人超決戦,1240256,0.8957212859613836
0,4194,51,一番くじドラゴンボールサイヤ人超決戦,1244450,0.8987502211758248
0,2220,52,一番くじドラゴンボールサイヤ人超決戦,1246670,0.9003535202163732
0,3720,53,一番くじドラゴンボールサイヤ人超決戦,1250390,0.9030401294194541
0,2860,54,一番くじドラゴンボールサイヤ人超決戦,1253250,0.9051056407960163
0,2326,55,一番くじドラゴンボールサイヤ人超決戦,1255576,0.906785493754717
0,1811,56,一番くじドラゴンボールサイヤ人超決戦,1257387,0.9080934102242814
0,1748,57,一番くじドラゴンボールサイヤ人超決戦,1259135,0.9093558276670194
0,1563,58,一番くじドラゴンボールサイヤ人超決戦,1260698,0.9104846368563784
0,1896,59,一番くじドラゴンボールサイヤ人超決戦,1262594,0.9118539409018196
0,22,0,＃一番くじ僕のヒーローアカデミアＬｅｔ’ｓ,22,0.0055
3120,756,1,＃一番くじ僕のヒーローアカデミアＬｅｔ’ｓ,778,0.1945
880,466,2,＃一番くじ僕のヒーローアカデミアＬｅｔ’ｓ,1244,0.311
0,385,3,＃一番くじ僕のヒーローアカデミアＬｅｔ’ｓ,1629,0.40725
0,267,4,＃一番くじ僕のヒーローアカデミアＬｅｔ’ｓ,1896,0.474
0,179,5,＃一番くじ僕のヒーローアカデミアＬｅｔ’ｓ,2075,0.51875
0,157,6,＃一番くじ僕のヒーローアカデミアＬｅｔ’ｓ,2232,0.558
0,107,7,＃一番くじ僕のヒーローアカデミアＬｅｔ’ｓ,2339,0.58475
0,118,8,＃一番くじ僕のヒーローアカデミアＬｅｔ’ｓ,2457,0.61425
0,160,9,＃一番くじ僕のヒーローアカデミアＬｅｔ’ｓ,2617,0.65425
0,151,10,＃一番くじ僕のヒーローアカデミアＬｅｔ’ｓ,2768,0.692
0,70,11,＃一番くじ僕のヒーローアカデミアＬｅｔ’ｓ,2838,0.7095
0,64,12,＃一番くじ僕のヒーローアカデミアＬｅｔ’ｓ,2902,0.7255
0,73,13,＃一番くじ僕のヒーローアカデミアＬｅｔ’ｓ,2975,0.74375
0,70,14,＃一番くじ僕のヒーローアカデミアＬｅｔ’ｓ,3045,0.76125
0,32,15,＃一番くじ僕のヒーローアカデミアＬｅｔ’ｓ,3077,0.76925
0,75,16,＃一番くじ僕のヒーローアカデミアＬｅｔ’ｓ,3152,0.788
0,36,17,＃一番くじ僕のヒーローアカデミアＬｅｔ’ｓ,3188,0.797
0,34,18,＃一番くじ僕のヒーローアカデミアＬｅｔ’ｓ,3222,0.8055
0,85,19,＃一番くじ僕のヒーローアカデミアＬｅｔ’ｓ,3307,0.82675
0,34,20,＃一番くじ僕のヒーローアカデミアＬｅｔ’ｓ,3341,0.83525
0,59,21,＃一番くじ僕のヒーローアカデミアＬｅｔ’ｓ,3400,0.85
0,14,22,＃一番くじ僕のヒーローアカデミアＬｅｔ’ｓ,3414,0.8535
0,11,23,＃一番くじ僕のヒーローアカデミアＬｅｔ’ｓ,3425,0.85625
0,58,24,＃一番くじ僕のヒーローアカデミアＬｅｔ’ｓ,3483,0.87075
0,27,25,＃一番くじ僕のヒーローアカデミアＬｅｔ’ｓ,3510,0.8775
0,73,26,＃一番くじ僕のヒーローアカデミアＬｅｔ’ｓ,3583,0.89575
0,5,27,＃一番くじ僕のヒーローアカデミアＬｅｔ’ｓ,3588,0.897
0,16,28,＃一番くじ僕のヒーローアカデミアＬｅｔ’ｓ,3604,0.901
0,22,29,＃一番くじ僕のヒーローアカデミアＬｅｔ’ｓ,3626,0.9065
0,24,30,＃一番くじ僕のヒーローアカデミアＬｅｔ’ｓ,3650,0.9125
0,13,31,＃一番くじ僕のヒーローアカデミアＬｅｔ’ｓ,3663,0.91575
0,3,32,＃一番くじ僕のヒーローアカデミアＬｅｔ’ｓ,3666,0.9165
0,13,33,＃一番くじ僕のヒーローアカデミアＬｅｔ’ｓ,3679,0.91975
0,16,34,＃一番くじ僕のヒーローアカデミアＬｅｔ’ｓ,3695,0.92375
0,41,35,＃一番くじ僕のヒーローアカデミアＬｅｔ’ｓ,3736,0.934
0,20,36,＃一番くじ僕のヒーローアカデミアＬｅｔ’ｓ,3756,0.939
0,28,37,＃一番くじ僕のヒーローアカデミアＬｅｔ’ｓ,3784,0.946
0,8,38,＃一番くじ僕のヒーローアカデミアＬｅｔ’ｓ,3792,0.948
0,7,39,＃一番くじ僕のヒーローアカデミアＬｅｔ’ｓ,3799,0.94975
0,5,40,＃一番くじ僕のヒーローアカデミアＬｅｔ’ｓ,3804,0.951
0,6,41,＃一番くじ僕のヒーローアカデミアＬｅｔ’ｓ,3810,0.9525
0,4,42,＃一番くじ僕のヒーローアカデミアＬｅｔ’ｓ,3814,0.9535
0,4,43,＃一番くじ僕のヒーローアカデミアＬｅｔ’ｓ,3818,0.9545
0,24,44,＃一番くじ僕のヒーローアカデミアＬｅｔ’ｓ,3842,0.9605
0,0,45,＃一番くじ僕のヒーローアカデミアＬｅｔ’ｓ,3842,0.9605
0,0,46,＃一番くじ僕のヒーローアカデミアＬｅｔ’ｓ,3842,0.9605
0,0,47,＃一番くじ僕のヒーローアカデミアＬｅｔ’ｓ,3842,0.9605
0,0,48,＃一番くじ僕のヒーローアカデミアＬｅｔ’ｓ,3842,0.9605
0,0,49,＃一番くじ僕のヒーローアカデミアＬｅｔ’ｓ,3842,0.9605
0,11,50,＃一番くじ僕のヒーローアカデミアＬｅｔ’ｓ,3853,0.96325
0,0,51,＃一番くじ僕のヒーローアカデミアＬｅｔ’ｓ,3853,0.96325
0,0,52,＃一番くじ僕のヒーローアカデミアＬｅｔ’ｓ,3853,0.96325
0,0,53,＃一番くじ僕のヒーローアカデミアＬｅｔ’ｓ,3853,0.96325
0,0,54,＃一番くじ僕のヒーローアカデミアＬｅｔ’ｓ,3853,0.96325
0,0,55,＃一番くじ僕のヒーローアカデミアＬｅｔ’ｓ,3853,0.96325
0,0,56,＃一番くじ僕のヒーローアカデミアＬｅｔ’ｓ,3853,0.96325
0,0,57,＃一番くじ僕のヒーローアカデミアＬｅｔ’ｓ,3853,0.96325
0,0,58,＃一番くじ僕のヒーローアカデミアＬｅｔ’ｓ,3853,0.96325
0,0,59,＃一番くじ僕のヒーローアカデミアＬｅｔ’ｓ,3853,0.96325
21648,24785,0,一番くじあつまれどうぶつの森,24785,0.04726029486915467
264990,318036,1,一番くじあつまれどうぶつの森,342821,0.6536946357610843
237468,163785,2,一番くじあつまれどうぶつの森,506606,0.9660015712117398
0,9743,3,一番くじあつまれどうぶつの森,516349,0.9845796245871755
0,1802,4,一番くじあつまれどうぶつの森,518151,0.9880156968629156
132,844,5,一番くじあつまれどうぶつの森,518995,0.9896250448100435
0,528,6,一番くじあつまれどうぶつの森,519523,0.9906318406821805
0,259,7,一番くじあつまれどうぶつの森,519782,0.9911257045664295
0,562,8,一番くじあつまれどうぶつの森,520344,0.9921973319909388
66,207,9,一番くじあつまれどうぶつの森,520551,0.9925920417362653
0,387,10,一番くじあつまれどうぶつの森,520938,0.9933299773470928
0,123,11,一番くじあつまれどうぶつの森,521061,0.9935645150218521
0,175,12,一番くじあつまれどうぶつの森,521236,0.9938982068355338
0,252,13,一番くじあつまれどうぶつの森,521488,0.9943787230472355
0,63,14,一番くじあつまれどうぶつの森,521551,0.994498852100161
0,223,15,一番くじあつまれどうぶつの森,521774,0.9949240708113096
132,22,16,一番くじあつまれどうぶつの森,521796,0.9949660206393154
0,0,17,一番くじあつまれどうぶつの森,521796,0.9949660206393154
0,0,18,一番くじあつまれどうぶつの森,521796,0.9949660206393154
0,0,19,一番くじあつまれどうぶつの森,521796,0.9949660206393154
0,0,20,一番くじあつまれどうぶつの森,521796,0.9949660206393154
0,0,21,一番くじあつまれどうぶつの森,521796,0.9949660206393154
0,0,22,一番くじあつまれどうぶつの森,521796,0.9949660206393154
0,0,23,一番くじあつまれどうぶつの森,521796,0.9949660206393154
0,12149,0,一番くじあつまれどうぶつの森,12149,0.010537262480094643
574927,245122,1,一番くじあつまれどうぶつの森,257271,0.2231403453384171
577765,285185,2,一番くじあつまれどうぶつの森,542456,0.4704915018439559
198,175554,3,一番くじあつまれどうぶつの森,718010,0.6227557686503215
66,142491,4,一番くじあつまれどうぶつの森,860501,0.7463433123206783
0,92324,5,一番くじあつまれどうぶつの森,952825,0.8264192215487842
0,51954,6,一番くじあつまれどうぶつの森,1004779,0.8714807850429678
0,26797,7,一番くじあつまれどうぶつの森,1031576,0.8947227821356583
0,20461,8,一番くじあつまれどうぶつの森,1052037,0.9124693396799184
0,15057,9,一番くじあつまれどうぶつの森,1067094,0.9255288146295262
0,13950,10,一番くじあつまれどうぶつの森,1081044,0.9376281488625758
0,12893,11,一番くじあつまれどうぶつの森,1093937,0.9488107091684331
0,8857,12,一番くじあつまれどうぶつの森,1102794,0.9564927022366855
0,5260,13,一番くじあつまれどうぶつの森,1108054,0.9610548884779645
0,3971,14,一番くじあつまれどうぶつの森,1112025,0.9644990788893939
0,3641,15,一番くじあつまれどうぶつの森,1115666,0.9676570484910092
0,2923,16,一番くじあつまれどうぶつの森,1118589,0.9701922709973321
0,2704,17,一番くじあつまれどうぶつの森,1121293,0.9725375469662328
0,3167,18,一番くじあつまれどうぶつの森,1124460,0.9752843994046607
0,2363,19,一番くじあつまれどうぶつの森,1126823,0.977333913870087
0,1949,20,一番くじあつまれどうぶつの森,1128772,0.9790243513195647
0,1385,21,一番くじあつまれどうぶつの森,1130157,0.9802256113849965
0,1169,22,一番くじあつまれどうぶつの森,1131326,0.9812395269203682
0,1059,23,一番くじあつまれどうぶつの森,1132385,0.9821580355191352
0,1149,24,一番くじあつまれどうぶつの森,1133534,0.9831546043387606
0,1423,25,一番くじあつまれどうぶつの森,1134957,0.9843888231641104
0,1157,26,一番くじあつまれどうぶつの森,1136114,0.9853923306700343
0,696,27,一番くじあつまれどうぶつの森,1136810,0.9859959963780057
0,540,28,一番くじあつまれどうぶつの森,1137350,0.9864643577031561
0,564,29,一番くじあつまれどうぶつの森,1137914,0.986953535087202
0,583,30,一番くじあつまれどうぶつの森,1138497,0.9874591918512068
0,503,31,一番くじあつまれどうぶつの森,1139000,0.9878954617522264
0,742,32,一番くじあつまれどうぶつの森,1139742,0.9885390249064144
0,598,33,一番くじあつまれどうぶつの森,1140340,0.9890576917072291
0,345,34,一番くじあつまれどうぶつの森,1140685,0.9893569225538529
0,219,35,一番くじあつまれどうぶつの森,1140904,0.989546869091275
0,324,36,一番くじあつまれどうぶつの森,1141228,0.9898278858863652
0,278,37,一番くじあつまれどうぶつの森,1141506,0.9900690052352388
0,219,38,一番くじあつまれどうぶつの森,1141725,0.9902589517726609
0,336,39,一番くじあつまれどうぶつの森,1142061,0.9905503765971988
0,359,40,一番くじあつまれどうぶつの森,1142420,0.9908617501448451
0,242,41,一番くじあつまれどうぶつの森,1142662,0.9910716454053754
0,224,42,一番くじあつまれどうぶつの森,1142886,0.991265928621734
0,179,43,一番くじあつまれどうぶつの森,1143065,0.9914211817276635
0,230,44,一番くじあつまれどうぶつの森,1143295,0.991620668958746
0,158,45,一番くじあつまれどうぶつの森,1143453,0.9917577080131419
0,264,46,一番くじあつまれどうぶつの森,1143717,0.9919866846609932
0,248,47,一番くじあつまれどうぶつの森,1143965,0.9922017839362474
0,93,48,一番くじあつまれどうぶつの森,1144058,0.9922824461644677
0,149,49,一番くじあつまれどうぶつの森,1144207,0.9924116791967776
0,186,50,一番くじあつまれどうぶつの森,1144393,0.9925730036532183
0,177,51,一番くじあつまれどうぶつの森,1144570,0.9927265220875732
0,115,52,一番くじあつまれどうぶつの森,1144685,0.9928262657031144
0,147,53,一番くじあつまれどうぶつの森,1144832,0.9929537640638498
0,155,54,一番くじあつまれどうぶつの森,1144987,0.9930882011108837
0,61,55,一番くじあつまれどうぶつの森,1145048,0.9931411085939099
0,60,56,一番くじあつまれどうぶつの森,1145108,0.9931931487411488
0,37,57,一番くじあつまれどうぶつの森,1145145,0.9932252401652795
0,97,58,一番くじあつまれどうぶつの森,1145242,0.9933093717366491
0,47,59,一番くじあつまれどうぶつの森,1145289,0.9933501365186529
1470,5496,0,一番くじディズニーハピネスモーメント,5496,0.004916044408983409
555800,61659,1,一番くじディズニーハピネスモーメント,67155,0.06006858847985459
559582,129247,2,一番くじディズニーハピネスモーメント,196402,0.1756770294783769
1120,106058,3,一番くじディズニーハピネスモーメント,302460,0.27054344831534244
0,83133,4,一番くじディズニーハピネスモーメント,385593,0.34490398686192497
0,68847,5,一番くじディズニーハピネスモーメント,454440,0.4064860300615758
0,59023,6,一番くじディズニーハピネスモーメント,513463,0.4592807333278472
0,50886,7,一番くじディズニーハピネスモーメント,564349,0.5047970789966117
0,47164,8,一番くじディズニーハピネスモーメント,611513,0.5469841820725385
0,50747,9,一番くじディズニーハピネスモーメント,662260,0.5923761954682228
0,44438,10,一番くじディズニーハピネスモーメント,706698,0.6321249548289224
0,33788,11,一番くじディズニーハピネスモーメント,740486,0.6623475364320395
0,22855,12,一番くじディズニーハピネスモーメント,763341,0.6827908033474899
0,23516,13,一番くじディズニーハピネスモーメント,786857,0.7038253194176598
0,20893,14,一番くじディズニーハピネスモーメント,807750,0.7225136228814317
0,19596,15,一番くじディズニーハピネスモーメント,827346,0.7400417899553835
0,21921,16,一番くじディズニーハピネスモーメント,849267,0.7596496155538779
0,18767,17,一番くじディズニーハピネスモーメント,868034,0.7764362613732723
0,13313,18,一番くじディズニーハピネスモーメント,881347,0.7883444308086428
0,11436,19,一番くじディズニーハピネスモーメント,892783,0.7985736673190384
0,10502,20,一番くじディズニーハピネスモーメント,903285,0.807967462512478
0,9658,21,一番くじディズニーハピネスモーメント,912943,0.8166063192995889
0,9466,22,一番くじディズニーハピネスモーメント,922409,0.825073436544028
0,8906,23,一番くじディズニーハピネスモーメント,931315,0.8330396467890072
0,7752,24,一番くじディズニーハピネスモーメント,939067,0.8399736308243856
0,5310,25,一番くじディズニーハピネスモーメント,944377,0.8447233025514056
0,4873,26,一番くじディズニーハピネスモーメント,949250,0.84908208792349
0,4460,27,一番くじディズニーハピネスモーメント,953710,0.853071454383473
0,4610,28,一番くじディズニーハピネスモーメント,958320,0.8571949923611683
0,4511,29,一番くじディズニーハピネスモーメント,962831,0.8612299771371734
0,5436,30,一番くじディズニーハピネスモーメント,968267,0.8660923529390718
0,5170,31,一番くじディズニーハピネスモーメント,973437,0.8707167979162269
0,4235,32,一番くじディズニーハピネスモーメント,977672,0.8745049070996411
0,2807,33,一番くじディズニーハピネスモーメント,980479,0.877015703434433
0,2970,34,一番くじディズニーハピネスモーメント,983449,0.8796722994851391
0,3084,35,一番くじディズニーハピネスモーメント,986533,0.8824308658893067
0,3193,36,一番くじディズニーハピネスモーメント,989726,0.885286930263012
0,3702,37,一番くじディズニーハピネスモーメント,993428,0.8885982833201547
0,3115,38,一番くじディズニーハピネスモーメント,996543,0.8913845785046495
0,2526,39,一番くじディズニーハピネスモーメント,999069,0.8936440268629268
0,2168,40,一番くじディズニーハピネスモーメント,1001237,0.8955832525322638
0,2092,41,一番くじディズニーハピネスモーメント,1003329,0.8974544979659598
0,1838,42,一番くじディズニーハピネスモーメント,1005167,0.8990985462963295
0,2378,43,一番くじディズニーハピネスモーメント,1007545,0.9012256120904638
0,2824,44,一番くじディズニーハピネスモーメント,1010369,0.9037516145305965
0,2754,45,一番くじディズニーハピネスモーメント,1013123,0.9062150035957967
0,2051,46,一番くじディズニーハピネスモーメント,1015174,0.9080495754813179
0,1753,47,一番くじディズニーハピネスモーメント,1016927,0.9096175932849839
0,1841,48,一番くじディズニーハピネスモーメント,1018768,0.9112643250457078
0,2025,49,一番くじディズニーハピネスモーメント,1020793,0.9130756405348256
0,1842,50,一番くじディズニーハピネスモーメント,1022635,0.9147232667723342
0,2011,51,一番くじディズニーハピネスモーメント,1024646,0.9165220595864655
0,1878,52,一番くじディズニーハピネスモーメント,1026524,0.9182018869882251
0,1618,53,一番くじディズニーハピネスモーメント,1028142,0.9196491504259499
0,1062,54,一番くじディズニーハピネスモーメント,1029204,0.9205990847713539
0,1211,55,一番くじディズニーハピネスモーメント,1030415,0.9216822961576855
0,954,56,一番くじディズニーハピネスモーメント,1031369,0.9225356270103365
0,1051,57,一番くじディズニーハピネスモーメント,1032420,0.9234757221111083
0,1399,58,一番くじディズニーハピネスモーメント,1033819,0.9247270951329729
0,1255,59,一番くじディズニーハピネスモーメント,1035074,0.9258496634978336
0,1812,0,一番くじきゅんキャラポケットモンスター,1812,0.003026860884671923
299880,28414,1,一番くじきゅんキャラポケットモンスター,30226,0.0504911131898971
298720,57152,2,一番くじきゅんキャラポケットモンスター,87378,0.14596084458105038
40,49386,3,一番くじきゅんキャラポケットモンスター,136764,0.22845783776560202
0,33832,4,一番くじきゅんキャラポケットモンスター,170596,0.2849726045703595
0,28520,5,一番くじきゅんキャラポケットモンスター,199116,0.33261392489643193
0,25931,6,一番くじきゅんキャラポケットモンスター,225047,0.3759304423359615
0,24308,7,一番くじきゅんキャラポケットモンスター,249355,0.4165358145128959
0,22877,8,一番くじきゅんキャラポケットモンスター,272232,0.45475076840839235
0,27629,9,一番くじきゅんキャラポケットモンスター,299861,0.5009037150875317
0,23451,10,一番くじきゅんキャラポケットモンスター,323312,0.5400775090204464
0,12554,11,一番くじきゅんキャラポケットモンスター,335866,0.5610483763196579
0,11829,12,一番くじきゅんキャラポケットモンスター,347695,0.5808081651743953
0,9842,13,一番くじきゅんキャラポケットモンスター,357537,0.5972487638647601
0,9476,14,一番くじきゅんキャラポケットモンスター,367013,0.6130779767472939
0,10066,15,一番くじきゅんキャラポケットモンスター,377079,0.6298927569156755
0,13375,16,一番くじきゅんキャラポケットモンスター,390454,0.6522350661499399
0,12139,17,一番くじきゅんキャラポケットモンスター,402593,0.6725126954430042
0,9164,18,一番くじきゅんキャラポケットモンスター,411757,0.6878207269811573
0,5539,19,一番くじきゅんキャラポケットモンスター,417296,0.6970733662969397
0,5212,20,一番くじきゅんキャラポケットモンスター,422508,0.7057797674729387
0,5352,21,一番くじきゅんキャラポケットモンスター,427860,0.7147200320726981
0,6079,22,一番くじきゅんキャラポケットモンスター,433939,0.7248747160229855
0,7555,23,一番くじきゅんキャラポケットモンスター,441494,0.7374949886409194
0,6782,24,一番くじきゅんキャラポケットモンスター,448276,0.74882400106909
0,3767,25,一番くじきゅんキャラポケットモンスター,452043,0.7551165976212749
0,3583,26,一番くじきゅんキャラポケットモンスター,455626,0.7611018308165174
0,3714,27,一番くじきゅんキャラポケットモンスター,459340,0.7673058933582788
0,3784,28,一番くじきゅんキャラポケットモンスター,463124,0.7736268876119203
0,3973,29,一番くじきゅんキャラポケットモンスター,467097,0.7802635974876386
0,5559,30,一番くじきゅんキャラポケットモンスター,472656,0.7895496458639583
0,4398,31,一番くじきゅんキャラポケットモンスター,477054,0.7968962982760924
0,3113,32,一番くじきゅんキャラポケットモンスター,480167,0.8020964185487104
0,2744,33,一番くじきゅんキャラポケットモンスター,482911,0.8066801416544167
0,2974,34,一番くじきゅんキャラポケットモンスター,485885,0.8116480689563009
0,2724,35,一番くじきゅんキャラポケットモンスター,488609,0.81619838300147
0,2584,36,一番くじきゅんキャラポケットモンスター,491193,0.8205148336228785
0,3593,37,一番くじきゅんキャラポケットモンスター,494786,0.8265167713483896
0,3232,38,一番くじきゅんキャラポケットモンスター,498018,0.831915675531204
0,1882,39,一番くじきゅんキャラポケットモンスター,499900,0.8350594681277562
0,1951,40,一番くじきゅんキャラポケットモンスター,501851,0.8383185219831618
0,1843,41,一番くじきゅんキャラポケットモンスター,503694,0.8413971669116664
0,1627,42,一番くじきゅんキャラポケットモンスター,505321,0.8441149939863691
0,1875,43,一番くじきゅんキャラポケットモンスター,507196,0.8472470934117332
0,2618,44,一番くじきゅんキャラポケットモンスター,509814,0.8516203394360551
0,2149,45,一番くじきゅんキャラポケットモンスター,511963,0.8552101429907791
0,1317,46,一番くじきゅんキャラポケットモンスター,513280,0.8574101296271549
0,1334,47,一番くじきゅんキャラポケットモンスター,514614,0.8596385139649872
0,1152,48,一番くじきゅんキャラポケットモンスター,515766,0.861562875851931
0,1292,49,一番くじきゅんキャラポケットモンスター,517058,0.8637211011626353
0,1404,50,一番くじきゅんキャラポケットモンスター,518462,0.866066417212348
0,1734,51,一番くじきゅんキャラポケットモンスター,520196,0.8689629827609248
0,1606,52,一番くじきゅんキャラポケットモンスター,521802,0.8716457303220634
0,943,53,一番くじきゅんキャラポケットモンスター,522745,0.8732209675263931
0,1205,54,一番くじきゅんキャラポケットモンスター,523950,0.8752338634237605
0,1306,55,一番くじきゅんキャラポケットモンスター,525256,0.8774154750768408
0,929,56,一番くじきゅんキャラポケットモンスター,526185,0.8789673259387946
0,996,57,一番くじきゅんキャラポケットモンスター,527181,0.880631097153548
0,1236,58,一番くじきゅんキャラポケットモンスター,528417,0.8826957770947481
0,1272,59,一番くじきゅんキャラポケットモンスター,529689,0.8848205933449151
490,963,0,一番くじチコちゃんに叱られる！,963,0.003343169588613088
148960,10582,1,一番くじチコちゃんに叱られる！,11545,0.040079847248741536
138530,16322,2,一番くじチコちゃんに叱られる！,27867,0.09674362089914945
0,12463,3,一番くじチコちゃんに叱られる！,40330,0.1400104148585315
0,10386,4,一番くじチコちゃんに叱られる！,50716,0.17606665509460162
0,9350,5,一番くじチコちゃんに叱られる！,60066,0.20852629751779206
0,9130,6,一番くじチコちゃんに叱られる！,69196,0.2402221836486721
70,8806,7,一番くじチコちゃんに叱られる！,78002,0.2707932650581496
0,11604,8,一番くじチコちゃんに叱られる！,89606,0.31107793785801074
0,9640,9,一番くじチコちゃんに叱られる！,99246,0.34454434993924665
0,7834,10,一番くじチコちゃんに叱られる！,107080,0.3717410171845166
0,8117,11,一番くじチコちゃんに叱られる！,115197,0.3999201527512585
0,5750,12,一番くじチコちゃんに叱られる！,120947,0.4198819649366429
0,5596,13,一番くじチコちゃんに叱られる！,126543,0.4393091477174102
0,6781,14,一番くじチコちゃんに叱られる！,133324,0.46285019961812185
0,8370,15,一番くじチコちゃんに叱られる！,141694,0.4919076549210207
0,7086,16,一番くじチコちゃんに叱られる！,148780,0.5165075507724354
0,4846,17,一番くじチコちゃんに叱られる！,153626,0.5333310189203263
0,4706,18,一番くじチコちゃんに叱られる！,158332,0.5496684603367471
0,4667,19,一番くじチコちゃんに叱られる！,162999,0.5658705085922583
0,4639,20,一番くじチコちゃんに叱られる！,167638,0.5819753515014754
0,4916,21,一番くじチコちゃんに叱られる！,172554,0.5990418330151015
0,5748,22,一番くじチコちゃんに叱られる！,178302,0.6189967019614651
0,5035,23,一番くじチコちゃんに叱られる！,183337,0.6364763061968408
0,4154,24,一番くじチコちゃんに叱られる！,187491,0.6508974136434647
0,2991,25,一番くじチコちゃんに叱られる！,190482,0.6612810275993751
0,3051,26,一番くじチコちゃんに叱られる！,193533,0.6718729387259157
0,2815,27,一番くじチコちゃんに叱られる！,196348,0.6816455476479778
0,2797,28,一番くじチコちゃんに叱られる！,199145,0.6913556674188509
0,3302,29,一番くじチコちゃんに叱られる！,202447,0.7028189550425273
0,3043,30,一番くじチコちゃんに叱られる！,205490,0.7133830932129839
0,2150,31,一番くじチコちゃんに叱られる！,207640,0.7208470751605625
0,2171,32,一番くじチコちゃんに叱られる！,209811,0.7283839611178615
0,2013,33,一番くじチコちゃんに叱られる！,211824,0.7353723311925013
0,1784,34,一番くじチコちゃんに叱られる！,213608,0.7415657003992362
0,1896,35,一番くじチコちゃんに叱られる！,215504,0.7481478909911474
0,1942,36,一番くじチコちゃんに叱られる！,217446,0.7548897760805415
0,1725,37,一番くじチコちゃんに叱られる！,219171,0.7608783197361569
0,1582,38,一番くじチコちゃんに叱られる！,220753,0.7663704218017705
0,1463,39,一番くじチコちゃんに叱られる！,222216,0.7714494011456344
0,1664,40,一番くじチコちゃんに叱られる！,223880,0.7772261760111092
0,1548,41,一番くじチコちゃんに叱られる！,225428,0.7826002430133657
0,1474,42,一番くじチコちゃんに叱られる！,226902,0.7877174101718452
0,1803,43,一番くじチコちゃんに叱られる！,228705,0.7939767401492797
0,1434,44,一番くじチコちゃんに叱られる！,230139,0.798955042527339
0,1351,45,一番くじチコちゃんに叱られる！,231490,0.8036452004860267
0,1095,46,一番くじチコちゃんに叱られる！,232585,0.8074466238500261
0,1161,47,一番くじチコちゃんに叱られる！,233746,0.8114771741017185
0,1232,48,一番くじチコちゃんに叱られる！,234978,0.8157542093386565
0,1137,49,一番くじチコちゃんに叱られる！,236115,0.8197014407220968
0,1158,50,一番くじチコちゃんに叱られる！,237273,0.8237215761152578
0,1015,51,一番くじチコちゃんに叱られる！,238288,0.827245269918417
0,856,52,一番くじチコちゃんに叱られる！,239144,0.8302169762194064
0,807,53,一番くじチコちゃんに叱られる！,239951,0.8330185731643812
0,812,54,一番くじチコちゃんに叱られる！,240763,0.8358375282069085
0,791,55,一番くじチコちゃんに叱られる！,241554,0.8385835792397154
0,901,56,一番くじチコちゃんに叱られる！,242455,0.8417115084186774
0,872,57,一番くじチコちゃんに叱られる！,243327,0.8447387606318347
0,807,58,一番くじチコちゃんに叱られる！,244134,0.8475403575768096
0,673,59,一番くじチコちゃんに叱られる！,244807,0.8498767575073772
0,5649,0,一番くじスター・ウォーズ,5649,0.005781050761494047
489660,50234,1,一番くじスター・ウォーズ,55883,0.05718931841114743
487258,81955,2,一番くじスター・ウォーズ,137838,0.14106009468274322
60,67009,3,一番くじスター・ウォーズ,204847,0.20963549395287148
120,55780,4,一番くじスター・ウォーズ,260627,0.2667194046408053
0,48102,5,一番くじスター・ウォーズ,308729,0.3159458347575315
0,42673,6,一番くじスター・ウォーズ,351402,0.35961635682254045
0,49078,7,一番くじスター・ウォーズ,400480,0.40984160186991253
0,39664,8,一番くじスター・ウォーズ,440144,0.45043278569074807
0,24120,9,一番くじスター・ウォーズ,464264,0.4751166136899048
0,21718,10,一番くじスター・ウォーズ,485982,0.4973422926486812
0,20800,11,一番くじスター・ウォーズ,506782,0.5186285124821165
0,21016,12,一番くじスター・ウォーズ,527798,0.5401357815215144
0,21002,13,一番くじスター・ウォーズ,548800,0.561628723297563
0,26532,14,一番くじスター・ウォーズ,575332,0.5887809340966353
0,22480,15,一番くじスター・ウォーズ,597812,0.611786425532002
0,13440,16,一番くじスター・ウォーズ,611252,0.6255405983474525
0,14551,17,一番くじスター・ウォーズ,625803,0.6404317418472755
0,13966,18,一番くじスター・ウォーズ,639769,0.6547242104142831
0,13075,19,一番くじスター・ウォーズ,652844,0.6681048510066949
0,14149,20,一番くじスター・ウォーズ,666993,0.6825845973731987
0,15977,21,一番くじスター・ウォーズ,682970,0.6989350749827561
0,13006,22,一番くじスター・ウォーズ,695976,0.7122451026343743
0,8536,23,一番くじスター・ウォーズ,704512,0.7209806397737111
0,8726,24,一番くじスター・ウォーズ,713238,0.7299106183442187
0,9235,25,一番くじスター・ウォーズ,722473,0.7393614952750732
0,7418,26,一番くじスター・ウォーズ,729891,0.7469528980983628
0,8324,27,一番くじスター・ウォーズ,738215,0.755471479535551
0,8569,28,一番くじスター・ウォーズ,746784,0.7642407880813543
0,8075,29,一番くじスター・ウォーズ,754859,0.7725045489061134
0,6768,30,一番くじスター・ウォーズ,761627,0.7794307573596082
0,7017,31,一番くじスター・ウォーズ,768644,0.786611786425532
60,7277,32,一番くじスター・ウォーズ,775921,0.7940588932393737
0,7682,33,一番くじスター・ウォーズ,783603,0.8019204673143954
0,9556,34,一番くじスター・ウォーズ,793159,0.8116998479263333
0,7303,35,一番くじスター・ウォーズ,800462,0.8191735625149669
0,6359,36,一番くじスター・ウォーズ,806821,0.8256812102034676
0,4777,37,一番くじスター・ウォーズ,811598,0.8305698771334831
0,4033,38,一番くじスター・ウォーズ,815631,0.8346971523540717
0,3589,39,一番くじスター・ウォーズ,819220,0.8383700486512928
0,3572,40,一番くじスター・ウォーズ,822792,0.842025547557304
0,3356,41,一番くじスター・ウォーズ,826148,0.8454599972573524
0,4392,42,一番くじスター・ウォーズ,830540,0.8499546644452586
0,4129,43,一番くじスター・ウォーズ,834669,0.8541801837573862
0,3444,44,一番くじスター・ウォーズ,838113,0.8577046905413455
0,2173,45,一番くじスター・ウォーズ,840286,0.8599284864883673
0,2016,46,一番くじスター・ウォーズ,842302,0.8619916124106849
0,1968,47,一番くじスター・ウォーズ,844270,0.8640056162872329
0,2275,48,一番くじスター・ウォーズ,846545,0.866333796581515
0,3157,49,一番くじスター・ウォーズ,849702,0.8695645944668109
0,2752,50,一番くじスター・ウォーズ,852454,0.8723809250909269
0,1483,51,一番くじスター・ウォーズ,853937,0.8738985916300127
0,1329,52,一番くじスター・ウォーズ,855266,0.8752586582722548
0,1299,53,一番くじスター・ウォーズ,856565,0.8765880236358911
0,1349,54,一番くじスター・ウォーズ,857914,0.8779685577972037
0,1594,55,一番くじスター・ウォーズ,859508,0.8795998190671314
0,2177,56,一番くじスター・ウォーズ,861685,0.8818277085179674
0,1606,57,一番くじスター・ウォーズ,863291,0.8834712502993375
0,1195,58,一番くじスター・ウォーズ,864486,0.8846941845638064
0,1238,59,一番くじスター・ウォーズ,865724,0.8859611239942773
0,4472,0,一番くじトイ・ストーリー２５ｔｈ,4472,0.006145803413999293
354355,38372,1,一番くじトイ・ストーリー２５ｔｈ,42844,0.05887987510496103
373230,64495,2,一番くじトイ・ストーリー２５ｔｈ,107339,0.14751439907318206
0,60515,3,一番くじトイ・ストーリー２５ｔｈ,167854,0.23067926794575971
66,59678,4,一番くじトイ・ストーリー２５ｔｈ,227532,0.31269386010601236
0,64996,5,一番くじトイ・ストーリー２５ｔｈ,292528,0.4020169009593885
0,39251,6,一番くじトイ・ストーリー２５ｔｈ,331779,0.4559589693410715
0,38004,7,一番くじトイ・ストーリー２５ｔｈ,369783,0.5081873040784662
0,33399,8,一番くじトイ・ストーリー２５ｔｈ,403182,0.5540870554702735
0,31854,9,一番くじトイ・ストーリー２５ｔｈ,435036,0.5978635362282193
0,35381,10,一番くじトイ・ストーリー２５ｔｈ,470417,0.646487120886249
0,26112,11,一番くじトイ・ストーリー２５ｔｈ,496529,0.6823724560263094
0,21831,12,一番くじトイ・ストーリー２５ｔｈ,518360,0.7123744762255532
0,15913,13,一番くじトイ・ストーリー２５ｔｈ,534273,0.7342434766117273
0,12327,14,一番くじトイ・ストーリー２５ｔｈ,546600,0.7511842902710227
0,11407,15,一番くじトイ・ストーリー２５ｔｈ,558007,0.7668607615464007
0,8958,16,一番くじトイ・ストーリー２５ｔｈ,566965,0.779171608367198
0,8476,17,一番くじトイ・ストーリー２５ｔｈ,575441,0.7908200497216386
0,9506,18,一番くじトイ・ストーリー２５ｔｈ,584947,0.8038840048319867
0,10292,19,一番くじトイ・ストーリー２５ｔｈ,595239,0.8180281481094646
0,7831,20,一番くじトイ・ストーリー２５ｔｈ,603070,0.8287901755099629
0,5276,21,一番くじトイ・ストーリー２５ｔｈ,608346,0.8360409042246901
0,5119,22,一番くじトイ・ストーリー２５ｔｈ,613465,0.8430758701630314
0,4567,23,一番くじトイ・ストーリー２５ｔｈ,618032,0.8493522306710223
0,4876,24,一番くじトイ・ストーリー２５ｔｈ,622908,0.8560532453057853
0,6121,25,一番くじトイ・ストーリー２５ｔｈ,629029,0.8644652450144369
0,5393,26,一番くじトイ・ストーリー２５ｔｈ,634422,0.8718767650975536
0,3149,27,一番くじトイ・ストーリー２５ｔｈ,637571,0.8762043891920714
0,2888,28,一番くじトイ・ストーリー２５ｔｈ,640459,0.8801733248494127
0,3202,29,一番くじトイ・ストーリー２５ｔｈ,643661,0.8845737860595257
0,2821,30,一番くじトイ・ストーリー２５ｔｈ,646482,0.888450644608473
0,2744,31,一番くじトイ・ストーリー２５ｔｈ,649226,0.8922216831970271
0,3473,32,一番くじトイ・ストーリー２５ｔｈ,652699,0.8969945756963159
0,2837,33,一番くじトイ・ストーリー２５ｔｈ,655536,0.9008934228084617
0,2244,34,一番くじトイ・ストーリー２５ｔｈ,657780,0.9039773187970607
0,2246,35,一番くじトイ・ストーリー２５ｔｈ,660026,0.9070639633560594
0,1813,36,一番くじトイ・ストーリー２５ｔｈ,661839,0.909555542423497
0,1720,37,一番くじトイ・ストーリー２５ｔｈ,663559,0.9119193129673429
0,2022,38,一番くじトイ・ストーリー２５ｔｈ,665581,0.9146981176415617
0,2686,39,一番くじトイ・ストーリー２５ｔｈ,668267,0.918389447688521
0,2276,40,一番くじトイ・ストーリー２５ｔｈ,670543,0.9215173208035171
0,1245,41,一番くじトイ・ストーリー２５ｔｈ,671788,0.9232283058774056
0,1310,42,一番くじトイ・ストーリー２５ｔｈ,673098,0.9250286194892882
0,1194,43,一番くじトイ・ストーリー２５ｔｈ,674292,0.9266695160179812
0,1120,44,一番くじトイ・ストーリー２５ｔｈ,675412,0.9282087154418808
0,1334,45,一番くじトイ・ストーリー２５ｔｈ,676746,0.9300420118985613
0,2014,46,一番くじトイ・ストーリー２５ｔｈ,678760,0.9328098222911808
0,1697,47,一番くじトイ・ストーリー２５ｔｈ,680457,0.9351419842754287
0,1010,48,一番くじトイ・ストーリー２５ｔｈ,681467,0.9365300123273382
0,1055,49,一番くじトイ・ストーリー２５ｔｈ,682522,0.9379798832132437
0,966,50,一番くじトイ・ストーリー２５ｔｈ,683488,0.9393074427163571
0,1310,51,一番くじトイ・ストーリー２５ｔｈ,684798,0.9411077563282397
0,1112,52,一番くじトイ・ストーリー２５ｔｈ,685910,0.9426359614705402
0,1323,53,一番くじトイ・ストーリー２５ｔｈ,687233,0.9444541407900215
0,1181,54,一番くじトイ・ストーリー２５ｔｈ,688414,0.9460771716111158
0,729,55,一番くじトイ・ストーリー２５ｔｈ,689143,0.9470790255218504
0,804,56,一番くじトイ・ストーリー２５ｔｈ,689947,0.9481839508225784
0,635,57,一番くじトイ・ストーリー２５ｔｈ,690582,0.9490566219245216
0,661,58,一番くじトイ・ストーリー２５ｔｈ,691243,0.9499650244416623
0,819,59,一番くじトイ・ストーリー２５ｔｈ,692062,0.9510905640203889
0,4112,0,一番くじうさまるもぐもぐバーガーショップ,4112,0.009329594235254613
213444,88207,1,一番くじうさまるもぐもぐバーガーショップ,92319,0.20945982738435567
227304,87320,2,一番くじうさまるもぐもぐバーガーショップ,179639,0.4075775726719123
0,49013,3,一番くじうさまるもぐもぐバーガーショップ,228652,0.5187817074609528
0,36912,4,一番くじうさまるもぐもぐバーガーショップ,265564,0.602530244039678
0,24199,5,一番くじうさまるもぐもぐバーガーショップ,289763,0.6574346338497282
0,14850,6,一番くじうさまるもぐもぐバーガーショップ,304613,0.6911273562216959
0,12247,7,一番くじうさまるもぐもぐバーガーショップ,316860,0.7189142094802472
0,9776,8,一番くじうさまるもぐもぐバーガーショップ,326636,0.7410946844909109
0,8166,9,一番くじうさまるもぐもぐバーガーショップ,334802,0.759622278490203
0,8127,10,一番くじうさまるもぐもぐバーガーショップ,342929,0.7780613865519526
0,8055,11,一番くじうさまるもぐもぐバーガーショップ,350984,0.7963371359597775
0,10446,12,一番くじうさまるもぐもぐバーガーショップ,361430,0.8200377540000181
0,4936,13,一番くじうさまるもぐもぐバーガーショップ,366366,0.8312368972746331
0,5011,14,一番くじうさまるもぐもぐバーガーショップ,371377,0.842606205813753
0,4058,15,一番くじうさまるもぐもぐバーガーショップ,375435,0.8518132810585641
0,3795,16,一番くじうさまるもぐもぐバーガーショップ,379230,0.8604236434425113
0,4766,17,一番くじうさまるもぐもぐバーガーショップ,383996,0.8712370787842486
0,4048,18,一番くじうさまるもぐもぐバーガーショップ,388044,0.8804214653271257
0,3157,19,一番くじうさまるもぐもぐバーガーショップ,391201,0.8875842885276848
0,2563,20,一番くじうさまるもぐもぐバーガーショップ,393764,0.893399402833365
0,2433,21,一番くじうさまるもぐもぐバーガーショップ,396197,0.8989195640139036
0,2132,22,一番くじうさまるもぐもぐバーガーショップ,398329,0.9037567952662292
0,1915,23,一番くじうさまるもぐもぐバーガーショップ,400244,0.9081016816865873
0,1720,24,一番くじうさまるもぐもぐバーガーショップ,401964,0.9120041384192328
0,1816,25,一番くじうさまるもぐもぐバーガーショップ,403780,0.9161244066904445
0,1838,26,一番くじうさまるもぐもぐバーガーショップ,405618,0.9202945901059109
0,1627,27,一番くじうさまるもぐもぐバーガーショップ,407245,0.9239860419105702
0,1166,28,一番くじうさまるもぐもぐバーガーショップ,408411,0.9266315445560729
0,1210,29,一番くじうさまるもぐもぐバーガーショップ,409621,0.929376877490085
0,952,30,一番くじうさまるもぐもぐバーガーショップ,410573,0.9315368419142004
0,1040,31,一番くじうさまるもぐもぐバーガーショップ,411613,0.9338964669153348
0,1210,32,一番くじうさまるもぐもぐバーガーショップ,412823,0.936641799849347
0,1096,33,一番くじうさまるもぐもぐバーガーショップ,413919,0.9391284815813118
0,765,34,一番くじうさまるもぐもぐバーガーショップ,414684,0.9408641672792616
0,703,35,一番くじうさまるもぐもぐバーガーショップ,415387,0.9424591830252208
0,595,36,一番くじうさまるもぐもぐバーガーショップ,415982,0.9438091607902929
0,725,37,一番くじうさまるもぐもぐバーガーショップ,416707,0.9454540916805068
0,676,38,一番くじうさまるもぐもぐバーガーショップ,417383,0.9469878479312441
0,756,39,一番くじうさまるもぐもぐバーガーショップ,418139,0.9487031137974534
0,616,40,一番くじうさまるもぐもぐバーガーショップ,418755,0.9501007378365869
0,568,41,一番くじうさまるもぐもぐバーガーショップ,419323,0.9513894561064372
0,516,42,一番くじうさまるもぐもぐバーガーショップ,419839,0.9525601931262309
0,418,43,一番くじうさまるもぐもぐバーガーショップ,420257,0.9535085808670715
0,474,44,一番くじうさまるもぐもぐバーガーショップ,420731,0.9545840253387423
0,503,45,一番くじうさまるもぐもぐバーガーショップ,421234,0.9557252670460218
0,645,46,一番くじうさまるもぐもぐバーガーショップ,421879,0.9571886883207638
0,479,47,一番くじうさまるもぐもぐバーガーショップ,422358,0.9582754771434017
0,295,48,一番くじうさまるもぐもぐバーガーショップ,422653,0.9589447938504543
0,270,49,一番くじうさまるもぐもぐバーガーショップ,422923,0.9595573888026718
0,335,50,一番くじうさまるもぐもぐバーガーショップ,423258,0.9603174603174603
0,291,51,一番くじうさまるもぐもぐバーガーショップ,423549,0.9609777015437393
0,326,52,一番くじうさまるもぐもぐバーガーショップ,423875,0.9617173532267872
0,354,53,一番くじうさまるもぐもぐバーガーショップ,424229,0.9625205332752502
0,385,54,一番くじうさまるもぐもぐバーガーショップ,424614,0.9633940482997086
0,221,55,一番くじうさまるもぐもぐバーガーショップ,424835,0.9638954686124498
0,144,56,一番くじうさまるもぐもぐバーガーショップ,424979,0.9642221859202992
0,262,57,一番くじうさまるもぐもぐバーガーショップ,425241,0.9648166299109695
0,311,58,一番くじうさまるもぐもぐバーガーショップ,425552,0.9655222485411165
0,288,59,一番くじうさまるもぐもぐバーガーショップ,425840,0.9661756831568152
0,3055,0,一番くじカードキャプターさくら,3055,0.0126563924103074
132420,35380,1,一番くじカードキャプターさくら,38435,0.15923025934211615
108900,35676,2,一番くじカードキャプターさくら,74111,0.3070304084845472
0,19636,3,一番くじカードキャプターさくら,93747,0.3883793189162317
0,14716,4,一番くじカードキャプターさくら,108463,0.44934543044162734
60,11472,5,一番くじカードキャプターさくら,119935,0.496872151793852
0,9507,6,一番くじカードキャプターさくら,129442,0.5362581821194796
0,8424,7,一番くじカードキャプターさくら,137866,0.5711575109785401
0,8432,8,一番くじカードキャプターさくら,146298,0.6060899826000498
0,6581,9,一番くじカードキャプターさくら,152879,0.6333540475598641
0,4543,10,一番くじカードキャプターさくら,157422,0.6521749937857321
0,4134,11,一番くじカードキャプターさくら,161556,0.669301516281382
0,3636,12,一番くじカードキャプターさくら,165192,0.6843649018145662
0,3123,13,一番くじカードキャプターさくら,168315,0.6973030077056923
0,3263,14,一番くじカードキャプターさくら,171578,0.7108211119396801
0,3040,15,一番くじカードキャプターさくら,174618,0.7234153616703952
0,2742,16,一番くじカードキャプターさくら,177360,0.7347750434998758
0,2186,17,一番くじカードキャプターさくら,179546,0.7438313033391333
0,1773,18,一番くじカードキャプターさくら,181319,0.7511765680669483
0,1790,19,一番くじカードキャプターさくら,183109,0.7585922611649681
0,1733,20,一番くじカードキャプターさくら,184842,0.7657718120805369
0,1900,21,一番くじカードキャプターさくら,186742,0.7736432181622338
0,2220,22,一番くじカードキャプターさくら,188962,0.7828403347419007
0,1828,23,一番くじカードキャプターさくら,190790,0.7904134559615544
0,1357,24,一番くじカードキャプターさくら,192147,0.7960352970420085
0,1140,25,一番くじカードキャプターさくら,193287,0.8007581406910266
0,1141,26,一番くじカードキャプターさくら,194428,0.8054851271853509
0,1306,27,一番くじカードキャプターさくら,195734,0.810895683155191
0,1317,28,一番くじカードキャプターさくら,197051,0.8163518104233988
0,1422,29,一番くじカードキャプターさくら,198473,0.822242936448753
0,1319,30,一番くじカードキャプターさくら,199792,0.8277073494075731
0,1061,31,一番くじカードキャプターさくら,200853,0.832102908277405
0,1047,32,一番くじカードキャプターさくら,201900,0.8364404673129505
0,959,33,一番くじカードキャプターさくら,202859,0.8404134559615544
0,4078,34,一番くじカードキャプターさくら,206937,0.8573079791200596
0,921,35,一番くじカードキャプターさくら,207858,0.8611235396470296
0,1164,36,一番くじカードキャプターさくら,209022,0.8659458115833955
0,912,37,一番くじカードキャプターさくら,209934,0.86972408650261
0,536,38,一番くじカードキャプターさくら,210470,0.8719446515867098
0,636,39,一番くじカードキャプターさくら,211106,0.8745795012014251
0,621,40,一番くじカードキャプターさくら,211727,0.8771522081365482
0,544,41,一番くじカードキャプターさくら,212271,0.8794059159830971
0,544,42,一番くじカードキャプターさくら,212815,0.8816596238296462
0,601,43,一番くじカードキャプターさくら,213416,0.8841494738586462
0,460,44,一番くじカードキャプターさくら,213876,0.886055182699478
0,444,45,一番くじカードキャプターさくら,214320,0.8878946060154114
0,423,46,一番くじカードキャプターさくら,214743,0.8896470295799155
0,350,47,一番くじカードキャプターさくら,215093,0.8910970254370701
0,331,48,一番くじカードキャプターさくら,215424,0.8924683072334079
0,376,49,一番くじカードキャプターさくら,215800,0.8940260170685227
0,497,50,一番くじカードキャプターさくら,216297,0.8960850111856823
0,416,51,一番くじカードキャプターさくら,216713,0.8978084348330433
0,413,52,一番くじカードキャプターさくら,217126,0.8995194299444859
0,253,53,一番くじカードキャプターさくら,217379,0.9005675698069434
0,372,54,一番くじカードキャプターさくら,217751,0.9021087082608336
0,374,55,一番くじカードキャプターさくら,218125,0.903658132405336
0,318,56,一番くじカードキャプターさくら,218443,0.9049755572126936
0,322,57,一番くじカードキャプターさくら,218765,0.906309553401276
0,303,58,一番くじカードキャプターさくら,219068,0.9075648355290413
0,357,59,一番くじカードキャプターさくら,219425,0.9090438313033391
0,4771,0,一番くじ妖怪ウォッチ妖怪ワールド,4771,0.0036729383506805442
645120,66088,1,一番くじ妖怪ウォッチ妖怪ワールド,70859,0.054550563527745274
653680,143727,2,一番くじ妖怪ウォッチ妖怪ワールド,214586,0.16519831249615077
0,120529,3,一番くじ妖怪ウォッチ妖怪ワールド,335115,0.25798715895793556
0,72501,4,一番くじ妖怪ウォッチ妖怪ワールド,407616,0.3138018106793127
0,67484,5,一番くじ妖怪ウォッチ妖怪ワールド,475100,0.3657541417749584
80,73678,6,一番くじ妖怪ウォッチ妖怪ワールド,548778,0.42247490299932255
0,64273,7,一番くじ妖怪ウォッチ妖怪ワールド,613051,0.47195525651290265
0,60365,8,一番くじ妖怪ウォッチ妖怪ワールド,673416,0.5184270493317731
0,66085,9,一番くじ妖怪ウォッチ妖怪ワールド,739501,0.5693023649688982
0,53548,10,一番くじ妖怪ウォッチ妖怪ワールド,793049,0.6105261131982509
0,37337,11,一番くじ妖怪ウォッチ妖怪ワールド,830386,0.6392698774404139
0,35812,12,一番くじ妖怪ウォッチ妖怪ワールド,866198,0.6668396255465912
80,29158,13,一番くじ妖怪ウォッチ妖怪ワールド,895356,0.6892868140666379
0,27241,14,一番くじ妖怪ウォッチ妖怪ワールド,922597,0.7102582065652522
0,24531,15,一番くじ妖怪ウォッチ妖怪ワールド,947128,0.7291433146517213
0,29157,16,一番くじ妖怪ウォッチ妖怪ワールド,976285,0.7515897333251217
0,22620,17,一番くじ妖怪ウォッチ妖怪ワールド,998905,0.7690036644700375
0,16166,18,一番くじ妖怪ウォッチ妖怪ワールド,1015071,0.7814490053581327
0,12155,19,一番くじ妖怪ウォッチ妖怪ワールド,1027226,0.7908064913469237
0,10939,20,一番くじ妖怪ウォッチ妖怪ワールド,1038165,0.7992278438135123
0,11123,21,一番くじ妖怪ウォッチ妖怪ワールド,1049288,0.8077908480630659
0,10600,22,一番くじ妖怪ウォッチ妖怪ワールド,1059888,0.8159512225164747
0,15708,23,一番くじ妖怪ウォッチ妖怪ワールド,1075596,0.8280439736404508
0,14056,24,一番くじ妖怪ウォッチ妖怪ワールド,1089652,0.8388649381043296
0,5834,25,一番くじ妖怪ウォッチ妖怪ワールド,1095486,0.8433562234402907
0,5896,26,一番くじ妖怪ウォッチ妖怪ワールド,1101382,0.8478952392683378
0,6706,27,一番くじ妖怪ウォッチ妖怪ワールド,1108088,0.8530578308800887
0,6517,28,一番くじ妖怪ウォッチ妖怪ワールド,1114605,0.858074921475642
0,6196,29,一番くじ妖怪ウォッチ妖怪ワールド,1120801,0.8628448912976535
0,9724,30,一番くじ妖怪ウォッチ妖怪ワールド,1130525,0.8703308800886863
0,8176,31,一番くじ妖怪ウォッチ妖怪ワールド,1138701,0.8766251462708629
0,3870,32,一番くじ妖怪ウォッチ妖怪ワールド,1142571,0.8796044527930036
0,4110,33,一番くじ妖怪ウォッチ妖怪ワールド,1146681,0.8827685225103159
0,4050,34,一番くじ妖怪ウォッチ妖怪ワールド,1150731,0.8858864014288353
0,3756,35,一番くじ妖怪ウォッチ妖怪ワールド,1154487,0.8887779454332697
0,4631,36,一番くじ妖怪ウォッチ妖怪ワールド,1159118,0.8923431052534335
0,6443,37,一番くじ妖怪ウォッチ妖怪ワールド,1165561,0.8973032271971423
0,5512,38,一番くじ妖怪ウォッチ妖怪ワールド,1171073,0.9015466219129149
0,2941,39,一番くじ妖怪ウォッチ妖怪ワールド,1174014,0.9038107409004127
0,2789,40,一番くじ妖怪ウォッチ妖怪ワールド,1176803,0.9059578431976351
0,4199,41,一番くじ妖怪ウォッチ妖怪ワールド,1181002,0.9091904292664901
0,2653,42,一番くじ妖怪ウォッチ妖怪ワールド,1183655,0.9112328324197819
0,2932,43,一番くじ妖怪ウォッチ妖怪ワールド,1186587,0.9134900227874607
0,4120,44,一番くじ妖怪ウォッチ妖怪ワールド,1190707,0.9166617909712386
0,4158,45,一番くじ妖怪ウォッチ妖怪ワールド,1194865,0.9198628133275851
0,3886,46,一番くじ妖怪ウォッチ妖怪ワールド,1198751,0.9228544373960706
0,3742,47,一番くじ妖怪ウォッチ妖怪ワールド,1202493,0.9257352035474533
0,2851,48,一番くじ妖怪ウォッチ妖怪ワールド,1205344,0.9279300363367617
0,1451,49,一番くじ妖怪ウォッチ妖怪ワールド,1206795,0.9290470838209028
0,1818,50,一番くじ妖怪ウォッチ妖怪ワールド,1208613,0.9304466650243272
0,2528,51,一番くじ妖怪ウォッチ妖怪ワールド,1211141,0.9323928373468006
0,2256,52,一番くじ妖怪ウォッチ妖怪ワールド,1213397,0.9341296113814128
0,1251,53,一番くじ妖怪ウォッチ妖怪ワールド,1214648,0.9350926895362444
0,1109,54,一番くじ妖怪ウォッチ妖怪ワールド,1215757,0.9359464494672661
0,1193,55,一番くじ妖怪ウォッチ妖怪ワールド,1216950,0.9368648765165979
0,1180,56,一番くじ妖怪ウォッチ妖怪ワールド,1218130,0.9377732955595245
0,1332,57,一番くじ妖怪ウォッチ妖怪ワールド,1219462,0.9387987312927265
0,2018,58,一番くじ妖怪ウォッチ妖怪ワールド,1221480,0.9403522818254604
0,1794,59,一番くじ妖怪ウォッチ妖怪ワールド,1223274,0.9417333867093675
0,42,0,一番くじ七つの大罪＜豚の帽子＞亭営業中※,42,0.0012244897959183673
14150,622,1,一番くじ七つの大罪＜豚の帽子＞亭営業中※,664,0.019358600583090378
20050,1408,2,一番くじ七つの大罪＜豚の帽子＞亭営業中※,2072,0.060408163265306125
50,1804,3,一番くじ七つの大罪＜豚の帽子＞亭営業中※,3876,0.11300291545189504
50,1299,4,一番くじ七つの大罪＜豚の帽子＞亭営業中※,5175,0.15087463556851313
0,836,5,一番くじ七つの大罪＜豚の帽子＞亭営業中※,6011,0.17524781341107873
0,793,6,一番くじ七つの大罪＜豚の帽子＞亭営業中※,6804,0.1983673469387755
0,740,7,一番くじ七つの大罪＜豚の帽子＞亭営業中※,7544,0.21994169096209912
0,728,8,一番くじ七つの大罪＜豚の帽子＞亭営業中※,8272,0.2411661807580175
0,597,9,一番くじ七つの大罪＜豚の帽子＞亭営業中※,8869,0.25857142857142856
0,888,10,一番くじ七つの大罪＜豚の帽子＞亭営業中※,9757,0.2844606413994169
0,770,11,一番くじ七つの大罪＜豚の帽子＞亭営業中※,10527,0.30690962099125363
0,408,12,一番くじ七つの大罪＜豚の帽子＞亭営業中※,10935,0.3188046647230321
0,408,13,一番くじ七つの大罪＜豚の帽子＞亭営業中※,11343,0.3306997084548105
0,495,14,一番くじ七つの大罪＜豚の帽子＞亭営業中※,11838,0.345131195335277
0,433,15,一番くじ七つの大罪＜豚の帽子＞亭営業中※,12271,0.35775510204081634
0,511,16,一番くじ七つの大罪＜豚の帽子＞亭営業中※,12782,0.3726530612244898
0,680,17,一番くじ七つの大罪＜豚の帽子＞亭営業中※,13462,0.3924781341107872
0,559,18,一番くじ七つの大罪＜豚の帽子＞亭営業中※,14021,0.40877551020408165
0,320,19,一番くじ七つの大罪＜豚の帽子＞亭営業中※,14341,0.4181049562682216
0,331,20,一番くじ七つの大罪＜豚の帽子＞亭営業中※,14672,0.42775510204081635
0,373,21,一番くじ七つの大罪＜豚の帽子＞亭営業中※,15045,0.43862973760932944
0,301,22,一番くじ七つの大罪＜豚の帽子＞亭営業中※,15346,0.44740524781341107
0,397,23,一番くじ七つの大罪＜豚の帽子＞亭営業中※,15743,0.4589795918367347
0,415,24,一番くじ七つの大罪＜豚の帽子＞亭営業中※,16158,0.4710787172011662
0,461,25,一番くじ七つの大罪＜豚の帽子＞亭営業中※,16619,0.4845189504373178
0,288,26,一番くじ七つの大罪＜豚の帽子＞亭営業中※,16907,0.4929154518950437
0,258,27,一番くじ七つの大罪＜豚の帽子＞亭営業中※,17165,0.5004373177842566
0,265,28,一番くじ七つの大罪＜豚の帽子＞亭営業中※,17430,0.5081632653061224
0,230,29,一番くじ七つの大罪＜豚の帽子＞亭営業中※,17660,0.5148688046647231
0,345,30,一番くじ七つの大罪＜豚の帽子＞亭営業中※,18005,0.5249271137026239
0,387,31,一番くじ七つの大罪＜豚の帽子＞亭営業中※,18392,0.5362099125364431
0,404,32,一番くじ七つの大罪＜豚の帽子＞亭営業中※,18796,0.5479883381924199
0,290,33,一番くじ七つの大罪＜豚の帽子＞亭営業中※,19086,0.5564431486880467
0,296,34,一番くじ七つの大罪＜豚の帽子＞亭営業中※,19382,0.5650728862973761
0,238,35,一番くじ七つの大罪＜豚の帽子＞亭営業中※,19620,0.5720116618075802
0,226,36,一番くじ七つの大罪＜豚の帽子＞亭営業中※,19846,0.578600583090379
0,340,37,一番くじ七つの大罪＜豚の帽子＞亭営業中※,20186,0.5885131195335277
0,358,38,一番くじ七つの大罪＜豚の帽子＞亭営業中※,20544,0.5989504373177843
0,311,39,一番くじ七つの大罪＜豚の帽子＞亭営業中※,20855,0.6080174927113703
0,264,40,一番くじ七つの大罪＜豚の帽子＞亭営業中※,21119,0.6157142857142858
0,225,41,一番くじ七つの大罪＜豚の帽子＞亭営業中※,21344,0.6222740524781342
0,231,42,一番くじ七つの大罪＜豚の帽子＞亭営業中※,21575,0.6290087463556852
0,348,43,一番くじ七つの大罪＜豚の帽子＞亭営業中※,21923,0.6391545189504373
0,325,44,一番くじ七つの大罪＜豚の帽子＞亭営業中※,22248,0.6486297376093294
0,257,45,一番くじ七つの大罪＜豚の帽子＞亭営業中※,22505,0.6561224489795918
0,249,46,一番くじ七つの大罪＜豚の帽子＞亭営業中※,22754,0.6633819241982507
0,198,47,一番くじ七つの大罪＜豚の帽子＞亭営業中※,22952,0.6691545189504373
0,269,48,一番くじ七つの大罪＜豚の帽子＞亭営業中※,23221,0.6769970845481049
0,270,49,一番くじ七つの大罪＜豚の帽子＞亭営業中※,23491,0.684868804664723
0,245,50,一番くじ七つの大罪＜豚の帽子＞亭営業中※,23736,0.6920116618075802
0,355,51,一番くじ七つの大罪＜豚の帽子＞亭営業中※,24091,0.7023615160349854
0,292,52,一番くじ七つの大罪＜豚の帽子＞亭営業中※,24383,0.7108746355685132
0,262,53,一番くじ七つの大罪＜豚の帽子＞亭営業中※,24645,0.7185131195335277
0,247,54,一番くじ七つの大罪＜豚の帽子＞亭営業中※,24892,0.7257142857142858
0,175,55,一番くじ七つの大罪＜豚の帽子＞亭営業中※,25067,0.7308163265306122
0,309,56,一番くじ七つの大罪＜豚の帽子＞亭営業中※,25376,0.7398250728862974
0,210,57,一番くじ七つの大罪＜豚の帽子＞亭営業中※,25586,0.7459475218658892
0,299,58,一番くじ七つの大罪＜豚の帽子＞亭営業中※,25885,0.75466472303207
0,226,59,一番くじ七つの大罪＜豚の帽子＞亭営業中※,26111,0.7612536443148687
70,15608,0,一番くじ乃木坂４６nan,15608,0.017666700623677093
456680,206422,1,一番くじ乃木坂４６nan,222030,0.2513158341539611
426580,219221,2,一番くじ乃木坂４６nan,441251,0.4994521602318132
0,111556,3,一番くじ乃木坂４６nan,552807,0.6257224353967876
0,71145,4,一番くじ乃木坂４６nan,623952,0.706251485619206
0,40472,5,一番くじ乃木坂４６nan,664424,0.7520617564829593
0,31837,6,一番くじ乃木坂４６nan,696261,0.7880980678461068
0,31736,7,一番くじ乃木坂４６nan,727997,0.8240200572741576
0,27577,8,一番くじ乃木坂４６nan,755574,0.8552344731569833
0,20096,9,一番くじ乃木坂４６nan,775670,0.8779811425402108
0,10278,10,一番くじ乃木坂４６nan,785948,0.889614814311748
0,7176,11,一番くじ乃木坂４６nan,793124,0.8977373312053607
0,6197,12,一番くじ乃木坂４６nan,799321,0.9047517176587773
0,6389,13,一番くじ乃木坂４６nan,805710,0.9119834289789127
0,4958,14,一番くじ乃木坂４６nan,810668,0.917595390901785
0,5910,15,一番くじ乃木坂４６nan,816578,0.9242849219554711
0,4617,16,一番くじ乃木坂４６nan,821195,0.9295109058598481
70,3165,17,一番くじ乃木坂４６nan,824360,0.9330933704596648
0,2417,18,一番くじ乃木坂４６nan,826777,0.9358291735995563
0,2150,19,一番くじ乃木坂４６nan,828927,0.9382627593466671
0,1789,20,一番くじ乃木坂４６nan,830716,0.9402877290683328
0,1819,21,一番くじ乃木坂４６nan,832535,0.9423466558004233
0,2704,22,一番くじ乃木坂４６nan,835239,0.9454073143400455
70,2220,23,一番くじ乃木坂４６nan,837459,0.9479201331114808
0,1227,24,一番くじ乃木坂４６nan,838686,0.9493089748378553
0,1520,25,一番くじ乃木坂４６nan,840206,0.9510294633660452
0,1275,26,一番くじ乃木坂４６nan,841481,0.9524726363090994
0,1071,27,一番くじ乃木坂４６nan,842552,0.9536849015812647
0,1105,28,一番くじ乃木坂４６nan,843657,0.954935651465245
0,1555,29,一番くじ乃木坂４６nan,845212,0.9566957565055972
0,1336,30,一番くじ乃木坂４６nan,846548,0.9582079753698485
0,980,31,一番くじ乃木坂４６nan,847528,0.959317237710392
0,523,32,一番くじ乃木坂４６nan,848051,0.959909221592131
0,674,33,一番くじ乃木坂４６nan,848725,0.9606721224263416
0,758,34,一番くじ乃木坂４６nan,849483,0.9615301028897416
0,583,35,一番くじ乃木坂４６nan,850066,0.9621900007923302
0,992,36,一番くじ乃木坂４６nan,851058,0.9633128459370437
0,901,37,一番くじ乃木坂４６nan,851959,0.9643326881501353
0,791,38,一番くじ乃木坂４６nan,852750,0.9652280213250025
0,564,39,一番くじ乃木坂４６nan,853314,0.9658664131209889
0,702,40,一番くじ乃木坂４６nan,854016,0.9666610071649292
0,578,41,一番くじ乃木坂４６nan,854594,0.9673152455657804
0,585,42,一番くじ乃木坂４６nan,855179,0.967977407269064
0,853,43,一番くじ乃木坂４６nan,856032,0.968942918265476
0,714,44,一番くじ乃木坂４６nan,856746,0.9697510951135861
0,609,45,一番くじ乃木坂４６nan,857355,0.9704404224252097
0,287,46,一番くじ乃木坂４６nan,857642,0.9707652778249403
0,378,47,一番くじ乃木坂４６nan,858020,0.9711931361562928
0,366,48,一番くじ乃木坂４６nan,858386,0.9716074116834754
0,395,49,一番くじ乃木坂４６nan,858781,0.9720545123207353
0,391,50,一番くじ乃木坂４６nan,859172,0.9724970853566052
0,504,51,一番くじ乃木坂４６nan,859676,0.9730675631317419
0,239,52,一番くじ乃木坂４６nan,859915,0.9733380873147928
0,264,53,一番くじ乃木坂４６nan,860179,0.9736369090065311
0,377,54,一番くじ乃木坂４６nan,860556,0.974063635437536
0,207,55,一番くじ乃木坂４６nan,860763,0.9742979388094672
0,189,56,一番くじ乃木坂４６nan,860952,0.9745118679751434
0,346,57,一番くじ乃木坂４６nan,861298,0.9749035054953762
0,343,58,一番くじ乃木坂４６nan,861641,0.9752917473145665
0,185,59,一番くじ乃木坂４６nan,861826,0.9755011488788528
0,1476,0,一番くじ仮面ライダ－１０ＴＨ,1476,0.0016617878856113489
441900,23874,1,一番くじ仮面ライダ－１０ＴＨ,25350,0.028540869173609547
445800,55101,2,一番くじ仮面ライダ－１０ＴＨ,80451,0.09057757261877955
300,73989,3,一番くじ仮面ライダ－１０ＴＨ,154440,0.17387975681152892
0,67486,4,一番くじ仮面ライダ－１０ＴＨ,221926,0.24986039180364783
0,50592,5,一番くじ仮面ライダ－１０ＴＨ,272518,0.30682053591533437
0,45109,6,一番くじ仮面ライダ－１０ＴＨ,317627,0.3576075208286422
0,42901,7,一番くじ仮面ライダ－１０ＴＨ,360528,0.4059085791488404
0,37720,8,一番くじ仮面ライダ－１０ＴＨ,398248,0.44837649178113037
0,35643,9,一番くじ仮面ライダ－１０ＴＨ,433891,0.4885059671245215
200,40332,10,一番くじ仮面ライダ－１０ＴＨ,474223,0.533914658860617
0,36902,11,一番くじ仮面ライダ－１０ＴＨ,511125,0.5754616077460032
0,27239,12,一番くじ仮面ライダ－１０ＴＨ,538364,0.6061292501688809
0,27770,13,一番くじ仮面ライダ－１０ＴＨ,566134,0.6373947309164603
0,26913,14,一番くじ仮面ライダ－１０ＴＨ,593047,0.6676953388876379
0,28079,15,一番くじ仮面ライダ－１０ＴＨ,621126,0.6993087142535465
0,27251,16,一番くじ仮面ライダ－１０ＴＨ,648377,0.729989867147039
0,25003,17,一番くじ仮面ライダ－１０ＴＨ,673380,0.7581400585453727
0,21152,18,一番くじ仮面ライダ－１０ＴＨ,694532,0.7819545147489304
0,13901,19,一番くじ仮面ライダ－１０ＴＨ,708433,0.7976052690835398
0,11759,20,一番くじ仮面ライダ－１０ＴＨ,720192,0.8108444044134204
0,10562,21,一番くじ仮面ライダ－１０ＴＨ,730754,0.8227358702994821
0,9766,22,一番くじ仮面ライダ－１０ＴＨ,740520,0.8337311416347669
0,9132,23,一番くじ仮面ライダ－１０ＴＨ,749652,0.8440126097725738
0,10313,24,一番くじ仮面ライダ－１０ＴＨ,759965,0.8556237333933798
0,9102,25,一番くじ仮面ライダ－１０ＴＨ,769067,0.8658714253546499
0,6450,26,一番くじ仮面ライダ－１０ＴＨ,775517,0.8731333033100653
0,6760,27,一番くじ仮面ライダ－１０ＴＨ,782277,0.8807442017563611
0,6091,28,一番くじ仮面ライダ－１０ＴＨ,788368,0.8876018914658861
0,5313,29,一番くじ仮面ライダ－１０ＴＨ,793681,0.8935836523305561
0,4973,30,一番くじ仮面ライダ－１０ＴＨ,798654,0.8991826165278091
0,5753,31,一番くじ仮面ライダ－１０ＴＨ,804407,0.9056597613150191
0,5101,32,一番くじ仮面ライダ－１０ＴＨ,809508,0.9114028371988291
0,3176,33,一番くじ仮面ライダ－１０ＴＨ,812684,0.9149786084215267
0,2888,34,一番くじ仮面ライダ－１０ＴＨ,815572,0.9182301283494708
0,2532,35,一番くじ仮面ライダ－１０ＴＨ,818104,0.9210808376491781
0,1986,36,一番くじ仮面ライダ－１０ＴＨ,820090,0.9233168205359154
0,2118,37,一番くじ仮面ライダ－１０ＴＨ,822208,0.9257014185994146
0,2859,38,一番くじ仮面ライダ－１０ＴＨ,825067,0.9289202882233731
0,2164,39,一番くじ仮面ライダ－１０ＴＨ,827231,0.9313566764242288
0,1452,40,一番くじ仮面ライダ－１０ＴＨ,828683,0.9329914433686106
0,1374,41,一番くじ仮面ライダ－１０ＴＨ,830057,0.9345383922539968
0,1366,42,一番くじ仮面ライダ－１０ＴＨ,831423,0.9360763341589732
0,1360,43,一番くじ仮面ライダ－１０ＴＨ,832783,0.9376075208286422
0,1329,44,一番くじ仮面ライダ－１０ＴＨ,834112,0.9391038054492231
0,1562,45,一番くじ仮面ライダ－１０ＴＨ,835674,0.94086241837424
0,1618,46,一番くじ仮面ライダ－１０ＴＨ,837292,0.9426840801621257
0,925,47,一番くじ仮面ライダ－１０ＴＨ,838217,0.9437255122720108
0,930,48,一番くじ仮面ライダ－１０ＴＨ,839147,0.9447725737446521
0,806,49,一番くじ仮面ライダ－１０ＴＨ,839953,0.9456800270209412
0,723,50,一番くじ仮面ライダ－１０ＴＨ,840676,0.9464940328754785
0,868,51,一番くじ仮面ライダ－１０ＴＨ,841544,0.9474712902499437
0,1255,52,一番くじ仮面ライダ－１０ＴＨ,842799,0.9488842603017339
0,1129,53,一番くじ仮面ライダ－１０ＴＨ,843928,0.9501553704120693
0,1149,54,一番くじ仮面ライダ－１０ＴＨ,845077,0.9514489979734294
0,992,55,一番くじ仮面ライダ－１０ＴＨ,846069,0.9525658635442468
0,860,56,一番くじ仮面ライダ－１０ＴＨ,846929,0.9535341139383022
0,624,57,一番くじ仮面ライダ－１０ＴＨ,847553,0.954236658410268
0,757,58,一番くじ仮面ライダ－１０ＴＨ,848310,0.955088943931547
0,880,59,一番くじ仮面ライダ－１０ＴＨ,849190,0.9560797117766269
0,12755,0,一番くじキングダムハーツ,12755,0.013338283120875902
487410,166323,1,一番くじキングダムハーツ,179078,0.18726719441162015
468300,167684,2,一番くじキングダムハーツ,346762,0.362619343909147
350,92877,3,一番くじキングダムハーツ,439639,0.4597435870622314
70,65699,4,一番くじキングダムハーツ,505338,0.5284469867296893
0,51821,5,一番くじキングダムハーツ,557159,0.5826377487529673
0,38898,6,一番くじキングダムハーツ,596057,0.6233145450552668
0,32564,7,一番くじキングダムハーツ,628621,0.6573676890417978
0,32584,8,一番くじキングダムハーツ,661205,0.6914417476235791
0,26079,9,一番くじキングダムハーツ,687284,0.7187133341002018
0,20064,10,一番くじキングダムハーツ,707348,0.7396948560552982
0,16424,11,一番くじキングダムハーツ,723772,0.7568699216748408
0,14112,12,一番くじキングダムハーツ,737884,0.7716272600834493
0,12316,13,一番くじキングダムハーツ,750200,0.7845064678385811
0,13320,14,一番くじキングダムハーツ,763520,0.7984355882752779
0,13551,15,一番くじキングダムハーツ,777071,0.8126062722871156
0,11716,16,一番くじキングダムハーツ,788787,0.8248580421847386
0,7528,17,一番くじキングダムハーツ,796315,0.8327302958369498
0,7602,18,一番くじキングダムハーツ,803917,0.8406799334915871
70,6572,19,一番くじキングダムハーツ,810489,0.8475524694908342
0,5955,20,一番くじキングダムハーツ,816444,0.8537797902266097
0,5776,21,一番くじキングダムハーツ,822220,0.8598199253348949
0,6400,22,一番くじキングダムハーツ,828620,0.8665125958149895
0,5886,23,一番くじキングダムハーツ,834506,0.8726677611971514
0,4721,24,一番くじキングダムハーツ,839227,0.8776046514059836
0,4340,25,一番くじキングダムハーツ,843567,0.8821431185752978
70,4144,26,一番くじキングダムハーツ,847711,0.886476622711159
0,3745,27,一番くじキングダムハーツ,851456,0.8903928806717768
0,3833,28,一番くじキングダムハーツ,855289,0.894401162851496
0,4192,29,一番くじキングダムハーツ,859481,0.8987848620159579
0,6104,30,一番くじキングダムハーツ,865585,0.905167996486348
0,3820,31,一番くじキングダムハーツ,869405,0.9091626841791545
0,4130,32,一番くじキングダムハーツ,873535,0.9134815480983405
0,3371,33,一番くじキングダムハーツ,876906,0.9170067031277778
0,3092,34,一番くじキングダムハーツ,879998,0.9202400995534734
0,2377,35,一番くじキングダムハーツ,882375,0.922725799198971
0,2117,36,一番くじキングダムハーツ,884492,0.9249396091062148
0,1786,37,一番くじキングダムハーツ,886278,0.9268072824620661
0,1516,38,一番くじキングダムハーツ,887794,0.9283926087820386
0,1123,39,一番くじキングダムハーツ,888917,0.9295669633053426
0,1319,40,一番くじキングダムハーツ,890236,0.9309462808620996
0,1370,41,一番くじキングダムハーツ,891606,0.9323789306367448
0,1227,42,一番くじキングダムハーツ,892833,0.9336620410553504
0,1600,43,一番くじキングダムハーツ,894433,0.9353352086753741
0,1613,44,一番くじキングダムハーツ,896046,0.9370219707823104
0,1248,45,一番くじキングダムハーツ,897294,0.9383270415259288
0,996,46,一番くじキングダムハーツ,898290,0.9393685883693936
0,932,47,一番くじキングダムハーツ,899222,0.9403432085080573
0,1099,48,一番くじキングダムハーツ,900321,0.9414924655170611
0,1073,49,一番くじキングダムハーツ,901394,0.9426145335522395
0,1426,50,一番くじキングダムハーツ,902820,0.9441057441935855
0,1148,51,一番くじキングダムハーツ,903968,0.9453062419609525
0,912,52,一番くじキングダムハーツ,904880,0.9462599475043659
0,766,53,一番くじキングダムハーツ,905646,0.9470609765024522
0,786,54,一番くじキングダムハーツ,906432,0.9478829200957889
0,787,55,一番くじキングダムハーツ,907219,0.948705909418888
0,1057,56,一番くじキングダムハーツ,908276,0.9498112457778661
0,951,57,一番くじキングダムハーツ,909227,0.9508057347820177
0,1009,58,一番くじキングダムハーツ,910236,0.951860876112395
0,755,59,一番くじキングダムハーツ,910991,0.9526504020830937
70,5146,0,一番くじトイ・ストーリー４,5146,0.006044588531021683
434000,68076,1,一番くじトイ・ストーリー４,73222,0.08600794042333262
417200,112106,2,一番くじトイ・ストーリー４,185328,0.21768975967298612
0,99625,3,一番くじトイ・ストーリー４,284953,0.33471116122818145
0,69104,4,一番くじトイ・ストーリー４,354057,0.4158820212840933
0,59799,5,一番くじトイ・ストーリー４,413856,0.486123053069279
0,46698,6,一番くじトイ・ストーリー４,460554,0.5409754034815702
70,46800,7,一番くじトイ・ストーリー４,507354,0.5959475650151526
0,49378,8,一番くじトイ・ストーリー４,556732,0.6539478939084267
0,42840,9,一番くじトイ・ストーリー４,599572,0.704268564850706
0,24788,10,一番くじトイ・ストーリー４,624360,0.7333850165621256
0,21452,11,一番くじトイ・ストーリー４,645812,0.7585829398360232
0,18740,12,一番くじトイ・ストーリー４,664552,0.7805952968261799
0,18476,13,一番くじトイ・ストーリー４,683028,0.8022975544435831
0,16435,14,一番くじトイ・ストーリー４,699463,0.8216024150163272
0,16581,15,一番くじトイ・ストーリー４,716044,0.8410787699391548
0,13184,16,一番くじトイ・ストーリー４,729228,0.8565649446754529
0,9176,17,一番くじトイ・ストーリー４,738404,0.8673432471163107
0,7234,18,一番くじトイ・ストーリー４,745638,0.8758404397772923
0,7262,19,一番くじトイ・ストーリー４,752900,0.8843705217656871
0,6529,20,一番くじトイ・ストーリー４,759429,0.8920396081471562
0,5722,21,一番くじトイ・ストーリー４,765151,0.898760777127822
0,6211,22,一番くじトイ・ストーリー４,771362,0.9060563347193835
0,5591,23,一番くじトイ・ストーリー４,776953,0.9126236286325088
0,3482,24,一番くじトイ・ストーリー４,780435,0.9167136514201142
0,3171,25,一番くじトイ・ストーリー４,783606,0.9204383677496653
0,2789,26,一番くじトイ・ストーリー４,786395,0.9237143796837927
0,2665,27,一番くじトイ・ストーリー４,789060,0.9268447388822327
0,2877,28,一番くじトイ・ストーリー４,791937,0.9302241172739446
0,3551,29,一番くじトイ・ストーリー４,795488,0.9343951887612469
0,3132,30,一番くじトイ・ストーリー４,798620,0.9380740949561868
0,2750,31,一番くじトイ・ストーリー４,801370,0.9413042967557028
0,2437,32,一番くじトイ・ストーリー４,803807,0.9441668428594922
0,2035,33,一番くじトイ・ストーリー４,805842,0.946557192191134
0,1825,34,一番くじトイ・ストーリー４,807667,0.9487008715671764
0,1793,35,一番くじトイ・ストーリー４,809460,0.9508069631404609
0,1653,36,一番くじトイ・ストーリー４,811113,0.9527486080766792
0,1245,37,一番くじトイ・ストーリー４,812358,0.9542110085277328
0,1002,38,一番くじトイ・ストーリー４,813360,0.9553879766015928
0,884,39,一番くじトイ・ストーリー４,814244,0.9564263396527827
0,865,40,一番くじトイ・ストーリー４,815109,0.957442384946085
0,821,41,一番くじトイ・ストーリー４,815930,0.958406747010595
0,1077,42,一番くじトイ・ストーリー４,817007,0.9596718114971692
0,1123,43,一番くじトイ・ストーリー４,818130,0.960990908450208
0,967,44,一番くじトイ・ストーリー４,819097,0.9621267648648014
0,703,45,一番くじトイ・ストーリー４,819800,0.9629525219066413
0,1639,46,一番くじトイ・ストーリー４,821439,0.9648777221791529
0,978,47,一番くじトイ・ストーリー４,822417,0.9660264994009444
0,1320,48,一番くじトイ・ストーリー４,823737,0.967576996264712
0,1242,49,一番くじトイ・ストーリー４,824979,0.9690358728592572
0,1432,50,一番くじトイ・ストーリー４,826411,0.9707179270326779
0,618,51,一番くじトイ・ストーリー４,827029,0.9714438414734419
0,338,52,一番くじトイ・ストーリー４,827367,0.9718408626400733
0,352,53,一番くじトイ・ストーリー４,827719,0.9722543284704114
0,424,54,一番くじトイ・ストーリー４,828143,0.9727523668569549
0,463,55,一番くじトイ・ストーリー４,828606,0.9732962153781098
0,365,56,一番くじトイ・ストーリー４,828971,0.9737249512533183
0,588,57,一番くじトイ・ストーリー４,829559,0.9744156271289967
0,412,58,一番くじトイ・ストーリー４,829971,0.974899570089506
0,316,59,一番くじトイ・ストーリー４,830287,0.9752707496417412
420,1725,0,一番くじうさまるもぐもぐパーティー,1725,0.006408827463218903
141120,60808,1,一番くじうさまるもぐもぐパーティー,62533,0.2323264972507059
127560,69414,2,一番くじうさまるもぐもぐパーティー,131947,0.49021771437063455
0,34291,3,一番くじうさまるもぐもぐパーティー,166238,0.6176177738148313
0,19997,4,一番くじうさまるもぐもぐパーティー,186235,0.6919118739783029
60,14379,5,一番くじうさまるもぐもぐパーティー,200614,0.7453336305543171
0,9745,6,一番くじうさまるもぐもぐパーティー,210359,0.7815388616436321
0,7708,7,一番くじうさまるもぐもぐパーティー,218067,0.8101761034329024
0,7415,8,一番くじうさまるもぐもぐパーティー,225482,0.8377247733689999
0,5493,9,一番くじうさまるもぐもぐパーティー,230975,0.8581327091692673
0,3399,10,一番くじうさまるもぐもぐパーティー,234374,0.8707608857185317
0,2944,11,一番くじうさまるもぐもぐパーティー,237318,0.8816986179224253
0,2626,12,一番くじうさまるもぐもぐパーティー,239944,0.8914548967157081
0,2282,13,一番くじうさまるもぐもぐパーティー,242226,0.8999331252786447
0,2205,14,一番くじうさまるもぐもぐパーティー,244431,0.9081252786446723
0,3318,15,一番くじうさまるもぐもぐパーティー,247749,0.9204525189478378
0,1780,16,一番くじうさまるもぐもぐパーティー,249529,0.9270656858374201
0,1799,17,一番くじうさまるもぐもぐパーティー,251328,0.9337494427106554
0,1598,18,一番くじうさまるもぐもぐパーティー,252926,0.9396864318620894
0,1619,19,一番くじうさまるもぐもぐパーティー,254545,0.9457014415217715
0,1401,20,一番くじうさまるもぐもぐパーティー,255946,0.9509065240005944
0,1147,21,一番くじうさまるもぐもぐパーティー,257093,0.9551679298558479
0,807,22,一番くじうさまるもぐもぐパーティー,257900,0.958166146529945
0,726,23,一番くじうさまるもぐもぐパーティー,258626,0.9608634269579432
0,489,24,一番くじうさまるもぐもぐパーティー,259115,0.9626801902214296
0,468,25,一番くじうさまるもぐもぐパーティー,259583,0.9644189329766681
0,351,26,一番くじうさまるもぐもぐパーティー,259934,0.965722990043097
0,425,27,一番くじうさまるもぐもぐパーティー,260359,0.9673019765195423
0,358,28,一番くじうさまるもぐもぐパーティー,260717,0.9686320404220538
0,410,29,一番くじうさまるもぐもぐパーティー,261127,0.9701552979640362
0,279,30,一番くじうさまるもぐもぐパーティー,261406,0.9711918561450439
0,214,31,一番くじうさまるもぐもぐパーティー,261620,0.9719869222767127
0,165,32,一番くじうさまるもぐもぐパーティー,261785,0.9725999405558032
0,134,33,一番くじうさまるもぐもぐパーティー,261919,0.9730977857036707
0,172,34,一番くじうさまるもぐもぐパーティー,262091,0.9737368108188438
0,256,35,一番くじうさまるもぐもぐパーティー,262347,0.9746879179670085
0,219,36,一番くじうさまるもぐもぐパーティー,262566,0.975501560410165
0,205,37,一番くじうさまるもぐもぐパーティー,262771,0.9762631891811562
0,218,38,一番くじうさまるもぐもぐパーティー,262989,0.9770731163620151
0,197,39,一番くじうさまるもぐもぐパーティー,263186,0.9778050230346262
0,110,40,一番くじうさまるもぐもぐパーティー,263296,0.9782137018873532
0,101,41,一番くじうさまるもぐもぐパーティー,263397,0.9785889433794026
0,133,42,一番くじうさまるもぐもぐパーティー,263530,0.9790830732649725
0,148,43,一番くじうさまるもぐもぐパーティー,263678,0.9796329320850052
0,139,44,一番くじうさまるもぐもぐパーティー,263817,0.9801493535443603
0,61,45,一番くじうさまるもぐもぐパーティー,263878,0.9803759845445088
0,106,46,一番くじうさまるもぐもぐパーティー,263984,0.9807698023480458
0,80,47,一番くじうさまるもぐもぐパーティー,264064,0.9810670233318473
0,96,48,一番くじうさまるもぐもぐパーティー,264160,0.981423688512409
0,101,49,一番くじうさまるもぐもぐパーティー,264261,0.9817989300044583
0,118,50,一番くじうさまるもぐもぐパーティー,264379,0.9822373309555654
0,55,51,一番くじうさまるもぐもぐパーティー,264434,0.982441670381929
0,74,52,一番くじうさまるもぐもぐパーティー,264508,0.9827165997919454
0,73,53,一番くじうさまるもぐもぐパーティー,264581,0.9829878139396642
0,39,54,一番くじうさまるもぐもぐパーティー,264620,0.9831327091692673
0,39,55,一番くじうさまるもぐもぐパーティー,264659,0.9832776043988706
0,16,56,一番くじうさまるもぐもぐパーティー,264675,0.9833370485956309
0,63,57,一番くじうさまるもぐもぐパーティー,264738,0.9835711101203745
0,37,58,一番くじうさまるもぐもぐパーティー,264775,0.9837085748253827
0,25,59,一番くじうさまるもぐもぐパーティー,264800,0.9838014563828206
1782,4928,0,一番くじスーパーマリオブラザーズ,4928,0.008803993239790905
292842,55765,1,一番くじスーパーマリオブラザーズ,60693,0.10842953768316343
264990,76091,2,一番くじスーパーマリオブラザーズ,136784,0.244367981191469
0,64331,3,一番くじスーパーマリオブラザーズ,201115,0.3592968953775462
0,39648,4,一番くじスーパーマリオブラザーズ,240763,0.43012902280677306
0,33066,5,一番くじスーパーマリオブラザーズ,273829,0.4892022453041201
66,29274,6,一番くじスーパーマリオブラザーズ,303103,0.5415009665098098
0,24932,7,一番くじスーパーマリオブラザーズ,328035,0.5860425978926156
0,30416,8,一番くじスーパーマリオブラザーズ,358451,0.6403815301940523
66,23876,9,一番くじスーパーマリオブラザーズ,382327,0.6830365915969029
0,11576,10,一番くじスーパーマリオブラザーズ,393903,0.7037174003923208
0,10664,11,一番くじスーパーマリオブラザーズ,404567,0.7227688987505047
0,10630,12,一番くじスーパーマリオブラザーズ,415197,0.7417596552722128
0,8825,13,一番くじスーパーマリオブラザーズ,424022,0.7575257348868951
0,9723,14,一番くじスーパーマリオブラザーズ,433745,0.7748961135943803
0,13068,15,一番くじスーパーマリオブラザーズ,446813,0.7982424170963258
0,10794,16,一番くじスーパーマリオブラザーズ,457607,0.8175261636527996
0,5463,17,一番くじスーパーマリオブラザーズ,463070,0.8272859475547838
0,4952,18,一番くじスーパーマリオブラザーズ,468022,0.8361328173850282
0,5061,19,一番くじスーパーマリオブラザーズ,473083,0.8451744183969158
0,4409,20,一番くじスーパーマリオブラザーズ,477492,0.8530512053681492
0,3827,21,一番くじスーパーマリオブラザーズ,481319,0.8598882350208845
0,5806,22,一番くじスーパーマリオブラザーズ,487125,0.8702607968614335
0,4534,23,一番くじスーパーマリオブラザーズ,491659,0.8783608994079457
0,2590,24,一番くじスーパーマリオブラザーズ,494249,0.8829879981277222
0,2554,25,一番くじスーパーマリオブラザーズ,496803,0.8875507819618184
0,2916,26,一番くじスーパーマリオブラザーズ,499719,0.892760287701922
0,3417,27,一番くじスーパーマリオブラザーズ,503136,0.8988648422677429
0,3145,28,一番くじスーパーマリオブラザーズ,506281,0.9044834621417571
0,2921,29,一番くじスーパーマリオブラザーズ,509202,0.9097019005048719
0,2423,30,一番くじスーパーマリオブラザーズ,511625,0.9140306496160758
0,1487,31,一番くじスーパーマリオブラザーズ,513112,0.9166872116995923
0,1335,32,一番くじスーパーマリオブラザーズ,514447,0.9190722220435698
0,1332,33,一番くじスーパーマリオブラザーズ,515779,0.9214518728137405
0,1248,34,一番くじスーパーマリオブラザーズ,517027,0.923681455517324
0,1457,35,一番くじスーパーマリオブラザーズ,518484,0.9262844218627735
0,1910,36,一番くじスーパーマリオブラザーズ,520394,0.9296966838530334
0,1772,37,一番くじスーパーマリオブラザーズ,522166,0.9328624054481854
0,1081,38,一番くじスーパーマリオブラザーズ,523247,0.9347936385431964
0,1133,39,一番くじスーパーマリオブラザーズ,524380,0.9368177709175233
0,1016,40,一番くじスーパーマリオブラザーズ,525396,0.9386328799133893
0,933,41,一番くじスーパーマリオブラザーズ,526329,0.9402997073672702
0,1156,42,一番くじスーパーマリオブラザーズ,527485,0.9423649298074483
0,1151,43,一番くじスーパーマリオブラザーズ,528636,0.9444212196246154
0,965,44,一番くじスーパーマリオブラザーズ,529601,0.9461452158657677
0,816,45,一番くじスーパーマリオブラザーズ,530417,0.9476030199411876
0,756,46,一番くじスーパーマリオブラザーズ,531173,0.9489536325404737
0,765,47,一番くじスーパーマリオブラザーズ,531938,0.9503203238611799
0,766,48,一番くじスーパーマリオブラザーズ,532704,0.9516888017064883
0,686,49,一番くじスーパーマリオブラザーズ,533390,0.9529143575836183
0,1235,50,一番くじスーパーマリオブラザーズ,534625,0.9551207154673726
0,1003,51,一番くじスーパーマリオブラザーズ,535628,0.9569125996434097
0,576,52,一番くじスーパーマリオブラザーズ,536204,0.9579416378142943
0,546,53,一番くじスーパーマリオブラザーズ,536750,0.9589170802471121
0,437,54,一番くじスーパーマリオブラザーズ,537187,0.9596977914982867
0,388,55,一番くじスーパーマリオブラザーズ,537575,0.9603909630439521
0,413,56,一番くじスーパーマリオブラザーズ,537988,0.9611287977046732
0,467,57,一番くじスーパーマリオブラザーズ,538455,0.9619631046939148
0,442,58,一番くじスーパーマリオブラザーズ,538897,0.9627527485681006
0,307,59,一番くじスーパーマリオブラザーズ,539204,0.9633012116209853
12480,15051,0,一番くじワンピース覇ノ躍動,15051,0.01079574797727664
718480,119335,1,一番くじワンピース覇ノ躍動,134386,0.09639209272967235
662880,140986,2,一番くじワンピース覇ノ躍動,275372,0.19751821885579848
0,85092,3,一番くじワンピース覇ノ躍動,360464,0.2585528203362598
0,69410,4,一番くじワンピース覇ノ躍動,429874,0.30833907155563206
160,59059,5,一番くじワンピース覇ノ躍動,488933,0.3507007803982326
80,58066,6,一番くじワンピース覇ノ躍動,546999,0.3923502323980031
80,54745,7,一番くじワンピース覇ノ躍動,601744,0.4316176048660125
0,67217,8,一番くじワンピース覇ノ躍動,668961,0.4798308658977449
0,57201,9,一番くじワンピース覇ノ躍動,726162,0.5208598726114649
0,31825,10,一番くじワンピース覇ノ躍動,757987,0.5436872381936076
0,36050,11,一番くじワンピース覇ノ躍動,794037,0.5695451024272681
0,27794,12,一番くじワンピース覇ノ躍動,821831,0.5894811212486372
0,23271,13,一番くじワンピース覇ノ躍動,845102,0.6061728926378608
0,24965,14,一番くじワンピース覇ノ躍動,870067,0.6240797325988409
0,31035,15,一番くじワンピース覇ノ躍動,901102,0.6463404487289838
0,27229,16,一番くじワンピース覇ノ躍動,928331,0.665871205600505
0,16469,17,一番くじワンピース覇ノ躍動,944800,0.6776840534802319
0,20823,18,一番くじワンピース覇ノ躍動,965623,0.6926199288460435
0,18076,19,一番くじワンピース覇ノ躍動,983699,0.7055854421300282
0,15932,20,一番くじワンピース覇ノ躍動,999631,0.7170131118379526
0,18152,21,一番くじワンピース覇ノ躍動,1017783,0.7300331382337751
0,19445,22,一番くじワンピース覇ノ躍動,1037228,0.7439806048086303
0,23356,23,一番くじワンピース覇ノ躍動,1060584,0.760733344809778
0,16828,24,一番くじワンピース覇ノ躍動,1077412,0.7728036954151604
0,17643,25,一番くじワンピース覇ノ躍動,1095055,0.7854586274172262
0,16365,26,一番くじワンピース覇ノ躍動,1111420,0.7971968784070695
0,18934,27,一番くじワンピース覇ノ躍動,1130354,0.8107778160325931
0,18126,28,一番くじワンピース覇ノ躍動,1148480,0.8237791932059448
0,21594,29,一番くじワンピース覇ノ躍動,1170074,0.8392680897457967
0,12511,30,一番くじワンピース覇ノ躍動,1182585,0.8482419521432261
0,10501,31,一番くじワンピース覇ノ躍動,1193086,0.8557740861880989
0,8099,32,一番くじワンピース覇ノ躍動,1201185,0.8615833189877776
0,7205,33,一番くじワンピース覇ノ躍動,1208390,0.866751305445573
0,6120,34,一番くじワンピース覇ノ躍動,1214510,0.8711410455041029
0,6271,35,一番くじワンピース覇ノ躍動,1220781,0.8756390945085213
0,7713,36,一番くじワンピース覇ノ躍動,1228494,0.8811714580822861
0,7952,37,一番くじワンピース覇ノ躍動,1236446,0.8868752510472255
0,6316,38,一番くじワンピース覇ノ躍動,1242762,0.8914055775520744
0,4216,39,一番くじワンピース覇ノ躍動,1246978,0.8944296207035061
0,4110,40,一番くじワンピース覇ノ躍動,1251088,0.8973776324094795
0,3832,41,一番くじワンピース覇ノ躍動,1254920,0.9001262408905721
0,4090,42,一番くじワンピース覇ノ躍動,1259010,0.9030599070407987
0,5664,43,一番くじワンピース覇ノ躍動,1264674,0.9071225684283009
0,5120,44,一番くじワンピース覇ノ躍動,1269794,0.9107950306994893
0,3216,45,一番くじワンピース覇ノ躍動,1273010,0.9131017960635796
0,2907,46,一番くじワンピース覇ノ躍動,1275917,0.9151869225913812
0,2980,47,一番くじワンピース覇ノ躍動,1278897,0.9173244103976588
0,2829,48,一番くじワンピース覇ノ躍動,1281726,0.9193535892580479
0,3145,49,一番くじワンピース覇ノ躍動,1284871,0.9216094278992368
0,3691,50,一番くじワンピース覇ノ躍動,1288562,0.9242569002123142
0,3083,51,一番くじワンピース覇ノ躍動,1291645,0.926468267630688
0,2367,52,一番くじワンピース覇ノ躍動,1294012,0.9281660641533253
0,2093,53,一番くじワンピース覇ノ躍動,1296105,0.9296673265622311
0,1863,54,一番くじワンピース覇ノ躍動,1297968,0.9310036150800483
0,1789,55,一番くじワンピース覇ノ躍動,1299757,0.9322868250416021
0,2161,56,一番くじワンピース覇ノ躍動,1301918,0.933836862340047
0,2542,57,一番くじワンピース覇ノ躍動,1304460,0.9356601824754691
0,2638,58,一番くじワンピース覇ノ躍動,1307098,0.937552361278476
0,1385,59,一番くじワンピース覇ノ躍動,1308483,0.9385457910139439
0,20944,0,一番くじ映画モンスターハンター,20944,0.03464796188459503
286880,46947,1,一番くじ映画モンスターハンター,67891,0.11231306246691371
317600,64726,2,一番くじ映画モンスターハンター,132617,0.21939021969295924
0,36505,3,一番くじ映画モンスターハンター,169122,0.2797809687665431
0,40980,4,一番くじ映画モンスターハンター,210102,0.3475747750132345
0,36012,5,一番くじ映画モンスターハンター,246114,0.4071499470619375
0,24998,6,一番くじ映画モンスターハンター,271112,0.4485044997353097
0,22727,7,一番くじ映画モンスターハンター,293839,0.48610210428798306
0,20119,8,一番くじ映画モンスターハンター,313958,0.519385256749603
0,16348,9,一番くじ映画モンスターハンター,330306,0.5464299894123875
0,17515,10,一番くじ映画モンスターハンター,347821,0.5754053070407623
0,20894,11,一番くじ映画モンスターハンター,368715,0.6099705532027527
0,19149,12,一番くじ映画モンスターハンター,387864,0.6416490206458444
0,13272,13,一番くじ映画モンスターハンター,401136,0.6636050820539968
0,9091,14,一番くじ映画モンスターハンター,410227,0.6786444547379565
0,8352,15,一番くじ映画モンスターハンター,418579,0.692461289041821
0,7461,16,一番くじ映画モンスターハンター,426040,0.7048041291688725
0,11570,17,一番くじ映画モンスターハンター,437610,0.7239445473795659
0,13526,18,一番くじ映画モンスターハンター,451136,0.7463208046585496
0,10085,19,一番くじ映画モンスターハンター,461221,0.7630045659078878
0,8859,20,一番くじ映画モンスターハンター,470080,0.7776601376389625
0,7245,21,一番くじ映画モンスターハンター,477325,0.7896456458443621
0,6381,22,一番くじ映画モンスターハンター,483706,0.8002018263631551
0,4748,23,一番くじ映画モンスターハンター,488454,0.8080565113816834
0,5696,24,一番くじ映画モンスターハンター,494150,0.817479486500794
0,7418,25,一番くじ映画モンスターハンター,501568,0.8297511911064055
0,5660,26,一番くじ映画モンスターハンター,507228,0.8391146109052409
0,3295,27,一番くじ映画モンスターハンター,510523,0.8445655770248809
0,3196,28,一番くじ映画モンスターハンター,513719,0.8498527660137639
0,3018,29,一番くじ映画モンスターハンター,516737,0.8548454870301747
0,2848,30,一番くじ映画モンスターハンター,519585,0.85955697458973
0,2798,31,一番くじ映画モンスターハンター,522383,0.8641857464266808
0,4170,32,一番くじ映画モンスターハンター,526553,0.8710842376919005
0,3258,33,一番くじ映画モンスターハンター,529811,0.8764739941768132
0,1876,34,一番くじ映画モンスターハンター,531687,0.879577488088936
0,1572,35,一番くじ映画モンスターハンター,533259,0.8821780704076231
0,1451,36,一番くじ映画モンスターハンター,534710,0.8845784806776072
0,1717,37,一番くじ映画モンスターハンター,536427,0.8874189385918475
0,1796,38,一番くじ映画モンスターハンター,538223,0.8903900873478031
0,2625,39,一番くじ映画モンスターハンター,540848,0.8947326627845421
0,1981,40,一番くじ映画モンスターハンター,542829,0.8980098597141345
0,1303,41,一番くじ映画モンスターハンター,544132,0.9001654314452091
0,1202,42,一番くじ映画モンスターハンター,545334,0.9021539174166225
0,1350,43,一番くじ映画モンスターハンター,546684,0.9043872419269455
0,1096,44,一番くじ映画モンスターハンター,547780,0.9062003705664373
0,1537,45,一番くじ映画モンスターハンター,549317,0.9087430518793013
0,1787,46,一番くじ映画モンスターハンター,551104,0.9116993118051879
0,1541,47,一番くじ映画モンスターハンター,552645,0.9142486103758602
0,857,48,一番くじ映画モンスターハンター,553502,0.9156663578613022
0,763,49,一番くじ映画モンスターハンター,554265,0.9169285997882477
0,754,50,一番くじ映画モンスターハンター,555019,0.9181759528851244
0,657,51,一番くじ映画モンスターハンター,555676,0.9192628374801483
0,776,52,一番くじ映画モンスターハンター,556452,0.9205465854949709
0,1208,53,一番くじ映画モンスターハンター,557660,0.9225449973530969
0,1188,54,一番くじ映画モンスターハンター,558848,0.924510322922181
0,534,55,一番くじ映画モンスターハンター,559382,0.9253937268395976
0,570,56,一番くじ映画モンスターハンター,559952,0.9263366860772896
0,2097,57,一番くじ映画モンスターハンター,562049,0.9298057834833245
0,557,58,一番くじ映画モンスターハンター,562606,0.9307272366331393
0,529,59,一番くじ映画モンスターハンター,563135,0.9316023689782954
2900,323,0,一番くじハイキュー！！烏野高校練習開始編※,323,0.05617391304347826
2800,1001,1,一番くじハイキュー！！烏野高校練習開始編※,1324,0.23026086956521738
0,613,2,一番くじハイキュー！！烏野高校練習開始編※,1937,0.3368695652173913
0,470,3,一番くじハイキュー！！烏野高校練習開始編※,2407,0.4186086956521739
0,481,4,一番くじハイキュー！！烏野高校練習開始編※,2888,0.5022608695652174
0,235,5,一番くじハイキュー！！烏野高校練習開始編※,3123,0.5431304347826087
50,222,6,一番くじハイキュー！！烏野高校練習開始編※,3345,0.5817391304347826
0,286,7,一番くじハイキュー！！烏野高校練習開始編※,3631,0.6314782608695653
0,245,8,一番くじハイキュー！！烏野高校練習開始編※,3876,0.6740869565217391
0,214,9,一番くじハイキュー！！烏野高校練習開始編※,4090,0.711304347826087
0,232,10,一番くじハイキュー！！烏野高校練習開始編※,4322,0.7516521739130435
0,129,11,一番くじハイキュー！！烏野高校練習開始編※,4451,0.7740869565217391
0,90,12,一番くじハイキュー！！烏野高校練習開始編※,4541,0.7897391304347826
0,69,13,一番くじハイキュー！！烏野高校練習開始編※,4610,0.8017391304347826
0,87,14,一番くじハイキュー！！烏野高校練習開始編※,4697,0.8168695652173913
0,87,15,一番くじハイキュー！！烏野高校練習開始編※,4784,0.832
0,63,16,一番くじハイキュー！！烏野高校練習開始編※,4847,0.8429565217391304
0,39,17,一番くじハイキュー！！烏野高校練習開始編※,4886,0.8497391304347827
0,42,18,一番くじハイキュー！！烏野高校練習開始編※,4928,0.8570434782608696
0,86,19,一番くじハイキュー！！烏野高校練習開始編※,5014,0.872
0,27,20,一番くじハイキュー！！烏野高校練習開始編※,5041,0.8766956521739131
0,29,21,一番くじハイキュー！！烏野高校練習開始編※,5070,0.8817391304347826
0,27,22,一番くじハイキュー！！烏野高校練習開始編※,5097,0.8864347826086957
0,28,23,一番くじハイキュー！！烏野高校練習開始編※,5125,0.8913043478260869
0,13,24,一番くじハイキュー！！烏野高校練習開始編※,5138,0.8935652173913043
0,5,25,一番くじハイキュー！！烏野高校練習開始編※,5143,0.8944347826086957
0,13,26,一番くじハイキュー！！烏野高校練習開始編※,5156,0.896695652173913
0,19,27,一番くじハイキュー！！烏野高校練習開始編※,5175,0.9
0,18,28,一番くじハイキュー！！烏野高校練習開始編※,5193,0.9031304347826087
0,23,29,一番くじハイキュー！！烏野高校練習開始編※,5216,0.9071304347826087
0,4,30,一番くじハイキュー！！烏野高校練習開始編※,5220,0.9078260869565218
0,7,31,一番くじハイキュー！！烏野高校練習開始編※,5227,0.9090434782608696
0,5,32,一番くじハイキュー！！烏野高校練習開始編※,5232,0.9099130434782609
0,5,33,一番くじハイキュー！！烏野高校練習開始編※,5237,0.9107826086956522
0,9,34,一番くじハイキュー！！烏野高校練習開始編※,5246,0.9123478260869565
0,3,35,一番くじハイキュー！！烏野高校練習開始編※,5249,0.9128695652173913
0,10,36,一番くじハイキュー！！烏野高校練習開始編※,5259,0.914608695652174
0,17,37,一番くじハイキュー！！烏野高校練習開始編※,5276,0.9175652173913044
0,3,38,一番くじハイキュー！！烏野高校練習開始編※,5279,0.9180869565217391
0,3,39,一番くじハイキュー！！烏野高校練習開始編※,5282,0.918608695652174
0,6,40,一番くじハイキュー！！烏野高校練習開始編※,5288,0.9196521739130434
0,2,41,一番くじハイキュー！！烏野高校練習開始編※,5290,0.92
0,3,42,一番くじハイキュー！！烏野高校練習開始編※,5293,0.9205217391304348
0,11,43,一番くじハイキュー！！烏野高校練習開始編※,5304,0.9224347826086956
0,16,44,一番くじハイキュー！！烏野高校練習開始編※,5320,0.9252173913043479
0,2,45,一番くじハイキュー！！烏野高校練習開始編※,5322,0.9255652173913044
0,5,46,一番くじハイキュー！！烏野高校練習開始編※,5327,0.9264347826086956
0,0,47,一番くじハイキュー！！烏野高校練習開始編※,5327,0.9264347826086956
0,2,48,一番くじハイキュー！！烏野高校練習開始編※,5329,0.9267826086956522
0,1,49,一番くじハイキュー！！烏野高校練習開始編※,5330,0.9269565217391305
0,16,50,一番くじハイキュー！！烏野高校練習開始編※,5346,0.9297391304347826
0,5,51,一番くじハイキュー！！烏野高校練習開始編※,5351,0.930608695652174
0,12,52,一番くじハイキュー！！烏野高校練習開始編※,5363,0.932695652173913
0,1,53,一番くじハイキュー！！烏野高校練習開始編※,5364,0.9328695652173913
0,8,54,一番くじハイキュー！！烏野高校練習開始編※,5372,0.9342608695652174
0,4,55,一番くじハイキュー！！烏野高校練習開始編※,5376,0.9349565217391305
0,1,56,一番くじハイキュー！！烏野高校練習開始編※,5377,0.9351304347826087
0,7,57,一番くじハイキュー！！烏野高校練習開始編※,5384,0.9363478260869565
0,21,58,一番くじハイキュー！！烏野高校練習開始編※,5405,0.94
0,3,59,一番くじハイキュー！！烏野高校練習開始編※,5408,0.9405217391304348
0,392,0,一番くじ黒子のバスケnan,392,0.593939393939394
660,202,1,一番くじ黒子のバスケnan,594,0.9
0,18,2,一番くじ黒子のバスケnan,612,0.9272727272727272
0,3,3,一番くじ黒子のバスケnan,615,0.9318181818181818
0,9,4,一番くじ黒子のバスケnan,624,0.9454545454545454
0,3,5,一番くじ黒子のバスケnan,627,0.95
0,2,6,一番くじ黒子のバスケnan,629,0.953030303030303
0,29,7,一番くじ黒子のバスケnan,658,0.996969696969697
0,0,8,一番くじ黒子のバスケnan,658,0.996969696969697
0,0,9,一番くじ黒子のバスケnan,658,0.996969696969697
0,0,10,一番くじ黒子のバスケnan,658,0.996969696969697
0,0,11,一番くじ黒子のバスケnan,658,0.996969696969697
0,0,12,一番くじ黒子のバスケnan,658,0.996969696969697
0,0,13,一番くじ黒子のバスケnan,658,0.996969696969697
0,0,14,一番くじ黒子のバスケnan,658,0.996969696969697
0,0,15,一番くじ黒子のバスケnan,658,0.996969696969697
0,0,16,一番くじ黒子のバスケnan,658,0.996969696969697
0,0,17,一番くじ黒子のバスケnan,658,0.996969696969697
0,0,18,一番くじ黒子のバスケnan,658,0.996969696969697
0,0,19,一番くじ黒子のバスケnan,658,0.996969696969697
0,0,20,一番くじ黒子のバスケnan,658,0.996969696969697
0,0,21,一番くじ黒子のバスケnan,658,0.996969696969697
0,0,22,一番くじ黒子のバスケnan,658,0.996969696969697
0,0,23,一番くじ黒子のバスケnan,658,0.996969696969697
0,0,24,一番くじ黒子のバスケnan,658,0.996969696969697
0,0,25,一番くじ黒子のバスケnan,658,0.996969696969697
0,0,26,一番くじ黒子のバスケnan,658,0.996969696969697
0,0,27,一番くじ黒子のバスケnan,658,0.996969696969697
0,0,28,一番くじ黒子のバスケnan,658,0.996969696969697
0,0,29,一番くじ黒子のバスケnan,658,0.996969696969697
0,0,30,一番くじ黒子のバスケnan,658,0.996969696969697
0,0,31,一番くじ黒子のバスケnan,658,0.996969696969697
0,0,32,一番くじ黒子のバスケnan,658,0.996969696969697
0,0,33,一番くじ黒子のバスケnan,658,0.996969696969697
0,0,34,一番くじ黒子のバスケnan,658,0.996969696969697
0,0,35,一番くじ黒子のバスケnan,658,0.996969696969697
0,0,36,一番くじ黒子のバスケnan,658,0.996969696969697
0,0,37,一番くじ黒子のバスケnan,658,0.996969696969697
0,0,38,一番くじ黒子のバスケnan,658,0.996969696969697
0,0,39,一番くじ黒子のバスケnan,658,0.996969696969697
0,0,40,一番くじ黒子のバスケnan,658,0.996969696969697
0,0,41,一番くじ黒子のバスケnan,658,0.996969696969697
0,0,42,一番くじ黒子のバスケnan,658,0.996969696969697
0,0,43,一番くじ黒子のバスケnan,658,0.996969696969697
0,0,44,一番くじ黒子のバスケnan,658,0.996969696969697
0,0,45,一番くじ黒子のバスケnan,658,0.996969696969697
0,0,46,一番くじ黒子のバスケnan,658,0.996969696969697
0,0,47,一番くじ黒子のバスケnan,658,0.996969696969697
0,0,48,一番くじ黒子のバスケnan,658,0.996969696969697
0,0,49,一番くじ黒子のバスケnan,658,0.996969696969697
0,0,50,一番くじ黒子のバスケnan,658,0.996969696969697
0,0,51,一番くじ黒子のバスケnan,658,0.996969696969697
0,0,52,一番くじ黒子のバスケnan,658,0.996969696969697
0,0,53,一番くじ黒子のバスケnan,658,0.996969696969697
0,0,54,一番くじ黒子のバスケnan,658,0.996969696969697
0,0,55,一番くじ黒子のバスケnan,658,0.996969696969697
0,0,56,一番くじ黒子のバスケnan,658,0.996969696969697
0,0,57,一番くじ黒子のバスケnan,658,0.996969696969697
0,0,58,一番くじ黒子のバスケnan,658,0.996969696969697
0,0,59,一番くじ黒子のバスケnan,658,0.996969696969697
0,5866,0,一番くじラブライブ！虹ヶ咲学園,5866,0.011842849067269644
236950,88336,1,一番くじラブライブ！虹ヶ咲学園,94202,0.19018412339497698
258230,91064,2,一番くじラブライブ！虹ヶ咲学園,185266,0.37403294839699586
0,51717,3,一番くじラブライブ！虹ヶ咲学園,236983,0.4784442380683195
70,42967,4,一番くじラブライブ！虹ヶ咲学園,279950,0.5651901800856012
0,27766,5,一番くじラブライブ！虹ヶ咲学園,307716,0.6212468707098442
0,15732,6,一番くじラブライブ！虹ヶ咲学園,323448,0.653008156343374
0,11415,7,一番くじラブライブ！虹ヶ咲学園,334863,0.6760538641686182
0,10752,8,一番くじラブライブ！虹ヶ咲学園,345615,0.6977610433659048
0,8555,9,一番くじラブライブ！虹ヶ咲学園,354170,0.7150327061293709
70,8265,10,一番くじラブライブ！虹ヶ咲学園,362435,0.7317188887991601
0,7640,11,一番くじラブライブ！虹ヶ咲学園,370075,0.747143260922232
0,6347,12,一番くじラブライブ！虹ヶ咲学園,376422,0.7599571993862554
0,6857,13,一番くじラブライブ！虹ヶ咲学園,383279,0.7738007752563999
0,4886,14,一番くじラブライブ！虹ヶ咲学園,388165,0.7836651053864169
0,4272,15,一番くじラブライブ！虹ヶ咲学園,392437,0.7922898328353388
0,3619,16,一番くじラブライブ！虹ヶ咲学園,396056,0.7995962206250504
0,3853,17,一番くじラブライブ！虹ヶ咲学園,399909,0.8073750302834531
0,4337,18,一番くじラブライブ！虹ヶ咲学園,404246,0.8161309860292336
0,3988,19,一番くじラブライブ！虹ヶ咲学園,408234,0.8241823467657272
0,2834,20,一番くじラブライブ！虹ヶ咲学園,411068,0.8299039005087621
0,2099,21,一番くじラブライブ！虹ヶ咲学園,413167,0.8341415650488573
0,1947,22,一番くじラブライブ！虹ヶ咲学園,415114,0.838072357263991
0,1978,23,一番くじラブライブ！虹ヶ咲学園,417092,0.8420657352822418
0,2305,24,一番くじラブライブ！虹ヶ咲学園,419397,0.8467192925785351
0,2773,25,一番くじラブライブ！虹ヶ咲学園,422170,0.8523176936122103
0,2752,26,一番くじラブライブ！虹ヶ咲学園,424922,0.8578736978115158
0,1806,27,一番くじラブライブ！虹ヶ咲学園,426728,0.86151982556731
0,1593,28,一番くじラブライブ！虹ヶ咲学園,428321,0.864735928288783
0,1843,29,一番くじラブライブ！虹ヶ咲学園,430164,0.868456755228943
0,1958,30,一番くじラブライブ！虹ヶ咲学園,432122,0.8724097553096988
0,1470,31,一番くじラブライブ！虹ヶ咲学園,433592,0.8753775337155778
0,2000,32,一番くじラブライブ！虹ヶ咲学園,435592,0.8794153274650731
0,1615,33,一番くじラブライブ！虹ヶ咲学園,437207,0.8826758459177905
0,1263,34,一番くじラブライブ！虹ヶ咲学園,438470,0.8852257126705968
0,1198,35,一番くじラブライブ！虹ヶ咲学園,439668,0.8876443511265445
0,1314,36,一番くじラブライブ！虹ヶ咲学園,440982,0.8902971816199629
0,999,37,一番くじラブライブ！虹ヶ咲学園,441981,0.8923140595978357
0,1027,38,一番くじラブライブ！虹ヶ咲学園,443008,0.8943874666882016
0,1615,39,一番くじラブライブ！虹ヶ咲学園,444623,0.897647985140919
0,1349,40,一番くじラブライブ！虹ヶ咲学園,445972,0.9003714770249536
0,830,41,一番くじラブライブ！虹ヶ咲学園,446802,0.9020471614309941
0,869,42,一番くじラブライブ！虹ヶ咲学園,447671,0.9038015828151498
0,837,43,一番くじラブライブ！虹ヶ咲学園,448508,0.9054913994993136
0,893,44,一番くじラブライブ！虹ヶ咲学園,449401,0.9072942744084632
0,781,45,一番くじラブライブ！虹ヶ咲学園,450182,0.9088710328676411
0,851,46,一番くじラブライブ！虹ヶ咲学園,451033,0.9105891141080513
0,971,47,一番くじラブライブ！虹ヶ咲学園,452004,0.9125494629734313
0,608,48,一番くじラブライブ！虹ヶ咲学園,452612,0.9137769522732779
0,567,49,一番くじラブライブ！虹ヶ咲学園,453179,0.9149216668012597
0,555,50,一番くじラブライブ！虹ヶ咲学園,453734,0.9160421545667448
0,424,51,一番くじラブライブ！虹ヶ咲学園,454158,0.9168981668416377
0,494,52,一番くじラブライブ！虹ヶ咲学園,454652,0.917895501897763
0,688,53,一番くじラブライブ！虹ヶ咲学園,455340,0.9192845029475895
0,695,54,一番くじラブライブ！虹ヶ咲学園,456035,0.9206876362755391
0,391,55,一番くじラブライブ！虹ヶ咲学園,456426,0.9214770249535654
0,474,56,一番くじラブライブ！虹ヶ咲学園,456900,0.9224339820721957
0,426,57,一番くじラブライブ！虹ヶ咲学園,457326,0.9232940321408383
0,350,58,一番くじラブライブ！虹ヶ咲学園,457676,0.9240006460469999
0,349,59,一番くじラブライブ！虹ヶ咲学園,458025,0.9247052410562868
1840,3491,0,一番くじモンスターハンターアイスボーン,3491,0.007469616569667922
248560,45408,1,一番くじモンスターハンターアイスボーン,48899,0.10462812393016091
216960,56840,2,一番くじモンスターハンターアイスボーン,105739,0.22624743238616912
0,40839,3,一番くじモンスターハンターアイスボーン,146578,0.31362975008558713
0,32145,4,一番くじモンスターハンターアイスボーン,178723,0.3824097055802807
0,24645,5,一番くじモンスターハンターアイスボーン,203368,0.43514207463197535
0,21951,6,一番くじモンスターハンターアイスボーン,225319,0.4821101506333447
0,20219,7,一番くじモンスターハンターアイスボーン,245538,0.5253723040054776
0,21462,8,一番くじモンスターハンターアイスボーン,267000,0.5712940773707634
0,20265,9,一番くじモンスターハンターアイスボーン,287265,0.6146546559397467
0,16190,10,一番くじモンスターハンターアイスボーン,303455,0.6492960458747005
0,12486,11,一番くじモンスターハンターアイスボーン,315941,0.6760120677850051
0,10961,12,一番くじモンスターハンターアイスボーン,326902,0.6994650804519
0,8697,13,一番くじモンスターハンターアイスボーン,335599,0.7180738616912017
0,15032,14,一番くじモンスターハンターアイスボーン,350631,0.7502375042793564
0,8936,15,一番くじモンスターハンターアイスボーン,359567,0.7693576686066416
0,8145,16,一番くじモンスターハンターアイスボーン,367712,0.7867853474837384
0,7147,17,一番くじモンスターハンターアイスボーン,374859,0.8020776275248203
0,6586,18,一番くじモンスターハンターアイスボーン,381445,0.8161695480999658
0,6148,19,一番くじモンスターハンターアイスボーン,387593,0.8293242896268401
0,3494,20,一番くじモンスターハンターアイスボーン,391087,0.8368003252310853
0,3713,21,一番くじモンスターハンターアイスボーン,394800,0.844744950359466
0,3429,22,一番くじモンスターハンターアイスボーン,398229,0.8520819068812051
0,3173,23,一番くじモンスターハンターアイスボーン,401402,0.8588711057856898
0,4619,24,一番くじモンスターハンターアイスボーン,406021,0.8687542793563848
0,4686,25,一番くじモンスターハンターアイスボーン,410707,0.8787808113659705
0,2291,26,一番くじモンスターハンターアイスボーン,412998,0.8836828141047587
0,1973,27,一番くじモンスターハンターアイスボーン,414971,0.8879043991783636
0,2210,28,一番くじモンスターハンターアイスボーン,417181,0.8926330879835672
0,2131,29,一番くじモンスターハンターアイスボーン,419312,0.8971927422115714
0,1924,30,一番くじモンスターハンターアイスボーン,421236,0.9013094830537487
0,1995,31,一番くじモンスターハンターアイスボーン,423231,0.9055781410475865
0,1282,32,一番くじモンスターハンターアイスボーン,424513,0.9083212084902431
0,1182,33,一番くじモンスターハンターアイスボーン,425695,0.9108503081136597
0,1204,34,一番くじモンスターハンターアイスボーン,426899,0.9134264806573091
0,1317,35,一番くじモンスターハンターアイスボーン,428216,0.9162444368366998
0,1220,36,一番くじモンスターハンターアイスボーン,429436,0.9188548442314276
0,1298,37,一番くじモンスターハンターアイスボーン,430734,0.9216321465251626
0,986,38,一番くじモンスターハンターアイスボーン,431720,0.9237418692228688
0,672,39,一番くじモンスターハンターアイスボーン,432392,0.9251797329681616
0,1146,40,一番くじモンスターハンターアイスボーン,433538,0.9276318041766518
0,801,41,一番くじモンスターハンターアイスボーン,434339,0.9293456864087641
0,967,42,一番くじモンスターハンターアイスボーン,435306,0.9314147552208147
0,937,43,一番くじモンスターハンターアイスボーン,436243,0.9334196336870935
0,925,44,一番くじモンスターハンターアイスボーン,437168,0.9353988360150634
0,543,45,一番くじモンスターハンターアイスボーン,437711,0.9365606812735364
0,700,46,一番くじモンスターハンターアイスボーン,438411,0.9380584560082164
0,457,47,一番くじモンスターハンターアイスボーン,438868,0.9390362889421431
0,455,48,一番くじモンスターハンターアイスボーン,439323,0.940009842519685
0,523,49,一番くじモンスターハンターアイスボーン,439846,0.9411288942143101
0,512,50,一番くじモンスターハンターアイスボーン,440358,0.9422244094488189
0,572,51,一番くじモンスターハンターアイスボーン,440930,0.9434483053748716
0,386,52,一番くじモンスターハンターアイスボーン,441316,0.944274221157138
0,427,53,一番くじモンスターハンターアイスボーン,441743,0.9451878637452927
0,428,54,一番くじモンスターハンターアイスボーン,442171,0.9461036460116399
0,362,55,一番くじモンスターハンターアイスボーン,442533,0.9468782095172886
0,410,56,一番くじモンスターハンターアイスボーン,442943,0.9477554775761725
0,579,57,一番くじモンスターハンターアイスボーン,443522,0.9489943512495721
0,466,58,一番くじモンスターハンターアイスボーン,443988,0.9499914412872305
0,223,59,一番くじモンスターハンターアイスボーン,444211,0.9504685895241356
0,1766,0,一番くじディズニープリンセスビューティフル,1766,0.005689469648644643
149358,54712,1,一番くじディズニープリンセスビューティフル,56478,0.1819534919683761
160974,68184,2,一番くじディズニープリンセスビューティフル,124662,0.40161985579803994
66,47207,3,一番くじディズニープリンセスビューティフル,171869,0.553705242946153
0,46195,4,一番くじディズニープリンセスビューティフル,218064,0.7025302998086328
0,27702,5,一番くじディズニープリンセスビューティフル,245766,0.7917770088724798
0,18150,6,一番くじディズニープリンセスビューティフル,263916,0.8502503237778594
0,8842,7,一番くじディズニープリンセスビューティフル,272758,0.8787363320639953
0,6512,8,一番くじディズニープリンセスビューティフル,279270,0.8997158486845921
0,5226,9,一番くじディズニープリンセスビューティフル,284496,0.9165522973730501
0,4248,10,一番くじディズニープリンセスビューティフル,288744,0.9302379525641273
0,3851,11,一番くじディズニープリンセスビューティフル,292595,0.9426446046688445
0,2796,12,一番くじディズニープリンセスビューティフル,295391,0.9516523946674914
0,1257,13,一番くじディズニープリンセスビューティフル,296648,0.9557020341625913
0,1145,14,一番くじディズニープリンセスビューティフル,297793,0.9593908465905063
0,886,15,一番くじディズニープリンセスビューティフル,298679,0.9622452464255569
0,803,16,一番くじディズニープリンセスビューティフル,299482,0.9648322476304615
0,729,17,一番くじディズニープリンセスビューティフル,300211,0.9671808452374049
0,871,18,一番くじディズニープリンセスビューティフル,301082,0.9699869200188146
0,644,19,一番くじディズニープリンセスビューティフル,301726,0.9720616756551267
0,328,20,一番くじディズニープリンセスビューティフル,302054,0.973118383494739
0,404,21,一番くじディズニープリンセスビューティフル,302458,0.9744199382727982
0,311,22,一番くじディズニープリンセスビューティフル,302769,0.9754218777182843
0,247,23,一番くじディズニープリンセスビューティフル,303016,0.9762176302682363
0,263,24,一番くじディズニープリンセスビューティフル,303279,0.9770649295420718
0,371,25,一番くじディズニープリンセスビューティフル,303650,0.9782601692021211
0,257,26,一番くじディズニープリンセスビューティフル,303907,0.9790881384545004
0,188,27,一番くじディズニープリンセスビューティフル,304095,0.9796938124601319
0,119,28,一番くじディズニープリンセスビューティフル,304214,0.9800771912190156
0,194,29,一番くじディズニープリンセスビューティフル,304408,0.9807021952461034
0,181,30,一番くじディズニープリンセスビューティフル,304589,0.9812853175600358
0,189,31,一番くじディズニープリンセスビューティフル,304778,0.98189421323591
0,198,32,一番くじディズニープリンセスビューティフル,304976,0.9825321039439687
0,224,33,一番くじディズニープリンセスビューティフル,305200,0.9832537580783381
0,97,34,一番くじディズニープリンセスビューティフル,305297,0.9835662600918821
0,71,35,一番くじディズニープリンセスビューティフル,305368,0.9837949986791152
0,98,36,一番くじディズニープリンセスビューティフル,305466,0.9841107223629019
0,179,37,一番くじディズニープリンセスビューティフル,305645,0.9846874013363488
0,139,38,一番くじディズニープリンセスビューティフル,305784,0.985135213500087
0,118,39,一番くじディズニープリンセスビューティフル,305902,0.9855153705887281
0,68,40,一番くじディズニープリンセスビューティフル,305970,0.985734444165233
0,43,41,一番くじディズニープリンセスビューティフル,306013,0.98587297598567
0,54,42,一番くじディズニープリンセスビューティフル,306067,0.986046946178777
0,58,43,一番くじディズニープリンセスビューティフル,306125,0.9862338030528547
0,66,44,一番くじディズニープリンセスビューティフル,306191,0.9864464332888743
0,69,45,一番くじディズニープリンセスビューティフル,306260,0.986668728535622
0,104,46,一番くじディズニープリンセスビューティフル,306364,0.9870037822408649
0,65,47,一番くじディズニープリンセスビューティフル,306429,0.9872131908066418
0,47,48,一番くじディズニープリンセスビューティフル,306476,0.9873646093080497
0,55,49,一番くじディズニープリンセスビューティフル,306531,0.9875418011713993
0,54,50,一番くじディズニープリンセスビューティフル,306585,0.9877157713645062
0,48,51,一番くじディズニープリンセスビューティフル,306633,0.9878704115361568
0,75,52,一番くじディズニープリンセスビューティフル,306708,0.9881120368043609
0,61,53,一番くじディズニープリンセスビューティフル,306769,0.9883085586891668
0,53,54,一番くじディズニープリンセスビューティフル,306822,0.988479307212031
0,60,55,一番くじディズニープリンセスビューティフル,306882,0.9886726074265942
0,48,56,一番くじディズニープリンセスビューティフル,306930,0.9888272475982448
0,27,57,一番くじディズニープリンセスビューティフル,306957,0.9889142326947983
0,20,58,一番くじディズニープリンセスビューティフル,306977,0.9889786660996527
0,20,59,一番くじディズニープリンセスビューティフル,306997,0.9890430995045071
0,2422,0,一番くじ進撃の巨人自由の翼,2422,0.018342787467529025
64086,15387,1,一番くじ進撃の巨人自由の翼,17809,0.13487477374451876
14826,25404,2,一番くじ進撃の巨人自由の翼,43213,0.32726956021235826
53064,21934,3,一番くじ進撃の巨人自由の翼,65147,0.49338463053142584
0,13857,4,一番くじ進撃の巨人自由の翼,79004,0.5983293068062193
0,8720,5,一番くじ進撃の巨人自由の翼,87724,0.6643694004135079
0,6966,6,一番くじ進撃の巨人自由の翼,94690,0.7171257412470369
0,5983,7,一番くじ進撃の巨人自由の翼,100673,0.7624374247392856
0,4632,8,一番くじ進撃の巨人自由の翼,105305,0.7975174377655425
0,2485,9,一番くじ進撃の巨人自由の翼,107790,0.8163373497625738
0,2187,10,一番くじ進撃の巨人自由の翼,109977,0.8329003870010072
0,1833,11,一番くじ進撃の巨人自由の翼,111810,0.8467824387879522
65,1364,12,一番くじ進撃の巨人自由の翼,113174,0.8571125635219363
0,1557,13,一番くじ進撃の巨人自由の翼,114731,0.8689043554653478
0,1497,14,一番くじ進撃の巨人自由の翼,116228,0.8802417430949477
0,1196,15,一番くじ進撃の巨人自由の翼,117424,0.8892995357502594
0,1030,16,一番くじ進撃の巨人自由の翼,118454,0.8971001431373589
0,784,17,一番くじ進撃の巨人自由の翼,119238,0.9030376928378306
0,879,18,一番くじ進撃の巨人自由の翼,120117,0.9096947160351709
0,710,19,一番くじ進撃の巨人自由の翼,120827,0.9150718337486083
0,662,20,一番くじ進撃の巨人自由の翼,121489,0.9200854280109966
0,709,21,一番くじ進撃の巨人自由の翼,122198,0.9254549723192039
0,547,22,一番くじ進撃の巨人自由の翼,122745,0.9295976249801198
0,489,23,一番くじ進撃の巨人自由の翼,123234,0.9333010201376845
0,478,24,一番くじ進撃の巨人自由の翼,123712,0.9369211078377171
0,478,25,一番くじ進撃の巨人自由の翼,124190,0.9405411955377496
0,420,26,一番くじ進撃の巨人自由の翼,124610,0.943722025734431
0,221,27,一番くじ進撃の巨人自由の翼,124831,0.9453957482903038
0,279,28,一番くじ進撃の巨人自由の翼,125110,0.9475087283495278
0,266,29,一番くじ進撃の巨人自由の翼,125376,0.9495232541407593
0,302,30,一番くじ進撃の巨人自由の翼,125678,0.9518104225202778
0,158,31,一番くじ進撃の巨人自由の翼,125836,0.9530070205466484
0,161,32,一番くじ進撃の巨人自由の翼,125997,0.9542263387887095
0,99,33,一番くじ進撃の巨人自由の翼,126096,0.9549761059064987
0,242,34,一番くじ進撃の巨人自由の翼,126338,0.9568088699722056
0,162,35,一番くじ進撃の巨人自由の翼,126500,0.958035761619497
0,125,36,一番くじ進撃の巨人自由の翼,126625,0.9589824372732711
0,85,37,一番くじ進撃の巨人自由の翼,126710,0.9596261767178377
0,55,38,一番くじ進撃の巨人自由の翼,126765,0.9600427140054983
0,81,39,一番くじ進撃の巨人自由の翼,126846,0.960656159829144
0,89,40,一番くじ進撃の巨人自由の翼,126935,0.9613301928946312
0,48,41,一番くじ進撃の巨人自由の翼,126983,0.9616937163456805
0,83,42,一番くじ進撃の巨人自由の翼,127066,0.9623223089797865
0,98,43,一番くじ進撃の巨人自由の翼,127164,0.9630645026923456
0,31,44,一番くじ進撃の巨人自由の翼,127195,0.9632992782544816
0,40,45,一番くじ進撃の巨人自由の翼,127235,0.9636022144636893
0,45,46,一番くじ進撃の巨人自由の翼,127280,0.963943017699048
0,84,47,一番くじ進撃の巨人自由の翼,127364,0.9645791837383842
0,14,48,一番くじ進撃の巨人自由の翼,127378,0.964685211411607
0,108,49,一番くじ進撃の巨人自由の翼,127486,0.9655031391764679
0,78,50,一番くじ進撃の巨人自由の翼,127564,0.966093864784423
0,15,51,一番くじ進撃の巨人自由の翼,127579,0.9662074658628759
0,86,52,一番くじ進撃の巨人自由の翼,127665,0.9668587787126726
0,87,53,一番くじ進撃の巨人自由の翼,127752,0.9675176649676994
0,27,54,一番くじ進撃の巨人自由の翼,127779,0.9677221469089147
0,92,55,一番くじ進撃の巨人自由の翼,127871,0.9684189001900925
0,41,56,一番くじ進撃の巨人自由の翼,127912,0.9687294098045304
0,21,57,一番くじ進撃の巨人自由の翼,127933,0.9688884513143645
0,10,58,一番くじ進撃の巨人自由の翼,127943,0.9689641853666664
0,3,59,一番くじ進撃の巨人自由の翼,127946,0.968986905582357
50,1768,0,一番くじ週刊少年ジャンプ５０周年,1768,0.0036244362443624435
239550,20228,1,一番くじ週刊少年ジャンプ５０周年,21996,0.04509225092250922
248000,34413,2,一番くじ週刊少年ジャンプ５０周年,56409,0.11563960639606397
150,30787,3,一番くじ週刊少年ジャンプ５０周年,87196,0.17875358753587536
0,23943,4,一番くじ週刊少年ジャンプ５０周年,111139,0.22783722837228373
0,19975,5,一番くじ週刊少年ジャンプ５０周年,131114,0.26878638786387865
50,18382,6,一番くじ週刊少年ジャンプ５０周年,149496,0.306469864698647
0,17226,7,一番くじ週刊少年ジャンプ５０周年,166722,0.34178351783517835
0,19060,8,一番くじ週刊少年ジャンプ５０周年,185782,0.3808569085690857
0,19121,9,一番くじ週刊少年ジャンプ５０周年,204903,0.4200553505535055
0,16632,10,一番くじ週刊少年ジャンプ５０周年,221535,0.4541512915129151
0,11790,11,一番くじ週刊少年ジャンプ５０周年,233325,0.4783210332103321
0,9679,12,一番くじ週刊少年ジャンプ５０周年,243004,0.49816318163181633
0,8872,13,一番くじ週刊少年ジャンプ５０周年,251876,0.516350963509635
0,8695,14,一番くじ週刊少年ジャンプ５０周年,260571,0.5341758917589176
0,7837,15,一番くじ週刊少年ジャンプ５０周年,268408,0.5502419024190242
0,9005,16,一番くじ週刊少年ジャンプ５０周年,277413,0.5687023370233703
0,8286,17,一番くじ週刊少年ジャンプ５０周年,285699,0.5856888068880689
0,5049,18,一番くじ週刊少年ジャンプ５０周年,290748,0.596039360393604
0,4326,19,一番くじ週刊少年ジャンプ５０周年,295074,0.6049077490774908
0,4139,20,一番くじ週刊少年ジャンプ５０周年,299213,0.6133927839278392
0,4008,21,一番くじ週刊少年ジャンプ５０周年,303221,0.6216092660926609
0,4492,22,一番くじ週刊少年ジャンプ５０周年,307713,0.6308179581795818
0,5459,23,一番くじ週刊少年ジャンプ５０周年,313172,0.6420090200902009
0,5224,24,一番くじ週刊少年ジャンプ５０周年,318396,0.6527183271832718
0,3640,25,一番くじ週刊少年ジャンプ５０周年,322036,0.660180401804018
0,2934,26,一番くじ週刊少年ジャンプ５０周年,324970,0.6661951619516195
0,2887,27,一番くじ週刊少年ジャンプ５０周年,327857,0.6721135711357114
0,2478,28,一番くじ週刊少年ジャンプ５０周年,330335,0.6771935219352193
0,2729,29,一番くじ週刊少年ジャンプ５０周年,333064,0.6827880278802788
0,3755,30,一番くじ週刊少年ジャンプ５０周年,336819,0.6904858548585486
0,3263,31,一番くじ週刊少年ジャンプ５０周年,340082,0.6971750717507175
0,3027,32,一番くじ週刊少年ジャンプ５０周年,343109,0.7033804838048381
0,1803,33,一番くじ週刊少年ジャンプ５０周年,344912,0.7070766707667077
0,1841,34,一番くじ週刊少年ジャンプ５０周年,346753,0.7108507585075851
0,1913,35,一番くじ週刊少年ジャンプ５０周年,348666,0.7147724477244772
0,2130,36,一番くじ週刊少年ジャンプ５０周年,350796,0.7191389913899139
0,2930,37,一番くじ週刊少年ジャンプ５０周年,353726,0.7251455514555145
0,2791,38,一番くじ週刊少年ジャンプ５０周年,356517,0.7308671586715867
0,2060,39,一番くじ週刊少年ジャンプ５０周年,358577,0.735090200902009
0,1648,40,一番くじ週刊少年ジャンプ５０周年,360225,0.7384686346863468
0,1629,41,一番くじ週刊少年ジャンプ５０周年,361854,0.7418081180811809
0,1576,42,一番くじ週刊少年ジャンプ５０周年,363430,0.7450389503895039
0,1756,43,一番くじ週刊少年ジャンプ５０周年,365186,0.7486387863878639
0,2387,44,一番くじ週刊少年ジャンプ５０周年,367573,0.7535321853218532
0,2229,45,一番くじ週刊少年ジャンプ５０周年,369802,0.7581016810168102
0,1233,46,一番くじ週刊少年ジャンプ５０周年,371035,0.760629356293563
0,1173,47,一番くじ週刊少年ジャンプ５０周年,372208,0.7630340303403034
0,1152,48,一番くじ週刊少年ジャンプ５０周年,373360,0.7653956539565395
0,1378,49,一番くじ週刊少年ジャンプ５０周年,374738,0.768220582205822
0,1286,50,一番くじ週刊少年ジャンプ５０周年,376024,0.7708569085690857
0,1711,51,一番くじ週刊少年ジャンプ５０周年,377735,0.7743644936449364
0,1702,52,一番くじ週刊少年ジャンプ５０周年,379437,0.7778536285362854
0,1230,53,一番くじ週刊少年ジャンプ５０周年,380667,0.7803751537515375
0,866,54,一番くじ週刊少年ジャンプ５０周年,381533,0.7821504715047151
0,804,55,一番くじ週刊少年ジャンプ５０周年,382337,0.7837986879868799
0,814,56,一番くじ週刊少年ジャンプ５０周年,383151,0.7854674046740467
0,837,57,一番くじ週刊少年ジャンプ５０周年,383988,0.7871832718327183
0,1185,58,一番くじ週刊少年ジャンプ５０周年,385173,0.7896125461254613
0,1088,59,一番くじ週刊少年ジャンプ５０周年,386261,0.7918429684296843
0,715,0,一番くじぷち仮面ライダードライブ,715,0.0010225182837709903
345152,14130,1,一番くじぷち仮面ライダードライブ,14845,0.021229767723888602
354102,29728,2,一番くじぷち仮面ライダードライブ,44573,0.06374364680073336
0,33273,3,一番くじぷち仮面ライダードライブ,77846,0.11132721443137973
0,29739,4,一番くじぷち仮面ライダードライブ,107585,0.15385682455874403
0,24470,5,一番くじぷち仮面ライダードライブ,132055,0.18885126148724213
0,24695,6,一番くじぷち仮面ライダードライブ,156750,0.22416746990364017
0,23574,7,一番くじぷち仮面ライダードライブ,180324,0.2578805412625455
0,26862,8,一番くじぷち仮面ライダードライブ,207186,0.29629576663129564
0,22394,9,一番くじぷち仮面ライダードライブ,229580,0.32832132529810343
0,20376,10,一番くじぷち仮面ライダードライブ,249956,0.35746095124232397
0,16441,11,一番くじぷち仮面ライダードライブ,266397,0.3809731513870496
0,13142,12,一番くじぷち仮面ライダードライブ,279539,0.399767466471411
0,10136,13,一番くじぷち仮面ライダードライブ,289675,0.4142629144774288
0,9652,14,一番くじぷち仮面ライダードライブ,299327,0.4280661962605863
0,9208,15,一番くじぷち仮面ライダードライブ,308535,0.4412345156409545
0,9645,16,一番くじぷち仮面ライダードライブ,318180,0.4550277867555995
0,12790,17,一番くじぷち仮面ライダードライブ,330970,0.47331870822333516
0,12481,18,一番くじぷち仮面ライダードライブ,343451,0.4911677301810215
0,11183,19,一番くじぷち仮面ライダードライブ,354634,0.5071604881774004
0,6348,20,一番くじぷち仮面ライダードライブ,360982,0.5162387344226848
0,6070,21,一番くじぷち仮面ライダードライブ,367052,0.5249194141184749
0,5656,22,一番くじぷち仮面ライダードライブ,372708,0.533008034276529
0,6328,23,一番くじぷち仮面ライダードライブ,379036,0.5420576786117777
0,7508,24,一番くじぷち仮面ライダードライブ,386544,0.552794835639124
0,7313,25,一番くじぷち仮面ライダードライブ,393857,0.5632531240436236
0,4567,26,一番くじぷち仮面ライダードライブ,398424,0.569784370200242
0,4387,27,一番くじぷち仮面ライダードライブ,402811,0.5760581991665403
0,4275,28,一番くじぷち仮面ライダードライブ,407086,0.5821718574366396
0,4176,29,一番くじぷち仮面ライダードライブ,411262,0.588143936252063
0,5023,30,一番くじぷち仮面ライダードライブ,416285,0.5953273059574918
0,7026,31,一番くじぷち仮面ライダードライブ,423311,0.6053751569529813
0,6056,32,一番くじぷち仮面ライダードライブ,429367,0.6140358153117466
0,3755,33,一番くじぷち仮面ライダードライブ,433122,0.6194058239209215
0,4058,34,一番くじぷち仮面ライダードライブ,437180,0.625209151467135
0,3736,35,一番くじぷち仮面ライダードライブ,440916,0.6305519882617762
0,3670,36,一番くじぷち仮面ライダードライブ,444586,0.6358004387533
0,3686,37,一番くじぷち仮面ライダードライブ,448272,0.6410717707728522
0,5262,38,一番くじぷち仮面ライダードライブ,453534,0.648596933303206
0,4736,39,一番くじぷち仮面ライダードライブ,458270,0.6553698655996247
0,3095,40,一番くじぷち仮面ライダードライブ,461365,0.6597960111776264
0,2941,41,一番くじぷち仮面ライダードライブ,464306,0.6640019220483544
0,2729,42,一番くじぷち仮面ライダードライブ,467035,0.6679046526727055
0,2472,43,一番くじぷち仮面ライダードライブ,469507,0.6714398487530997
0,3031,44,一番くじぷち仮面ライダードライブ,472538,0.6757744682189877
0,3669,45,一番くじぷち仮面ライダードライブ,476207,0.6810214886150097
0,2986,46,一番くじぷち仮面ライダードライブ,479193,0.6852917537833176
0,2197,47,一番くじぷち仮面ライダードライブ,481390,0.688433673600723
0,2421,48,一番くじぷち仮面ライダードライブ,483811,0.6918959348105267
0,2935,49,一番くじぷち仮面ライダードライブ,486746,0.6960932651082439
0,2100,50,一番くじぷち仮面ライダードライブ,488846,0.6990964656619769
0,2137,51,一番くじぷち仮面ライダードライブ,490983,0.7021525797492757
0,2930,52,一番くじぷち仮面ライダードライブ,493913,0.706342759569484
0,2632,53,一番くじぷち仮面ライダードライブ,496545,0.7101067709301627
0,1966,54,一番くじぷち仮面ライダードライブ,498511,0.7129183386866575
0,1717,55,一番くじぷち仮面ライダードライブ,500228,0.7153738126632097
0,1467,56,一番くじぷち仮面ライダードライブ,501695,0.7174717627643175
0,1720,57,一番くじぷち仮面ライダードライブ,503415,0.7199315270273748
0,2103,58,一番くじぷち仮面ライダードライブ,505518,0.7229390178676132
0,2448,59,一番くじぷち仮面ライダードライブ,507966,0.7264398916559648
0,3146,0,一番くじ進撃の巨人壁外調査女型捕縛作戦,3146,0.003474703473930336
455341,40625,1,一番くじ進撃の巨人壁外調査女型捕縛作戦,43771,0.04834432477984893
449820,106115,2,一番くじ進撃の巨人壁外調査女型捕縛作戦,149886,0.16554653683837328
0,76237,3,一番くじ進撃の巨人壁外調査女型捕縛作戦,226123,0.24974900624143334
0,56068,4,一番くじ進撃の巨人壁外調査女型捕縛作戦,282191,0.31167515830002396
0,42246,5,一番くじ進撃の巨人壁外調査女型捕縛作戦,324437,0.3583351465262353
0,33347,6,一番くじ進撃の巨人壁外調査女型捕縛作戦,357784,0.3951663406601053
60,26665,7,一番くじ進撃の巨人壁外調査女型捕縛作戦,384449,0.4246173794815778
0,22230,8,一番くじ進撃の巨人壁外調査女型捕縛作戦,406679,0.44917003626017643
0,22081,9,一番くじ進撃の巨人壁外調査女型捕縛作戦,428760,0.4735581250738623
0,26714,10,一番くじ進撃の巨人壁外調査女型捕縛作戦,455474,0.5030632835616484
0,23204,11,一番くじ進撃の巨人壁外調査女型捕縛作戦,478678,0.5286917067686031
0,13892,12,一番くじ進撃の巨人壁外調査女型捕縛作戦,492570,0.5440351844100018
0,11568,13,一番くじ進撃の巨人壁外調査女型捕縛作戦,504138,0.5568118435919553
60,10347,14,一番くじ進撃の巨人壁外調査女型捕縛作戦,514485,0.568239929048013
60,9863,15,一番くじ進撃の巨人壁外調査女型捕縛作戦,524348,0.5791334447388505
0,9461,16,一番くじ進撃の巨人壁外調査女型捕縛作戦,533809,0.5895829582693194
0,14040,17,一番くじ進撃の巨人壁外調査女型捕縛作戦,547849,0.6050898993926448
0,12097,18,一番くじ進撃の巨人壁外調査女型捕縛作戦,559946,0.6184508300741881
0,7028,19,一番くじ進撃の巨人壁外調査女型捕縛作戦,566974,0.6262131364997388
0,6578,20,一番くじ進撃の巨人壁外調査女型捕縛作戦,573552,0.6334784255815932
60,7893,21,一番くじ進撃の巨人壁外調査女型捕縛作戦,581445,0.6421961097900267
0,6757,22,一番くじ進撃の巨人壁外調査女型捕縛作戦,588202,0.6496591013263736
0,7856,23,一番くじ進撃の巨人壁外調査女型捕縛作戦,596058,0.6583359196643256
0,9538,24,一番くじ進撃の巨人壁外調査女型捕縛作戦,605596,0.6688704783847157
0,8040,25,一番くじ進撃の巨人壁外調査女型捕縛作戦,613636,0.6777505215920901
0,5702,26,一番くじ進撃の巨人壁外調査女型捕縛作戦,619338,0.6840482835782156
0,4558,27,一番くじ進撃の巨人壁外調査女型捕縛作戦,623896,0.6890825170283664
0,4717,28,一番くじ進撃の巨人壁外調査女型捕縛作戦,628613,0.6942923632732899
0,4067,29,一番くじ進撃の巨人壁外調査女型捕縛作戦,632680,0.6987842955773188
0,4493,30,一番くじ進撃の巨人壁外調査女型捕縛作戦,637173,0.7037467376333801
0,6409,31,一番くじ進撃の巨人壁外調査女型捕縛作戦,643582,0.7108253690906018
0,5863,32,一番くじ進撃の巨人壁外調査女型捕縛作戦,649445,0.717300952837472
0,3558,33,一番くじ進撃の巨人壁外調査女型捕縛作戦,653003,0.721230703301631
0,3405,34,一番くじ進撃の巨人壁外調査女型捕縛作戦,656408,0.7249914678689332
0,3511,35,一番くじ進撃の巨人壁外調査女型捕縛作戦,659919,0.7288693076327506
0,4018,36,一番くじ進撃の巨人壁外調査女型捕縛作戦,663937,0.7333071202704657
0,3567,37,一番くじ進撃の巨人壁外調査女型捕縛作戦,667504,0.7372468110814987
0,5249,38,一番くじ進撃の巨人壁外調査女型捕縛作戦,672753,0.7430442422749699
0,5226,39,一番くじ進撃の巨人壁外調査女型捕縛作戦,677979,0.7488162703597633
0,3104,40,一番くじ進撃の巨人壁外調査女型捕縛作戦,681083,0.7522445855482819
0,3045,41,一番くじ進撃の巨人壁外調査女型捕縛作戦,684128,0.755607736240627
0,3091,42,一番くじ進撃の巨人壁外調査女型捕縛作戦,687219,0.7590216931503279
0,3210,43,一番くじ進撃の巨人壁外調査女型捕縛作戦,690429,0.7625670835353617
0,3136,44,一番くじ進撃の巨人壁外調査女型捕縛作戦,693565,0.7660307421794321
0,4540,45,一番くじ進撃の巨人壁外調査女型捕縛作戦,698105,0.7710450949358351
0,3647,46,一番くじ進撃の巨人壁外調査女型捕縛作戦,701752,0.7750731443857473
0,1994,47,一番くじ進撃の巨人壁外調査女型捕縛作戦,703746,0.777275483459815
0,2108,48,一番くじ進撃の巨人壁外調査女型捕縛作戦,705854,0.7796037335942858
0,1857,49,一番くじ進撃の巨人壁外調査女型捕縛作戦,707711,0.7816547584992727
0,1861,50,一番くじ進撃の巨人壁外調査女型捕縛作戦,709572,0.7837102013362035
0,2009,51,一番くじ進撃の巨人壁外調査女型捕縛作戦,711581,0.7859291076550611
0,2883,52,一番くじ進撃の巨人壁外調査女型捕縛作戦,714464,0.7891133321036756
0,2599,53,一番くじ進撃の巨人壁外調査女型捕縛作戦,717063,0.7919838833842684
0,1485,54,一番くじ進撃の巨人壁外調査女型捕縛作戦,718548,0.7936240406184663
0,1612,55,一番くじ進撃の巨人壁外調査女型捕縛作戦,720160,0.7954044671918852
0,1511,56,一番くじ進撃の巨人壁外調査女型捕縛作戦,721671,0.7970733409837188
0,1765,57,一番くじ進撃の巨人壁外調査女型捕縛作戦,723436,0.7990227534539944
0,1748,58,一番くじ進撃の巨人壁外調査女型捕縛作戦,725184,0.8009533897135082
0,1966,59,一番くじ進撃の巨人壁外調査女型捕縛作戦,727150,0.8031248032639681
0,2352,0,一番くじ仮面ライダーオーズ変身編,2352,0.0021302418259215652
544300,37361,1,一番くじ仮面ライダーオーズ変身編,39713,0.03596866225885337
559800,123787,2,一番くじ仮面ライダーオーズ変身編,163500,0.14808441264378228
0,125190,3,一番くじ仮面ライダーオーズ変身編,288690,0.26147088126075535
0,85911,4,一番くじ仮面ライダーオーズ変身編,374601,0.3392817679558011
0,81514,5,一番くじ仮面ライダーオーズ変身編,456115,0.41311022552305043
0,86182,6,一番くじ仮面ライダーオーズ変身編,542297,0.4911665609999094
0,78371,7,一番くじ仮面ライダーオーズ変身編,620668,0.5621483561271624
0,71992,8,一番くじ仮面ライダーオーズ変身編,692660,0.6273525948736528
0,78085,9,一番くじ仮面ライダーオーズ変身編,770745,0.6980753554931618
0,59292,10,一番くじ仮面ライダーオーズ変身編,830037,0.7517770129517254
0,44193,11,一番くじ仮面ライダーオーズ変身編,874230,0.7918032786885246
0,29554,12,一番くじ仮面ライダーオーズ変身編,903784,0.8185707816320985
0,20553,13,一番くじ仮面ライダーオーズ変身編,924337,0.8371859433022372
0,15189,14,一番くじ仮面ライダーオーズ変身編,939526,0.8509428493795852
0,14041,15,一番くじ仮面ライダーオーズ変身編,953567,0.8636599945657096
0,15840,16,一番くじ仮面ライダーオーズ変身編,969407,0.8780065211484467
0,15046,17,一番くじ仮面ライダーオーズ変身編,984453,0.8916339099719228
0,11066,18,一番くじ仮面ライダーオーズ変身編,995519,0.9016565528484739
0,6563,19,一番くじ仮面ライダーオーズ変身編,1002082,0.9076007608006521
0,5407,20,一番くじ仮面ライダーオーズ変身編,1007489,0.9124979621411105
0,5303,21,一番くじ仮面ライダーオーズ変身編,1012792,0.9173009691151164
0,5025,22,一番くじ仮面ライダーオーズ変身編,1017817,0.9218521873018748
0,5494,23,一番くじ仮面ライダーオーズ変身編,1023311,0.9268281858527307
0,4235,24,一番くじ仮面ライダーオーズ変身編,1027546,0.9306638891404764
0,3091,25,一番くじ仮面ライダーオーズ変身編,1030637,0.9334634543972467
0,2787,26,一番くじ仮面ライダーオーズ変身編,1033424,0.9359876822751563
0,2630,27,一番くじ仮面ライダーオーズ変身編,1036054,0.9383697128883254
0,2478,28,一番くじ仮面ライダーオーズ変身編,1038532,0.9406140748120642
0,2413,29,一番くじ仮面ライダーオーズ変身編,1040945,0.9427995652567702
0,3002,30,一番くじ仮面ライダーオーズ変身編,1043947,0.9455185218730188
0,2472,31,一番くじ仮面ライダーオーズ変身編,1046419,0.9477574495063853
0,1791,32,一番くじ仮面ライダーオーズ変身編,1048210,0.9493795851825015
0,1909,33,一番くじ仮面ライダーオーズ変身編,1050119,0.9511085952359388
0,1677,34,一番くじ仮面ライダーオーズ変身編,1051796,0.9526274793949824
0,1406,35,一番くじ仮面ライダーオーズ変身編,1053202,0.9539009147722126
0,1314,36,一番くじ仮面ライダーオーズ変身編,1054516,0.9550910243637352
0,1582,37,一番くじ仮面ライダーオーズ変身編,1056098,0.9565238655918848
0,1202,38,一番くじ仮面ライダーオーズ変身編,1057300,0.9576125350964586
0,970,39,一番くじ仮面ライダーオーズ変身編,1058270,0.9584910787066389
0,829,40,一番くじ仮面ライダーオーズ変身編,1059099,0.9592419164930713
0,872,41,一番くじ仮面ライダーオーズ変身編,1059971,0.9600317000271714
0,695,42,一番くじ仮面ライダーオーズ変身編,1060666,0.9606611719952903
0,889,43,一番くじ仮面ライダーオーズ変身編,1061555,0.9614663526854451
0,1083,44,一番くじ仮面ライダーオーズ変身編,1062638,0.9624472420976361
0,973,45,一番くじ仮面ライダーオーズ変身編,1063611,0.9633285028530024
0,624,46,一番くじ仮面ライダーオーズ変身編,1064235,0.9638936690517164
0,570,47,一番くじ仮面ライダーオーズ変身編,1064805,0.96440992663708
0,554,48,一番くじ仮面ライダーオーズ変身編,1065359,0.964911692781451
0,752,49,一番くじ仮面ライダーオーズ変身編,1066111,0.9655927905081062
0,617,50,一番くじ仮面ライダーオーズ変身編,1066728,0.9661516167013857
0,581,51,一番くじ仮面ライダーオーズ変身編,1067309,0.9666778371524318
0,676,52,一番くじ仮面ライダーオーズ変身編,1067985,0.9672901005343719
0,434,53,一番くじ仮面ライダーオーズ変身編,1068419,0.9676831808712979
0,399,54,一番くじ仮面ライダーオーズ変身編,1068818,0.9680445611810524
0,497,55,一番くじ仮面ライダーオーズ変身編,1069315,0.9684947015668871
0,551,56,一番くじ仮面ライダーオーズ変身編,1069866,0.968993750566072
0,441,57,一番くじ仮面ライダーオーズ変身編,1070307,0.9693931709084322
0,611,58,一番くじ仮面ライダーオーズ変身編,1070918,0.9699465628113395
0,491,59,一番くじ仮面ライダーオーズ変身編,1071409,0.9703912689068019
1650,7525,0,ポケモンコレクションくじ２０２０,7525,0.010957695287244515
358842,93126,1,ポケモンコレクションくじ２０２０,100651,0.14656518117693657
326108,128017,2,ポケモンコレクションくじ２０２０,228668,0.33297996889616327
0,76426,3,ポケモンコレクションくじ２０２０,305094,0.4442693801948941
0,60960,4,ポケモンコレクションくじ２０２０,366054,0.5330376333125586
0,52777,5,ポケモンコレクションくじ２０２０,418831,0.6098900298806521
66,43844,6,ポケモンコレクションくじ２０２０,462675,0.6737344408007782
0,40861,7,ポケモンコレクションくじ２０２０,503536,0.7332350902535487
0,41270,8,ポケモンコレクションくじ２０２０,544806,0.7933313141079781
0,28073,9,ポケモンコレクションくじ２０２０,572879,0.8342104343470232
0,15491,10,ポケモンコレクションくじ２０２０,588370,0.8567679968313694
0,16664,11,ポケモンコレクションくじ２０２０,605034,0.8810336492256077
0,9936,12,ポケモンコレクションくじ２０２０,614970,0.895502175521164
0,7949,13,ポケモンコレクションくじ２０２０,622919,0.9070772877920353
66,6492,14,ポケモンコレクションくじ２０２０,629411,0.9165307572677551
0,7293,15,ポケモンコレクションくじ２０２０,636704,0.9271506206205623
0,5360,16,ポケモンコレクションくじ２０２０,642064,0.9349557032437691
0,3351,17,ポケモンコレクションくじ２０２０,645415,0.9398353360554045
0,2696,18,ポケモンコレクションくじ２０２０,648111,0.9437611761211069
0,3129,19,ポケモンコレクションくじ２０２０,651240,0.948317538719617
0,3402,20,ポケモンコレクションくじ２０２０,654642,0.9532714363099434
0,2815,21,ポケモンコレクションくじ２０２０,657457,0.9573705608592581
0,2358,22,ポケモンコレクションくじ２０２０,659815,0.9608042147446165
0,1755,23,ポケモンコレクションくじ２０２０,661570,0.9633597968348643
0,1206,24,ポケモンコレクションくじ２０２０,662776,0.9651159404250857
0,1316,25,ポケモンコレクションくじ２０２０,664092,0.9670322629497388
0,1001,26,ポケモンコレクションくじ２０２０,665093,0.9684898912530653
0,1076,27,ポケモンコレクションくじ２０２０,666169,0.9700567324662314
0,1010,28,ポケモンコレクションくじ２０２０,667179,0.9715274663187387
0,1193,29,ポケモンコレクションくじ２０２０,668372,0.9732646796712546
0,1031,30,ポケモンコレクションくじ２０２０,669403,0.974765993138517
0,692,31,ポケモンコレクションくじ２０２０,670095,0.975773664253304
0,653,32,ポケモンコレクションくじ２０２０,670748,0.9767245446549746
0,577,33,ポケモンコレクションくじ２０２０,671325,0.9775647559746743
0,639,34,ポケモンコレクションくじ２０２０,671964,0.978495249966508
0,1065,35,ポケモンコレクションくじ２０２０,673029,0.9800460732862311
0,812,36,ポケモンコレクションくじ２０２０,673841,0.9812284850567616
0,645,37,ポケモンコレクションくじ２０２０,674486,0.9821677160813825
0,422,38,ポケモンコレクションくじ２０２０,674908,0.982782220720747
0,493,39,ポケモンコレクションくじ２０２０,675401,0.9835001135814262
0,311,40,ポケモンコレクションくじ２０２０,675712,0.983952983114228
0,323,41,ポケモンコレクションくじ２０２０,676035,0.984423326712604
0,406,42,ポケモンコレクションくじ２０２０,676441,0.9850145325978693
0,437,43,ポケモンコレクションくじ２０２０,676878,0.9856508798192016
0,340,44,ポケモンコレクションくじ２０２０,677218,0.986145978343808
0,273,45,ポケモンコレクションくじ２０２０,677491,0.9865435133356244
0,204,46,ポケモンコレクションくじ２０２０,677695,0.9868405724503883
0,173,47,ポケモンコレクションくじ２０２０,677868,0.987092490229085
0,147,48,ポケモンコレクションくじ２０２０,678015,0.9873065475323707
0,138,49,ポケモンコレクションくじ２０２０,678153,0.9875074992864756
0,155,50,ポケモンコレクションくじ２０２０,678308,0.9877332059668109
0,157,51,ポケモンコレクションくじ２０２０,678465,0.9879618249914086
0,97,52,ポケモンコレクションくじ２０２０,678562,0.9881030736881345
0,89,53,ポケモンコレクションくじ２０２０,678651,0.9882326730078109
0,89,54,ポケモンコレクションくじ２０２０,678740,0.9883622723274873
0,62,55,ポケモンコレクションくじ２０２０,678802,0.9884525549996214
0,82,56,ポケモンコレクションくじ２０２０,678884,0.9885719611143794
0,110,57,ポケモンコレクションくじ２０２０,678994,0.9887321400488109
0,75,58,ポケモンコレクションくじ２０２０,679069,0.9888413529586505
0,53,59,ポケモンコレクションくじ２０２０,679122,0.9889185300816039
640,92,0,一番くじモンスターハンター１０th,92,0.001635846372688478
28320,1398,1,一番くじモンスターハンター１０th,1490,0.026493598862019914
27200,3436,2,一番くじモンスターハンター１０th,4926,0.08758890469416786
0,3017,3,一番くじモンスターハンター１０th,7943,0.14123399715504978
80,2546,4,一番くじモンスターハンター１０th,10489,0.18650426742532006
0,2889,5,一番くじモンスターハンター１０th,13378,0.23787339971550497
0,2500,6,一番くじモンスターハンター１０th,15878,0.282325746799431
0,2433,7,一番くじモンスターハンター１０th,18311,0.32558677098150784
0,2380,8,一番くじモンスターハンター１０th,20691,0.3679054054054054
0,2312,9,一番くじモンスターハンター１０th,23003,0.4090149359886202
0,1922,10,一番くじモンスターハンター１０th,24925,0.44318990042674256
0,1611,11,一番くじモンスターハンター１０th,26536,0.4718349928876245
0,1407,12,一番くじモンスターハンター１０th,27943,0.49685277382645804
0,1384,13,一番くじモンスターハンター１０th,29327,0.5214615931721195
0,1098,14,一番くじモンスターハンター１０th,30425,0.5409850640113798
0,1204,15,一番くじモンスターハンター１０th,31629,0.5623933143669986
0,1225,16,一番くじモンスターハンター１０th,32854,0.5841749644381223
0,1204,17,一番くじモンスターハンター１０th,34058,0.6055832147937411
0,897,18,一番くじモンスターハンター１０th,34955,0.6215327169274538
0,847,19,一番くじモンスターハンター１０th,35802,0.636593172119488
0,624,20,一番くじモンスターハンター１０th,36426,0.6476884779516359
0,656,21,一番くじモンスターハンター１０th,37082,0.6593527738264581
0,458,22,一番くじモンスターハンター１０th,37540,0.6674964438122333
0,808,23,一番くじモンスターハンター１０th,38348,0.6818634423897582
0,728,24,一番くじモンスターハンター１０th,39076,0.6948079658605975
0,453,25,一番くじモンスターハンター１０th,39529,0.7028627311522049
0,534,26,一番くじモンスターハンター１０th,40063,0.7123577524893314
0,478,27,一番くじモンスターハンター１０th,40541,0.7208570412517781
0,489,28,一番くじモンスターハンター１０th,41030,0.729551920341394
0,460,29,一番くじモンスターハンター１０th,41490,0.7377311522048364
0,636,30,一番くじモンスターハンター１０th,42126,0.7490398293029872
0,579,31,一番くじモンスターハンター１０th,42705,0.7593349928876245
0,325,32,一番くじモンスターハンター１０th,43030,0.7651137980085349
0,292,33,一番くじモンスターハンター１０th,43322,0.7703058321479375
0,330,34,一番くじモンスターハンター１０th,43652,0.7761735419630157
0,327,35,一番くじモンスターハンター１０th,43979,0.7819879089615932
0,328,36,一番くじモンスターハンター１０th,44307,0.7878200568990043
0,486,37,一番くじモンスターハンター１０th,44793,0.7964615931721195
0,418,38,一番くじモンスターハンター１０th,45211,0.8038940256045519
0,244,39,一番くじモンスターハンター１０th,45455,0.8082325746799431
0,260,40,一番くじモンスターハンター１０th,45715,0.8128556187766715
0,221,41,一番くじモンスターハンター１０th,45936,0.8167852062588905
0,208,42,一番くじモンスターハンター１０th,46144,0.8204836415362731
0,199,43,一番くじモンスターハンター１０th,46343,0.8240220483641536
0,393,44,一番くじモンスターハンター１０th,46736,0.8310099573257468
0,429,45,一番くじモンスターハンター１０th,47165,0.8386379800853485
0,313,46,一番くじモンスターハンター１０th,47478,0.844203413940256
0,230,47,一番くじモンスターハンター１０th,47708,0.8482930298719772
0,198,48,一番くじモンスターハンター１０th,47906,0.8518136557610242
0,123,49,一番くじモンスターハンター１０th,48029,0.8540007112375534
0,181,50,一番くじモンスターハンター１０th,48210,0.8572190611664295
0,245,51,一番くじモンスターハンター１０th,48455,0.8615753911806543
0,173,52,一番くじモンスターハンター１０th,48628,0.8646514935988621
0,132,53,一番くじモンスターハンター１０th,48760,0.8669985775248933
0,351,54,一番くじモンスターハンター１０th,49111,0.8732396870554765
0,114,55,一番くじモンスターハンター１０th,49225,0.8752667140825036
0,119,56,一番くじモンスターハンター１０th,49344,0.8773826458036984
0,151,57,一番くじモンスターハンター１０th,49495,0.8800675675675675
0,222,58,一番くじモンスターハンター１０th,49717,0.8840149359886202
0,131,59,一番くじモンスターハンター１０th,49848,0.8863442389758179
0,3854,0,一番くじ美少女戦士セーラームーンＬｉｆｅ,3854,0.007661418575063614
257040,48465,1,一番くじ美少女戦士セーラームーンＬｉｆｅ,52319,0.10400564567430025
245820,81078,2,一番くじ美少女戦士セーラームーンＬｉｆｅ,133397,0.26518169529262087
180,60054,3,一番くじ美少女戦士セーラームーンＬｉｆｅ,193451,0.3845638517811705
0,42505,4,一番くじ美少女戦士セーラームーンＬｉｆｅ,235956,0.4690601145038168
0,36255,5,一番くじ美少女戦士セーラームーンＬｉｆｅ,272211,0.5411319179389313
0,29114,6,一番くじ美少女戦士セーラームーンＬｉｆｅ,301325,0.5990080311704835
0,26442,7,一番くじ美少女戦士セーラームーンＬｉｆｅ,327767,0.65157243956743
0,21156,8,一番くじ美少女戦士セーラームーンＬｉｆｅ,348923,0.6936287372773536
0,21124,9,一番くじ美少女戦士セーラームーンＬｉｆｅ,370047,0.7356214217557252
0,17129,10,一番くじ美少女戦士セーラームーンＬｉｆｅ,387176,0.7696723918575064
0,11072,11,一番くじ美少女戦士セーラームーンＬｉｆｅ,398248,0.7916825699745547
0,9618,12,一番くじ美少女戦士セーラームーンＬｉｆｅ,407866,0.8108023218829516
0,7909,13,一番くじ美少女戦士セーラームーンＬｉｆｅ,415775,0.8265247296437659
0,6227,14,一番くじ美少女戦士セーラームーンＬｉｆｅ,422002,0.8389034669211196
0,5817,15,一番くじ美少女戦士セーラームーンＬｉｆｅ,427819,0.8504671596692112
0,6014,16,一番くじ美少女戦士セーラームーンＬｉｆｅ,433833,0.8624224713740458
0,4726,17,一番くじ美少女戦士セーラームーンＬｉｆｅ,438559,0.8718173505089059
0,3038,18,一番くじ美少女戦士セーラームーンＬｉｆｅ,441597,0.8778566316793893
0,3036,19,一番くじ美少女戦士セーラームーンＬｉｆｅ,444633,0.8838919370229008
0,3252,20,一番くじ美少女戦士セーラームーンＬｉｆｅ,447885,0.8903566316793893
0,2328,21,一番くじ美少女戦士セーラームーンＬｉｆｅ,450213,0.8949844942748092
0,2354,22,一番くじ美少女戦士セーラームーンＬｉｆｅ,452567,0.8996640426208652
0,2654,23,一番くじ美少女戦士セーラームーンＬｉｆｅ,455221,0.9049399650127227
0,2820,24,一番くじ美少女戦士セーラームーンＬｉｆｅ,458041,0.910545881043257
0,1847,25,一番くじ美少女戦士セーラームーンＬｉｆｅ,459888,0.9142175572519083
0,1717,26,一番くじ美少女戦士セーラームーンＬｉｆｅ,461605,0.9176308047073791
0,1550,27,一番くじ美少女戦士セーラームーンＬｉｆｅ,463155,0.920712070610687
0,1658,28,一番くじ美少女戦士セーラームーンＬｉｆｅ,464813,0.9240080311704835
0,1698,29,一番くじ美少女戦士セーラームーンＬｉｆｅ,466511,0.92738350826972
0,1754,30,一番くじ美少女戦士セーラームーンＬｉｆｅ,468265,0.9308703085241731
0,1488,31,一番くじ美少女戦士セーラームーンＬｉｆｅ,469753,0.9338283237913486
0,1096,32,一番くじ美少女戦士セーラームーンＬｉｆｅ,470849,0.9360070769720101
0,959,33,一番くじ美少女戦士セーラームーンＬｉｆｅ,471808,0.9379134860050891
0,1221,34,一番くじ美少女戦士セーラームーンＬｉｆｅ,473029,0.9403407283715013
0,938,35,一番くじ美少女戦士セーラームーンＬｉｆｅ,473967,0.942205391221374
0,1017,36,一番くじ美少女戦士セーラームーンＬｉｆｅ,474984,0.9442270992366413
0,1090,37,一番くじ美少女戦士セーラームーンＬｉｆｅ,476074,0.9463939249363867
0,968,38,一番くじ美少女戦士セーラームーンＬｉｆｅ,477042,0.9483182251908397
0,816,39,一番くじ美少女戦士セーラームーンＬｉｆｅ,477858,0.9499403625954198
0,570,40,一番くじ美少女戦士セーラームーンＬｉｆｅ,478428,0.9510734732824427
0,627,41,一番くじ美少女戦士セーラームーンＬｉｆｅ,479055,0.9523198950381679
0,503,42,一番くじ美少女戦士セーラームーンＬｉｆｅ,479558,0.9533198155216285
0,524,43,一番くじ美少女戦士セーラームーンＬｉｆｅ,480082,0.9543614821882952
0,752,44,一番くじ美少女戦士セーラームーンＬｉｆｅ,480834,0.955856393129771
0,504,45,一番くじ美少女戦士セーラームーンＬｉｆｅ,481338,0.9568583015267176
0,302,46,一番くじ美少女戦士セーラームーンＬｉｆｅ,481640,0.957458651399491
0,308,47,一番くじ美少女戦士セーラームーンＬｉｆｅ,481948,0.9580709287531807
0,365,48,一番くじ美少女戦士セーラームーンＬｉｆｅ,482313,0.9587965171755726
0,311,49,一番くじ美少女戦士セーラームーンＬｉｆｅ,482624,0.9594147582697201
0,287,50,一番くじ美少女戦士セーラームーンＬｉｆｅ,482911,0.9599852894402036
0,368,51,一番くじ美少女戦士セーラームーンＬｉｆｅ,483279,0.9607168416030535
0,471,52,一番くじ美少女戦士セーラームーンＬｉｆｅ,483750,0.9616531488549618
0,356,53,一番くじ美少女戦士セーラームーンＬｉｆｅ,484106,0.9623608460559796
0,269,54,一番くじ美少女戦士セーラームーンＬｉｆｅ,484375,0.962895594783715
0,260,55,一番くじ美少女戦士セーラームーンＬｉｆｅ,484635,0.9634124522900763
0,272,56,一番くじ美少女戦士セーラームーンＬｉｆｅ,484907,0.9639531647582698
0,348,57,一番くじ美少女戦士セーラームーンＬｉｆｅ,485255,0.9646449586513995
0,390,58,一番くじ美少女戦士セーラームーンＬｉｆｅ,485645,0.9654202449109415
0,346,59,一番くじ美少女戦士セーラームーンＬｉｆｅ,485991,0.9661080629770993
0,73,0,映画妖怪ウォッチ箱を選んで運だめし,73,0.0014163756305781918
25400,718,1,映画妖怪ウォッチ箱を選んで運だめし,791,0.015347303065580131
26120,2598,2,映画妖怪ウォッチ箱を選んで運だめし,3389,0.06575475358944509
0,2044,3,映画妖怪ウォッチ箱を選んで運だめし,5433,0.10541327124563446
0,1609,4,映画妖怪ウォッチ箱を選んで運だめし,7042,0.13663174233604966
0,1670,5,映画妖怪ウォッチ箱を選んで運だめし,8712,0.1690337601862631
20,1615,6,映画妖怪ウォッチ箱を選んで運だめし,10327,0.2003686457120683
0,1488,7,映画妖怪ウォッチ箱を選んで運だめし,11815,0.22923942568878541
0,1695,8,映画妖怪ウォッチ箱を選んで運だめし,13510,0.2621265036864571
0,1694,9,映画妖怪ウォッチ箱を選んで運だめし,15204,0.2949941792782305
0,1401,10,映画妖怪ウォッチ箱を選んで運だめし,16605,0.3221769499417928
0,1325,11,映画妖怪ウォッチ箱を選んで運だめし,17930,0.34788513775708185
0,1372,12,映画妖怪ウォッチ箱を選んで運だめし,19302,0.37450523864959256
0,1479,13,映画妖怪ウォッチ箱を選んで運だめし,20781,0.40320139697322466
0,1700,14,映画妖怪ウォッチ箱を選んで運だめし,22481,0.43618548700038806
0,2206,15,映画妖怪ウォッチ箱を選んで運だめし,24687,0.4789871944121071
0,1848,16,映画妖怪ウォッチ箱を選んで運だめし,26535,0.5148428405122235
0,1327,17,映画妖怪ウォッチ箱を選んで運だめし,27862,0.5405898331393093
0,940,18,映画妖怪ウォッチ箱を選んで運だめし,28802,0.5588280946837408
0,782,19,映画妖怪ウォッチ箱を選んで運だめし,29584,0.5740007760962359
0,738,20,映画妖怪ウォッチ箱を選んで運だめし,30322,0.5883197516492045
0,655,21,映画妖怪ウォッチ箱を選んで運だめし,30977,0.6010283275126116
0,677,22,映画妖怪ウォッチ箱を選んで運だめし,31654,0.6141637563057819
0,892,23,映画妖怪ウォッチ箱を選んで運だめし,32546,0.6314707023670936
0,853,24,映画妖怪ウォッチ箱を選んで運だめし,33399,0.6480209545983702
0,612,25,映画妖怪ウォッチ箱を選んで運だめし,34011,0.6598952270081491
0,391,26,映画妖怪ウォッチ箱を選んで運だめし,34402,0.6674815677143966
0,376,27,映画妖怪ウォッチ箱を選んで運だめし,34778,0.6747768723321692
0,367,28,映画妖怪ウォッチ箱を選んで運だめし,35145,0.6818975552968568
0,424,29,映画妖怪ウォッチ箱を選んで運だめし,35569,0.6901241753977493
0,553,30,映画妖怪ウォッチ箱を選んで運だめし,36122,0.7008537058595266
0,477,31,映画妖怪ウォッチ箱を選んで運だめし,36599,0.7101086534730306
0,276,32,映画妖怪ウォッチ箱を選んで運だめし,36875,0.7154637175009702
0,243,33,映画妖怪ウォッチ箱を選んで運だめし,37118,0.7201785021342646
0,229,34,映画妖怪ウォッチ箱を選んで運だめし,37347,0.7246216530849825
0,286,35,映画妖怪ウォッチ箱を選んで運だめし,37633,0.7301707411719053
0,298,36,映画妖怪ウォッチ箱を選んで運だめし,37931,0.7359526581296081
0,388,37,映画妖怪ウォッチ箱を選んで運だめし,38319,0.7434807916181606
0,271,38,映画妖怪ウォッチ箱を選んで運だめし,38590,0.7487388436166085
0,233,39,映画妖怪ウォッチ箱を選んで運だめし,38823,0.7532596041909196
0,184,40,映画妖怪ウォッチ箱を選んで運だめし,39007,0.7568296468762127
0,232,41,映画妖怪ウォッチ箱を選んで運だめし,39239,0.7613310050446256
0,203,42,映画妖怪ウォッチ箱を選んで運だめし,39442,0.7652696934419868
0,198,43,映画妖怪ウォッチ箱を選んで運だめし,39640,0.7691113698098564
0,310,44,映画妖怪ウォッチ箱を選んで運だめし,39950,0.7751261156383391
0,316,45,映画妖怪ウォッチ箱を選んで運だめし,40266,0.7812572759022118
0,163,46,映画妖怪ウォッチ箱を選んで運だめし,40429,0.78441986806364
0,147,47,映画妖怪ウォッチ箱を選んで運だめし,40576,0.7872720217306947
0,155,48,映画妖怪ウォッチ箱を選んで運だめし,40731,0.790279394644936
0,133,49,映画妖怪ウォッチ箱を選んで運だめし,40864,0.7928599146294141
0,151,50,映画妖怪ウォッチ箱を選んで運だめし,41015,0.795789677920062
0,213,51,映画妖怪ウォッチ箱を選んで運だめし,41228,0.7999223903764067
0,173,52,映画妖怪ウォッチ箱を選んで運だめし,41401,0.8032790065968181
0,150,53,映画妖怪ウォッチ箱を選んで運だめし,41551,0.8061893674815677
0,126,54,映画妖怪ウォッチ箱を選んで運だめし,41677,0.8086340706247575
0,140,55,映画妖怪ウォッチ箱を選んで運だめし,41817,0.8113504074505239
0,225,56,映画妖怪ウォッチ箱を選んで運だめし,42042,0.8157159487776484
0,99,57,映画妖怪ウォッチ箱を選んで運だめし,42141,0.8176367869615833
0,184,58,映画妖怪ウォッチ箱を選んで運だめし,42325,0.8212068296468762
0,163,59,映画妖怪ウォッチ箱を選んで運だめし,42488,0.8243694218083042
0,48,0,モンスターストライク缶バッジコード付き,48,0.0010588780304868633
23130,654,1,モンスターストライク缶バッジコード付き,702,0.015486091195870376
22171,1304,2,モンスターストライク缶バッジコード付き,2006,0.044252277690763495
0,1559,3,モンスターストライク缶バッジコード付き,3565,0.07864375372261807
0,2109,4,モンスターストライク缶バッジコード付き,5674,0.12516820718713464
0,2044,5,モンスターストライク缶バッジコード付き,7718,0.17025876331870024
0,1451,6,モンスターストライク缶バッジコード付き,9169,0.20226776378195938
0,1347,7,モンスターストライク缶バッジコード付き,10516,0.23198252851249695
30,1640,8,モンスターストライク缶バッジコード付き,12156,0.26816086122079813
0,1400,9,モンスターストライク缶バッジコード付き,13556,0.299044803776665
0,1438,10,モンスターストライク缶バッジコード付き,14994,0.3307670247733339
0,2302,11,モンスターストライク缶バッジコード付き,17296,0.3815490503187664
0,2113,12,モンスターストライク缶バッジコード付き,19409,0.4281617436191569
0,1218,13,モンスターストライク缶バッジコード付き,20627,0.455030773642761
0,983,14,モンスターストライク缶バッジコード付き,21610,0.47671571330877327
0,1030,15,モンスターストライク缶バッジコード付き,22640,0.49943747104630387
0,921,16,モンスターストライク缶バッジコード付き,23561,0.5197546932562706
0,857,17,モンスターストライク缶バッジコード付き,24418,0.5386600780922548
0,1296,18,モンスターストライク缶バッジコード付き,25714,0.5672497849154
0,1183,19,モンスターストライク缶バッジコード付き,26897,0.5933467163751075
0,604,20,モンスターストライク缶バッジコード付き,27501,0.6066709315920672
0,608,21,モンスターストライク缶バッジコード付き,28109,0.6200833866449008
0,636,22,モンスターストライク缶バッジコード付き,28745,0.6341135205488517
0,579,23,モンスターストライク缶バッジコード付き,29324,0.6468862367915996
0,580,24,モンスターストライク缶バッジコード付き,29904,0.6596810129933158
0,813,25,モンスターストライク缶バッジコード付き,30717,0.6776157596346871
0,728,26,モンスターストライク缶バッジコード付き,31445,0.6936754097637379
0,520,27,モンスターストライク缶バッジコード付き,31965,0.7051465884273456
0,392,28,モンスターストライク缶バッジコード付き,32357,0.7137940923429883
0,321,29,モンスターストライク缶バッジコード付き,32678,0.7208753391718692
0,270,30,モンスターストライク缶バッジコード付き,32948,0.7268315280933577
0,307,31,モンスターストライク缶バッジコード付き,33255,0.73360393549668
0,518,32,モンスターストライク缶バッジコード付き,33773,0.7450309942423508
0,547,33,モンスターストライク缶バッジコード付き,34320,0.7570977917981072
0,273,34,モンスターストライク缶バッジコード付き,34593,0.7631201605965013
0,207,35,モンスターストライク缶バッジコード付き,34800,0.7676865721029759
0,231,36,モンスターストライク缶バッジコード付き,35031,0.7727824226246939
0,314,37,モンスターストライク缶バッジコード付き,35345,0.7797092497407955
0,246,38,モンスターストライク缶バッジコード付き,35591,0.7851359996470406
0,375,39,モンスターストライク缶バッジコード付き,35966,0.7934084842602193
0,369,40,モンスターストライク缶バッジコード付き,36335,0.801548609119587
0,186,41,モンスターストライク缶バッジコード付き,36521,0.8056517614877237
0,165,42,モンスターストライク缶バッジコード付き,36686,0.8092916547175222
0,144,43,モンスターストライク缶バッジコード付き,36830,0.8124682888089828
0,181,44,モンスターストライク缶バッジコード付き,37011,0.816461141382277
0,199,45,モンスターストライク缶バッジコード付き,37210,0.8208510732170038
0,231,46,モンスターストライク缶バッジコード付き,37441,0.8259469237387218
0,279,47,モンスターストライク缶バッジコード付き,37720,0.8321016522909267
0,133,48,モンスターストライク缶バッジコード付き,37853,0.8350356268337341
0,143,49,モンスターストライク缶バッジコード付き,37996,0.8381902009662262
0,95,50,モンスターストライク缶バッジコード付き,38091,0.8402858970682314
0,114,51,モンスターストライク缶バッジコード付き,38205,0.8428007323906378
0,129,52,モンスターストライク缶バッジコード付き,38334,0.8456464670975712
0,220,53,モンスターストライク缶バッジコード付き,38554,0.850499658070636
0,179,54,モンスターストライク缶バッジコード付き,38733,0.8544483907259932
0,101,55,モンスターストライク缶バッジコード付き,38834,0.8566764465818093
0,111,56,モンスターストライク缶バッジコード付き,38945,0.8591251020273102
0,93,57,モンスターストライク缶バッジコード付き,39038,0.8611766782113786
0,82,58,モンスターストライク缶バッジコード付き,39120,0.8629855948467936
0,78,59,モンスターストライク缶バッジコード付き,39198,0.8647062716463347
0,5189,0,一番くじ銀魂～金／銀～,5189,0.005962722927008641
436080,60300,1,一番くじ銀魂～金／銀～,65489,0.07525395293252436
433920,119353,2,一番くじ銀魂～金／銀～,184842,0.21240347490347491
60,88108,3,一番くじ銀魂～金／銀～,272950,0.31364910829196546
0,56641,4,一番くじ銀魂～金／銀～,329591,0.3787357510571796
0,47706,5,一番くじ銀魂～金／銀～,377297,0.4335551112336827
0,43921,6,一番くじ銀魂～金／銀～,421218,0.4840250965250965
0,37281,7,一番くじ銀魂～金／銀～,458499,0.5268650027578599
180,33412,8,一番くじ銀魂～金／銀～,491911,0.565259009009009
0,36682,9,一番くじ銀魂～金／銀～,528593,0.6074105993748851
0,29712,10,一番くじ銀魂～金／銀～,558305,0.6415529049457621
0,23091,11,一番くじ銀魂～金／銀～,581396,0.668086964515536
0,18877,12,一番くじ銀魂～金／銀～,600273,0.6897786817429674
0,17807,13,一番くじ銀魂～金／銀～,618080,0.710240853097996
0,16842,14,一番くじ銀魂～金／銀～,634922,0.7295941349512778
0,14458,15,一番くじ銀魂～金／銀～,649380,0.746207942636514
0,15427,16,一番くじ銀魂～金／銀～,664807,0.7639352362566648
0,12904,17,一番くじ銀魂～金／銀～,677711,0.7787633296561868
0,7997,18,一番くじ銀魂～金／銀～,685708,0.7879527486670344
0,6823,19,一番くじ銀魂～金／銀～,692531,0.7957931145431145
0,6656,20,一番くじ銀魂～金／銀～,699187,0.8034415793344365
0,6206,21,一番くじ銀魂～金／銀～,705393,0.810572945394374
0,6157,22,一番くじ銀魂～金／銀～,711550,0.8176480051480052
0,7048,23,一番くじ銀魂～金／銀～,718598,0.8257469203897775
0,5919,24,一番くじ銀魂～金／銀～,724517,0.8325484923699209
0,4188,25,一番くじ銀魂～金／銀～,728705,0.8373609578966722
0,3983,26,一番くじ銀魂～金／銀～,732688,0.8419378562235705
0,3551,27,一番くじ銀魂～金／銀～,736239,0.8460183397683397
0,4054,28,一番くじ銀魂～金／銀～,740293,0.8506768247839677
0,4335,29,一番くじ銀魂～金／銀～,744628,0.8556582092296378
0,4502,30,一番くじ銀魂～金／銀～,749130,0.8608314947600662
0,3894,31,一番くじ銀魂～金／銀～,753024,0.8653061224489796
0,2811,32,一番くじ銀魂～金／銀～,755835,0.8685362658576944
0,3065,33,一番くじ銀魂～金／銀～,758900,0.8720582827725685
0,3304,34,一番くじ銀魂～金／銀～,762204,0.8758549365692223
0,2386,35,一番くじ銀魂～金／銀～,764590,0.8785967089538518
0,2683,36,一番くじ銀魂～金／銀～,767273,0.8816797665011951
0,3015,37,一番くじ銀魂～金／銀～,770288,0.8851443280014708
0,2804,38,一番くじ銀魂～金／銀～,773092,0.8883664276521419
0,2485,39,一番くじ銀魂～金／銀～,775577,0.8912219617576761
0,2309,40,一番くじ銀魂～金／銀～,777886,0.8938752528038242
0,2146,41,一番くじ銀魂～金／銀～,780032,0.896341239198382
0,2138,42,一番くじ銀魂～金／銀～,782170,0.8987980327266042
0,2338,43,一番くじ銀魂～金／銀～,784508,0.9014846479132194
0,2241,44,一番くじ銀魂～金／銀～,786749,0.9040597995955139
0,2021,45,一番くじ銀魂～金／銀～,788770,0.906382147453576
0,1766,46,一番くじ銀魂～金／銀～,790536,0.908411472697187
0,1399,47,一番くじ銀魂～金／銀～,791935,0.9100190751976466
0,1422,48,一番くじ銀魂～金／銀～,793357,0.9116531071888214
0,1480,49,一番くじ銀魂～金／銀～,794837,0.9133537874609303
0,1422,50,一番くじ銀魂～金／銀～,796259,0.9149878194521052
0,1309,51,一番くじ銀魂～金／銀～,797568,0.9164920022062879
0,1510,52,一番くじ銀魂～金／銀～,799078,0.9182271557271557
0,1095,53,一番くじ銀魂～金／銀～,800173,0.9194854293068578
0,846,54,一番くじ銀魂～金／銀～,801019,0.9204575749218606
0,980,55,一番くじ銀魂～金／銀～,801999,0.9215837010479868
0,888,56,一番くじ銀魂～金／銀～,802887,0.922604109211252
0,933,57,一番くじ銀魂～金／銀～,803820,0.9236762272476559
0,1220,58,一番くじ銀魂～金／銀～,805040,0.9250781393638536
0,1032,59,一番くじ銀魂～金／銀～,806072,0.926264019121162
0,4491,0,一番くじＡ３！観劇準備ＯＫ！,4491,0.02896746562088805
75900,49500,1,一番くじＡ３！観劇準備ＯＫ！,53991,0.34824814881704896
79136,41864,2,一番くじＡ３！観劇準備ＯＫ！,95855,0.6182757553084445
0,12554,3,一番くじＡ３！観劇準備ＯＫ！,108409,0.6992504966588405
0,7139,4,一番くじＡ３！観劇準備ＯＫ！,115548,0.7452978663020202
0,3536,5,一番くじＡ３！観劇準備ＯＫ！,119084,0.7681054722774066
0,2737,6,一番くじＡ３！観劇準備ＯＫ！,121821,0.78575943651797
0,2764,7,一番くじＡ３！観劇準備ＯＫ！,124585,0.8035875538584587
0,1947,8,一番くじＡ３！観劇準備ＯＫ！,126532,0.8161459273975077
0,1784,9,一番くじＡ３！観劇準備ＯＫ！,128316,0.8276529322221936
0,1505,10,一番くじＡ３！観劇準備ＯＫ！,129821,0.8373603550143193
0,1018,11,一番くじＡ３！観劇準備ＯＫ！,130839,0.8439265718929797
0,760,12,一番くじＡ３！観劇準備ＯＫ！,131599,0.8488286591501328
0,679,13,一番くじＡ３！観劇準備ＯＫ！,132278,0.8532082871075105
0,609,14,一番くじＡ３！観劇準備ＯＫ！,132887,0.857136407028045
0,834,15,一番くじＡ３！観劇準備ＯＫ！,133721,0.8625158027812895
0,719,16,一番くじＡ３！観劇準備ＯＫ！,134440,0.8671534353311489
0,635,17,一番くじＡ３！観劇準備ＯＫ！,135075,0.8712492582367967
0,581,18,一番くじＡ３！観劇準備ＯＫ！,135656,0.874996774942594
0,417,19,一番くじＡ３！観劇準備ＯＫ！,136073,0.8776864728192162
0,357,20,一番くじＡ３！観劇準備ＯＫ！,136430,0.8799891638071158
0,435,21,一番くじＡ３！観劇準備ＯＫ！,136865,0.8827949637503547
0,528,22,一番くじＡ３！観劇準備ＯＫ！,137393,0.8862006243711138
0,448,23,一番くじＡ３！観劇準備ＯＫ！,137841,0.8890902758069094
0,245,24,一番くじＡ３！観劇準備ＯＫ！,138086,0.89067055393586
0,329,25,一番くじＡ３！観劇準備ＯＫ！,138415,0.8927926417090224
0,240,26,一番くじＡ３！観劇準備ＯＫ！,138655,0.8943406692639129
0,391,27,一番くじＡ３！観劇準備ＯＫ！,139046,0.8968626641554219
0,291,28,一番くじＡ３！観劇準備ＯＫ！,139337,0.8987396475657267
0,237,29,一番くじＡ３！観劇準備ＯＫ！,139574,0.900268324776181
0,378,30,一番くじＡ３！観劇準備ＯＫ！,139952,0.9027064681751336
0,284,31,一番くじＡ３！観劇準備ＯＫ！,140236,0.9045383007817539
0,389,32,一番くじＡ３！観劇準備ＯＫ！,140625,0.9070473954436389
0,210,33,一番くじＡ３！観劇準備ＯＫ！,140835,0.908401919554168
0,143,34,一番くじＡ３！観劇準備ＯＫ！,140978,0.9093242859722903
0,196,35,一番くじＡ３！観劇準備ＯＫ！,141174,0.9105885084754508
0,290,36,一番くじＡ３！観劇準備ＯＫ！,141464,0.9124590417709435
0,339,37,一番くじＡ３！観劇準備ＯＫ！,141803,0.9146456306922264
0,275,38,一番くじＡ３！観劇準備ＯＫ！,142078,0.9164194122655384
0,154,39,一番くじＡ３！観劇準備ＯＫ！,142232,0.9174127299465931
0,138,40,一番くじＡ３！観劇準備ＯＫ！,142370,0.918302845790655
0,139,41,一番くじＡ３！観劇準備ＯＫ！,142509,0.9191994117495291
0,115,42,一番くじＡ３！観劇準備ＯＫ！,142624,0.9199411749529142
0,115,43,一番くじＡ３！観劇準備ＯＫ！,142739,0.9206829381562992
0,226,44,一番くじＡ３！観劇準備ＯＫ！,142965,0.922140664103821
0,215,45,一番くじＡ３！観劇準備ＯＫ！,143180,0.9235274387884105
0,137,46,一番くじＡ３！観劇準備ＯＫ！,143317,0.9244111045176604
0,91,47,一番くじＡ３！観劇準備ＯＫ！,143408,0.9249980649655564
0,140,48,一番くじＡ３！観劇準備ＯＫ！,143548,0.9259010810392425
0,173,49,一番くじＡ３！観劇準備ＯＫ！,143721,0.9270169509017261
0,109,50,一番くじＡ３！観劇準備ＯＫ！,143830,0.9277200134162388
0,140,51,一番くじＡ３！観劇準備ＯＫ！,143970,0.9286230294899249
0,86,52,一番くじＡ３！観劇準備ＯＫ！,144056,0.9291777393637607
0,116,53,一番くじＡ３！観劇準備ＯＫ！,144172,0.9299259526819578
0,79,54,一番くじＡ３！観劇準備ＯＫ！,144251,0.9304355117521091
0,75,55,一番くじＡ３！観劇準備ＯＫ！,144326,0.9309192703630125
0,57,56,一番くじＡ３！観劇準備ＯＫ！,144383,0.931286926907299
0,72,57,一番くじＡ３！観劇準備ＯＫ！,144455,0.9317513351737661
0,67,58,一番くじＡ３！観劇準備ＯＫ！,144522,0.932183492866173
0,76,59,一番くじＡ３！観劇準備ＯＫ！,144598,0.9326737015918883
0,161,0,一番くじアイドリッシュセブンＶＳトリガー,161,0.006555374592833876
11520,2399,1,一番くじアイドリッシュセブンＶＳトリガー,2560,0.10423452768729642
13040,7855,2,一番くじアイドリッシュセブンＶＳトリガー,10415,0.42406351791530944
0,2059,3,一番くじアイドリッシュセブンＶＳトリガー,12474,0.507899022801303
0,1329,4,一番くじアイドリッシュセブンＶＳトリガー,13803,0.5620114006514658
0,845,5,一番くじアイドリッシュセブンＶＳトリガー,14648,0.5964169381107491
0,695,6,一番くじアイドリッシュセブンＶＳトリガー,15343,0.6247149837133551
0,450,7,一番くじアイドリッシュセブンＶＳトリガー,15793,0.6430374592833876
0,416,8,一番くじアイドリッシュセブンＶＳトリガー,16209,0.6599755700325733
0,474,9,一番くじアイドリッシュセブンＶＳトリガー,16683,0.6792752442996742
0,314,10,一番くじアイドリッシュセブンＶＳトリガー,16997,0.6920602605863192
0,211,11,一番くじアイドリッシュセブンＶＳトリガー,17208,0.7006514657980456
0,249,12,一番くじアイドリッシュセブンＶＳトリガー,17457,0.7107899022801303
0,277,13,一番くじアイドリッシュセブンＶＳトリガー,17734,0.7220684039087948
0,135,14,一番くじアイドリッシュセブンＶＳトリガー,17869,0.7275651465798045
0,218,15,一番くじアイドリッシュセブンＶＳトリガー,18087,0.736441368078176
0,266,16,一番くじアイドリッシュセブンＶＳトリガー,18353,0.7472719869706841
0,222,17,一番くじアイドリッシュセブンＶＳトリガー,18575,0.7563110749185668
0,134,18,一番くじアイドリッシュセブンＶＳトリガー,18709,0.7617671009771987
0,161,19,一番くじアイドリッシュセブンＶＳトリガー,18870,0.7683224755700325
0,139,20,一番くじアイドリッシュセブンＶＳトリガー,19009,0.7739820846905537
0,63,21,一番くじアイドリッシュセブンＶＳトリガー,19072,0.7765472312703583
0,141,22,一番くじアイドリッシュセブンＶＳトリガー,19213,0.7822882736156351
0,220,23,一番くじアイドリッシュセブンＶＳトリガー,19433,0.7912459283387622
0,88,24,一番くじアイドリッシュセブンＶＳトリガー,19521,0.794828990228013
0,147,25,一番くじアイドリッシュセブンＶＳトリガー,19668,0.800814332247557
0,117,26,一番くじアイドリッシュセブンＶＳトリガー,19785,0.8055781758957655
0,91,27,一番くじアイドリッシュセブンＶＳトリガー,19876,0.8092833876221498
0,132,28,一番くじアイドリッシュセブンＶＳトリガー,20008,0.8146579804560261
0,166,29,一番くじアイドリッシュセブンＶＳトリガー,20174,0.8214169381107492
0,115,30,一番くじアイドリッシュセブンＶＳトリガー,20289,0.826099348534202
0,58,31,一番くじアイドリッシュセブンＶＳトリガー,20347,0.8284609120521172
0,120,32,一番くじアイドリッシュセブンＶＳトリガー,20467,0.8333469055374593
0,157,33,一番くじアイドリッシュセブンＶＳトリガー,20624,0.8397394136807818
0,108,34,一番くじアイドリッシュセブンＶＳトリガー,20732,0.8441368078175896
0,71,35,一番くじアイドリッシュセブンＶＳトリガー,20803,0.847027687296417
0,76,36,一番くじアイドリッシュセブンＶＳトリガー,20879,0.8501221498371335
0,83,37,一番くじアイドリッシュセブンＶＳトリガー,20962,0.8535016286644951
0,57,38,一番くじアイドリッシュセブンＶＳトリガー,21019,0.8558224755700325
0,106,39,一番くじアイドリッシュセブンＶＳトリガー,21125,0.8601384364820847
0,52,40,一番くじアイドリッシュセブンＶＳトリガー,21177,0.862255700325733
0,35,41,一番くじアイドリッシュセブンＶＳトリガー,21212,0.8636807817589577
0,115,42,一番くじアイドリッシュセブンＶＳトリガー,21327,0.8683631921824104
0,41,43,一番くじアイドリッシュセブンＶＳトリガー,21368,0.8700325732899022
0,47,44,一番くじアイドリッシュセブンＶＳトリガー,21415,0.8719462540716613
0,50,45,一番くじアイドリッシュセブンＶＳトリガー,21465,0.8739820846905537
0,17,46,一番くじアイドリッシュセブンＶＳトリガー,21482,0.8746742671009772
0,56,47,一番くじアイドリッシュセブンＶＳトリガー,21538,0.8769543973941368
0,77,48,一番くじアイドリッシュセブンＶＳトリガー,21615,0.8800895765472313
0,32,49,一番くじアイドリッシュセブンＶＳトリガー,21647,0.8813925081433225
0,44,50,一番くじアイドリッシュセブンＶＳトリガー,21691,0.8831840390879478
0,34,51,一番くじアイドリッシュセブンＶＳトリガー,21725,0.8845684039087948
0,64,52,一番くじアイドリッシュセブンＶＳトリガー,21789,0.8871742671009772
0,43,53,一番くじアイドリッシュセブンＶＳトリガー,21832,0.8889250814332248
0,38,54,一番くじアイドリッシュセブンＶＳトリガー,21870,0.8904723127035831
0,42,55,一番くじアイドリッシュセブンＶＳトリガー,21912,0.8921824104234528
0,34,56,一番くじアイドリッシュセブンＶＳトリガー,21946,0.8935667752442997
0,55,57,一番くじアイドリッシュセブンＶＳトリガー,22001,0.8958061889250815
0,15,58,一番くじアイドリッシュセブンＶＳトリガー,22016,0.8964169381107492
0,13,59,一番くじアイドリッシュセブンＶＳトリガー,22029,0.8969462540716613
0,9812,0,一番くじキングダムハーツセカンドメモリー,9812,0.012995337995337995
362880,177891,1,一番くじキングダムハーツセカンドメモリー,187703,0.248600074168256
392080,163155,2,一番くじキングダムハーツセカンドメモリー,350858,0.4646879635515999
80,83737,3,一番くじキングダムハーツセカンドメモリー,434595,0.5755920216147489
0,60679,4,一番くじキングダムハーツセカンドメモリー,495274,0.655957300275482
0,43314,5,一番くじキングダムハーツセカンドメモリー,538588,0.7133237974147065
0,24115,6,一番くじキングダムハーツセカンドメモリー,562703,0.7452625026488663
0,19550,7,一番くじキングダムハーツセカンドメモリー,582253,0.7711551705869888
0,17506,8,一番くじキングダムハーツセカンドメモリー,599759,0.7943406971816063
0,12498,9,一番くじキングダムハーツセカンドメモリー,612257,0.8108934625980081
0,13214,10,一番くじキングダムハーツセカンドメモリー,625471,0.8283945221445221
0,12853,11,一番くじキングダムハーツセカンドメモリー,638324,0.8454174613265523
0,9248,12,一番くじキングダムハーツセカンドメモリー,647572,0.8576658190294554
0,6321,13,一番くじキングダムハーツセカンドメモリー,653893,0.8660375609239246
0,5648,14,一番くじキングダムハーツセカンドメモリー,659541,0.8735179593134138
0,4707,15,一番くじキングダムハーツセカンドメモリー,664248,0.8797520661157024
0,4006,16,一番くじキングダムハーツセカンドメモリー,668254,0.885057745285018
0,4395,17,一番くじキングダムハーツセカンドメモリー,672649,0.8908786289468108
0,4772,18,一番くじキングダムハーツセカンドメモリー,677421,0.8971988239033694
0,4297,19,一番くじキングダムハーツセカンドメモリー,681718,0.9028899131171858
0,3155,20,一番くじキングダムハーツセカンドメモリー,684873,0.9070684996821361
0,2522,21,一番くじキングダムハーツセカンドメモリー,687395,0.9104087200678109
0,4598,22,一番くじキングダムハーツセカンドメモリー,691993,0.9164984636575546
0,3369,23,一番くじキングダムハーツセカンドメモリー,695362,0.9209604789150244
0,4472,24,一番くじキングダムハーツセカンドメモリー,699834,0.9268833439287985
0,3823,25,一番くじキングダムハーツセカンドメモリー,703657,0.9319466518330155
0,2841,26,一番くじキングダムハーツセカンドメモリー,706498,0.9357093663911846
0,2104,27,一番くじキングダムハーツセカンドメモリー,708602,0.9384959737232464
0,1690,28,一番くじキングダムハーツセカンドメモリー,710292,0.9407342657342658
0,1509,29,一番くじキングダムハーツセカンドメモリー,711801,0.9427328353464717
0,1808,30,一番くじキングダムハーツセカンドメモリー,713609,0.9451274104683196
0,1821,31,一番くじキングダムハーツセカンドメモリー,715430,0.9475392032210214
0,1734,32,一番くじキングダムハーツセカンドメモリー,717164,0.9498357702903157
0,1365,33,一番くじキングダムハーツセカンドメモリー,718529,0.9516436215299852
0,1100,34,一番くじキングダムハーツセカンドメモリー,719629,0.9531004979868616
0,903,35,一番くじキングダムハーツセカンドメモリー,720532,0.954296461114643
0,793,36,一番くじキングダムハーツセカンドメモリー,721325,0.9553467365967366
0,914,37,一番くじキングダムハーツセカンドメモリー,722239,0.9565572684890866
0,872,38,一番くじキングダムハーツセカンドメモリー,723111,0.9577121741894469
0,1031,39,一番くじキングダムハーツセカンドメモリー,724142,0.959077664759483
0,850,40,一番くじキングダムハーツセカンドメモリー,724992,0.9602034329307056
0,727,41,一番くじキングダムハーツセカンドメモリー,725719,0.9611662958253867
0,530,42,一番くじキングダムハーツセカンドメモリー,726249,0.9618682453909727
0,677,43,一番くじキングダムハーツセカンドメモリー,726926,0.962764886628523
0,702,44,一番くじキングダムハーツセカンドメモリー,727628,0.9636946386946387
0,582,45,一番くじキングダムハーツセカンドメモリー,728210,0.9644654587836407
0,700,46,一番くじキングダムハーツセカンドメモリー,728910,0.9653925619834711
0,565,47,一番くじキングダムハーツセカンドメモリー,729475,0.9661408667090485
0,453,48,一番くじキングダムハーツセカンドメモリー,729928,0.9667408349226531
0,528,49,一番くじキングダムハーツセカンドメモリー,730456,0.9674401356219539
0,411,50,一番くじキングダムハーツセカンドメモリー,730867,0.9679844776435685
0,399,51,一番くじキングダムハーツセカンドメモリー,731266,0.9685129264674719
0,450,52,一番くじキングダムハーツセカンドメモリー,731716,0.9691089213816486
0,471,53,一番くじキングダムハーツセカンドメモリー,732187,0.9697327293918203
0,530,54,一番くじキングダムハーツセカンドメモリー,732717,0.9704346789574062
0,522,55,一番くじキングダムハーツセカンドメモリー,733239,0.9711260330578513
0,563,56,一番くじキングダムハーツセカンドメモリー,733802,0.9718716889171435
0,453,57,一番くじキングダムハーツセカンドメモリー,734255,0.972471657130748
0,380,58,一番くじキングダムハーツセカンドメモリー,734635,0.9729749417249417
0,597,59,一番くじキングダムハーツセカンドメモリー,735232,0.9737656283110828
0,10211,0,一番くじドラゴンボール超戦士バトル列伝Ｚ,10211,0.007478608221561917
669360,125538,1,一番くじドラゴンボール超戦士バトル列伝Ｚ,135749,0.09942352242373995
695601,158719,2,一番くじドラゴンボール超戦士バトル列伝Ｚ,294468,0.21567043441258393
80,137767,3,一番くじドラゴンボール超戦士バトル列伝Ｚ,432235,0.31657195423041967
160,149173,4,一番くじドラゴンボール超戦士バトル列伝Ｚ,581408,0.42582730867514157
0,125952,5,一番くじドラゴンボール超戦士バトル列伝Ｚ,707360,0.5180754393892897
0,68632,6,一番くじドラゴンボール超戦士バトル列伝Ｚ,775992,0.5683419989292209
0,56772,7,一番くじドラゴンボール超戦士バトル列伝Ｚ,832764,0.6099222110489461
80,51448,8,一番くじドラゴンボール超戦士バトル列伝Ｚ,884212,0.6476030881210171
0,41065,9,一番くじドラゴンボール超戦士バトル列伝Ｚ,925277,0.6776793829617223
80,46414,10,一番くじドラゴンボール超戦士バトル列伝Ｚ,971691,0.711673323025925
0,55922,11,一番くじドラゴンボール超戦士バトル列伝Ｚ,1027613,0.7526309891669676
0,45321,12,一番くじドラゴンボール超戦士バトル列伝Ｚ,1072934,0.7858244083432879
0,24687,13,一番くじドラゴンボール超戦士バトル列伝Ｚ,1097621,0.8039053407853307
0,18192,14,一番くじドラゴンボール超戦士バトル列伝Ｚ,1115813,0.8172292895432051
0,24309,15,一番くじドラゴンボール超戦士バトル列伝Ｚ,1140122,0.8350333721264925
0,19933,16,一番くじドラゴンボール超戦士バトル列伝Ｚ,1160055,0.8496324415301155
0,15235,17,一番くじドラゴンボール超戦士バトル列伝Ｚ,1175290,0.8607906626892082
0,20426,18,一番くじドラゴンボール超戦士バトル列伝Ｚ,1195716,0.875750808760467
0,16245,19,一番くじドラゴンボール超戦士バトル列伝Ｚ,1211961,0.8876487610236413
0,8747,20,一番くじドラゴンボール超戦士バトル列伝Ｚ,1220708,0.8940551253478017
0,7902,21,一番くじドラゴンボール超戦士バトル列伝Ｚ,1228610,0.8998426057284483
0,6758,22,一番くじドラゴンボール超戦士バトル列伝Ｚ,1235368,0.9047922124624916
0,6192,23,一番くじドラゴンボール超戦士バトル列伝Ｚ,1241560,0.9093272768154356
0,5929,24,一番くじドラゴンボール超戦士バトル列伝Ｚ,1247489,0.913669718118505
0,9527,25,一番くじドラゴンボール超戦士バトル列伝Ｚ,1257016,0.9206473599289858
0,8342,26,一番くじドラゴンボール超戦士バトル列伝Ｚ,1265358,0.9267570994044798
0,4383,27,一番くじドラゴンボール超戦士バトル列伝Ｚ,1269741,0.9299672394333807
0,4054,28,一番くじドラゴンボール超戦士バトル列伝Ｚ,1273795,0.9329364175481796
0,3816,29,一番くじドラゴンボール超戦士バトル列伝Ｚ,1277611,0.9357312827889473
0,3379,30,一番くじドラゴンボール超戦士バトル列伝Ｚ,1280990,0.938206086155969
0,4087,31,一番くじドラゴンボール超戦士バトル列伝Ｚ,1285077,0.9411994337028815
0,5016,32,一番くじドラゴンボール超戦士バトル列伝Ｚ,1290093,0.9448731873841424
0,5237,33,一番くじドラゴンボール超戦士バトル列伝Ｚ,1295330,0.9487088030198607
0,2366,34,一番くじドラゴンボール超戦士バトル列伝Ｚ,1297696,0.9504416780616994
0,2418,35,一番くじドラゴンボール超戦士バトル列伝Ｚ,1300114,0.9522126382692929
0,1954,36,一番くじドラゴンボール超戦士バトル列伝Ｚ,1302068,0.9536437616132291
0,1999,37,一番くじドラゴンボール超戦士バトル列伝Ｚ,1304067,0.9551078432736837
0,2375,38,一番くじドラゴンボール超戦士バトル列伝Ｚ,1306442,0.9568473099788262
0,3212,39,一番くじドラゴンボール超戦士バトル列伝Ｚ,1309654,0.9591998013712124
0,2849,40,一番くじドラゴンボール超戦士バトル列伝Ｚ,1312503,0.9612864290103497
0,1573,41,一番くじドラゴンボール超戦士バトル列伝Ｚ,1314076,0.9624385052744292
0,1563,42,一番くじドラゴンボール超戦士バトル列伝Ｚ,1315639,0.9635832574681714
0,1280,43,一番くじドラゴンボール超戦士バトル列伝Ｚ,1316919,0.964520738471364
0,1204,44,一番くじドラゴンボール超戦士バトル列伝Ｚ,1318123,0.965402556539992
0,1414,45,一番くじドラゴンボール超戦士バトル列伝Ｚ,1319537,0.9664381800857063
0,1977,46,一番くじドラゴンボール超戦士バトル列伝Ｚ,1321514,0.9678861487914185
0,1733,47,一番くじドラゴンボール超戦士バトル列伝Ｚ,1323247,0.9691554101808972
0,963,48,一番くじドラゴンボール超戦士バトル列伝Ｚ,1324210,0.9698607181543929
0,877,49,一番くじドラゴンボール超戦士バトル列伝Ｚ,1325087,0.9705030391229865
0,777,50,一番くじドラゴンボール超戦士バトル列伝Ｚ,1325864,0.9710721193882057
0,916,51,一番くじドラゴンボール超戦士バトル列伝Ｚ,1326780,0.9717430042311155
0,967,52,一番くじドラゴンボール超戦士バトル列伝Ｚ,1327747,0.9724512418327461
0,1282,53,一番くじドラゴンボール超戦士バトル列伝Ｚ,1329029,0.9733901876500061
0,1102,54,一番くじドラゴンボール超戦士バトル列伝Ｚ,1330131,0.9741973002011922
0,710,55,一番くじドラゴンボール超戦士バトル列伝Ｚ,1330841,0.9747173091951505
0,700,56,一番くじドラゴンボール超戦士バトル列伝Ｚ,1331541,0.9752299941187715
0,609,57,一番くじドラゴンボール超戦士バトル列伝Ｚ,1332150,0.9756760300023217
0,548,58,一番くじドラゴンボール超戦士バトル列伝Ｚ,1332698,0.9760773890568135
0,590,59,一番くじドラゴンボール超戦士バトル列伝Ｚ,1333288,0.9765095092067226
0,20410,0,一番くじワンピースゴール・Ｄ・ロジャー編,20410,0.011930481708543184
858908,178318,1,一番くじワンピースゴール・Ｄ・ロジャー編,198728,0.1161646628601357
851536,386696,2,一番くじワンピースゴール・Ｄ・ロジャー編,585424,0.3422043274738944
240,298949,3,一番くじワンピースゴール・Ｄ・ロジャー編,884373,0.5169522733968379
0,198082,4,一番くじワンピースゴール・Ｄ・ロジャー編,1082455,0.6327393227741848
0,113447,5,一番くじワンピースゴール・Ｄ・ロジャー編,1195902,0.6990537450372469
0,81442,6,一番くじワンピースゴール・Ｄ・ロジャー編,1277344,0.7466599327544039
0,65624,7,一番くじワンピースゴール・Ｄ・ロジャー編,1342968,0.7850198510121912
0,55936,8,一番くじワンピースゴール・Ｄ・ロジャー編,1398904,0.8177167361101368
60,46890,9,一番くじワンピースゴール・Ｄ・ロジャー編,1445794,0.8451258633670496
0,47469,10,一番くじワンピースゴール・Ｄ・ロジャー編,1493263,0.8728734398600843
0,35005,11,一番くじワンピースゴール・Ｄ・ロジャー編,1528268,0.8933352973910766
0,18941,12,一番くじワンピースゴール・Ｄ・ロジャー編,1547209,0.9044070883779222
0,16011,13,一番くじワンピースゴール・Ｄ・ロジャー編,1563220,0.9137661742493325
0,12488,14,一番くじワンピースゴール・Ｄ・ロジャー編,1575708,0.9210659221952554
0,11351,15,一番くじワンピースゴール・Ｄ・ロジャー編,1587059,0.9277010470298303
0,11637,16,一番くじワンピースゴール・Ｄ・ロジャー編,1598696,0.9345033505889835
0,12500,17,一番くじワンピースゴール・Ｄ・ロジャー編,1611196,0.9418101130268468
0,9946,18,一番くじワンピースゴール・Ｄ・ロジャー編,1621142,0.9476239577634059
0,6300,19,一番くじワンピースゴール・Ｄ・ロジャー編,1627442,0.951306566032089
0,5644,20,一番くじワンピースゴール・Ｄ・ロジャー編,1633086,0.954605715408033
0,4650,21,一番くじワンピースゴール・Ｄ・ロジャー編,1637736,0.9573238310349181
0,4687,22,一番くじワンピースゴール・Ｄ・ロジャー編,1642423,0.9600635746786194
0,4372,23,一番くじワンピースゴール・Ｄ・ロジャー編,1646795,0.9626191879088865
0,4218,24,一番くじワンピースゴール・Ｄ・ロジャー編,1651013,0.9650847818259191
0,3634,25,一番くじワンピースゴール・Ｄ・ロジャー編,1654647,0.9672090038018546
0,1794,26,一番くじワンピースゴール・Ｄ・ロジャー編,1656441,0.9682576703469368
0,1639,27,一番くじワンピースゴール・Ｄ・ロジャー編,1658080,0.9692157330377894
0,1549,28,一番くじワンピースゴール・Ｄ・ロジャー編,1659629,0.9701211870390894
0,1563,29,一番くじワンピースゴール・Ｄ・ロジャー編,1661192,0.9710348246143199
0,1580,30,一番くじワンピースゴール・Ｄ・ロジャー編,1662772,0.9719583993864658
0,1937,31,一番くじワンピースゴール・Ｄ・ロジャー編,1664709,0.9730906552938371
0,1686,32,一番くじワンピースゴール・Ｄ・ロジャー編,1666395,0.9740761914114561
0,1329,33,一番くじワンピースゴール・Ｄ・ロジャー編,1667724,0.9748530463938497
0,1253,34,一番くじワンピースゴール・Ｄ・ロジャー編,1668977,0.9755854762606211
0,1187,35,一番くじワンピースゴール・Ｄ・ロジャー編,1670164,0.9762793264217207
0,981,36,一番くじワンピースゴール・Ｄ・ロジャー編,1671145,0.9768527611378441
0,1308,37,一番くじワンピースゴール・Ｄ・ロジャー編,1672453,0.9776173407593421
0,1503,38,一番くじワンピースゴール・Ｄ・ロジャー編,1673956,0.9784959058748708
0,1298,39,一番くじワンピースゴール・Ｄ・ロジャー編,1675254,0.9792546400864185
0,910,40,一番くじワンピースゴール・Ｄ・ロジャー編,1676164,0.979786572391895
0,752,41,一番くじワンピースゴール・Ｄ・ロジャー編,1676916,0.9802261472201569
0,697,42,一番くじワンピースゴール・Ｄ・ロジャー編,1677613,0.9806335722936921
0,659,43,一番くじワンピースゴール・Ｄ・ロジャー編,1678272,0.9810187848094163
0,649,44,一番くじワンピースゴール・Ｄ・ロジャー編,1678921,0.9813981519151901
0,633,45,一番くじワンピースゴール・Ｄ・ロジャー編,1679554,0.9817681663650435
0,516,46,一番くじワンピースゴール・Ｄ・ロジャー編,1680070,0.9820697895184786
0,437,47,一番くじワンピースゴール・Ｄ・ロジャー編,1680507,0.9823252339333062
0,434,48,一番くじワンピースゴール・Ｄ・ロジャー編,1680941,0.9825789247251489
0,314,49,一番くじワンピースゴール・Ｄ・ロジャー編,1681255,0.9827624705975879
0,263,50,一番くじワンピースゴール・Ｄ・ロジャー編,1681518,0.9829162048792806
0,395,51,一番くじワンピースゴール・Ｄ・ロジャー編,1681913,0.9831470985723171
0,309,52,一番くじワンピースゴール・Ｄ・ロジャー編,1682222,0.983327721739781
0,377,53,一番くじワンピースゴール・Ｄ・ロジャー編,1682599,0.983548093694907
0,228,54,一番くじワンピースゴール・Ｄ・ロジャー編,1682827,0.9836813690417736
0,179,55,一番くじワンピースゴール・Ｄ・ロジャー編,1683006,0.9837860018798839
0,163,56,一番くじワンピースゴール・Ｄ・ロジャー編,1683169,0.9838812820620736
0,202,57,一番くじワンピースゴール・Ｄ・ロジャー編,1683371,0.9839993593430695
0,232,58,一番くじワンピースゴール・Ｄ・ロジャー編,1683603,0.9841349728539162
0,194,59,一番くじワンピースゴール・Ｄ・ロジャー編,1683797,0.9842483738069518
60,7094,0,一番くじドラゴンボール超戦士バトル列伝,7094,0.009727922593491041
353940,90664,1,一番くじドラゴンボール超戦士バトル列伝,97758,0.13405444839223246
374761,153150,2,一番くじドラゴンボール超戦士バトル列伝,250908,0.34406732479386104
480,124675,3,一番くじドラゴンボール超戦士バトル列伝,375583,0.5150327532324704
0,97167,4,一番くじドラゴンボール超戦士バトル列伝,472750,0.6482767699567085
0,65914,5,一番くじドラゴンボール超戦士バトル列伝,538664,0.7386638984917194
0,31465,6,一番くじドラゴンボール超戦士バトル列伝,570129,0.7818114999019529
0,24958,7,一番くじドラゴンボール超戦士バトル列伝,595087,0.8160361252315764
0,21218,8,一番くじドラゴンボール超戦士バトル列伝,616305,0.8451321305302363
0,16496,9,一番くじドラゴンボール超戦士バトル列伝,632801,0.8677529102176098
0,14356,10,一番くじドラゴンボール超戦士バトル列伝,647157,0.8874391319193518
0,16786,11,一番くじドラゴンボール超戦士バトル列伝,663943,0.9104575853524418
0,10683,12,一番くじドラゴンボール超戦士バトル列伝,674626,0.9251070633713683
0,5854,13,一番くじドラゴンボール超戦士バトル列伝,680480,0.933134587879727
0,4633,14,一番くじドラゴンボール超戦士バトル列伝,685113,0.9394877687897417
0,4156,15,一番くじドラゴンボール超戦士バトル列伝,689269,0.9451868449524917
0,3270,16,一番くじドラゴンボール超戦士バトル列伝,692539,0.9496709592576391
0,3327,17,一番くじドラゴンボール超戦士バトル列伝,695866,0.9542332370231514
0,3701,18,一番くじドラゴンボール超戦士バトル列伝,699567,0.9593083767917602
0,3060,19,一番くじドラゴンボール超戦士バトル列伝,702627,0.9635045204534578
0,1727,20,一番くじドラゴンボール超戦士バトル列伝,704354,0.9658727361736381
0,1367,21,一番くじドラゴンボール超戦士バトル列伝,705721,0.9677472879336186
0,1158,22,一番くじドラゴンボール超戦士バトル列伝,706879,0.9693352403389277
0,967,23,一番くじドラゴンボール超戦士バトル列伝,707846,0.9706612765875753
0,1158,24,一番くじドラゴンボール超戦士バトル列伝,709004,0.9722492289928844
0,1324,25,一番くじドラゴンボール超戦士バトル列伝,710328,0.9740648153353967
0,1269,26,一番くじドラゴンボール超戦士バトル列伝,711597,0.9758049807951007
0,703,27,一番くじドラゴンボール超戦士バトル列伝,712300,0.9767689968062684
0,487,28,一番くじドラゴンボール超戦士バトル列伝,712787,0.9774368144413164
0,483,29,一番くじドラゴンボール超戦士バトル列伝,713270,0.978099146921251
0,1767,30,一番くじドラゴンボール超戦士バトル列伝,715037,0.9805222141925646
0,473,31,一番くじドラゴンボール超戦士バトル列伝,715510,0.9811708337847159
0,515,32,一番くじドラゴンボール超戦士バトル列伝,716025,0.9818770475055572
0,420,33,一番くじドラゴンボール超戦士バトル列伝,716445,0.9824529887924568
0,318,34,一番くじドラゴンボール超戦士バトル列伝,716763,0.9828890586239666
0,250,35,一番くじドラゴンボール超戦士バトル列伝,717013,0.9832318808185497
0,222,36,一番くじドラゴンボール超戦士バトル列伝,717235,0.9835363069273395
0,261,37,一番くじドラゴンボール超戦士バトル列伝,717496,0.9838942132984844
0,227,38,一番くじドラゴンボール超戦士バトル列伝,717723,0.9842054958511658
0,304,39,一番くじドラゴンボール超戦士バトル列伝,718027,0.9846223676397788
0,261,40,一番くじドラゴンボール超戦士バトル列伝,718288,0.9849802740109237
0,106,41,一番くじドラゴンボール超戦士バトル列伝,718394,0.9851256306214269
0,137,42,一番くじドラゴンボール超戦士バトル列伝,718531,0.9853134971840585
0,124,43,一番くじドラゴンボール超戦士バトル列伝,718655,0.9854835369925717
0,93,44,一番くじドラゴンボール超戦士バトル列伝,718748,0.9856110668489566
0,232,45,一番くじドラゴンボール超戦士バトル列伝,718980,0.9859292058455298
0,200,46,一番くじドラゴンボール超戦士バトル列伝,719180,0.9862034636011963
0,189,47,一番くじドラゴンボール超戦士バトル列伝,719369,0.9864626371803011
0,65,48,一番くじドラゴンボール超戦士バトル列伝,719434,0.9865517709508927
0,88,49,一番くじドラゴンボール超戦士バトル列伝,719522,0.9866724443633861
0,146,50,一番くじドラゴンボール超戦士バトル列伝,719668,0.9868726525250225
0,57,51,一番くじドラゴンボール超戦士バトル列伝,719725,0.9869508159853876
0,55,52,一番くじドラゴンボール超戦士バトル列伝,719780,0.9870262368681958
0,113,53,一番くじドラゴンボール超戦士バトル列伝,719893,0.9871811925001475
0,67,54,一番くじドラゴンボール超戦士バトル列伝,719960,0.9872730688482957
0,72,55,一番くじドラゴンボール超戦士バトル列伝,720032,0.9873718016403357
0,90,56,一番くじドラゴンボール超戦士バトル列伝,720122,0.9874952176303856
0,36,57,一番くじドラゴンボール超戦士バトル列伝,720158,0.9875445840264055
0,94,58,一番くじドラゴンボール超戦士バトル列伝,720252,0.9876734851715688
0,78,59,一番くじドラゴンボール超戦士バトル列伝,720330,0.9877804456962788
0,27522,0,一番くじワンピースパンクハザード編,27522,0.017822647753065475
762973,276060,1,一番くじワンピースパンクハザード編,303582,0.1965930909879777
779922,350862,2,一番くじワンピースパンクハザード編,654444,0.4238036801870206
726,198419,3,一番くじワンピースパンクハザード編,852863,0.5522955028930557
0,112992,4,一番くじワンピースパンクハザード編,965855,0.6254666610543221
66,78330,5,一番くじワンピースパンクハザード編,1044185,0.6761914629763343
0,60640,6,一番くじワンピースパンクハザード編,1104825,0.7154606061979711
66,48275,7,一番くじワンピースパンクハザード編,1153100,0.7467224447372937
132,45471,8,一番くじワンピースパンクハザード編,1198571,0.7761684739495471
66,47549,9,一番くじワンピースパンクハザード編,1246120,0.8069601707016186
0,37568,10,一番くじワンピースパンクハザード編,1283688,0.8312883892463161
0,22626,11,一番くじワンピースパンクハザード編,1306314,0.8459404940374236
0,18043,12,一番くじワンピースパンクハザード編,1324357,0.8576247478492308
0,16608,13,一番くじワンピースパンクハザード編,1340965,0.8683797269162649
132,14536,14,一番くじワンピースパンクハザード編,1355501,0.8777929239127971
0,13653,15,一番くじワンピースパンクハザード編,1369154,0.8866343093416396
0,16180,16,一番くじワンピースパンクハザード編,1385334,0.8971121249307901
0,14022,17,一番くじワンピースパンクハザード編,1399356,0.9061924667225743
0,8915,18,一番くじワンピースパンクハザード編,1408271,0.9119656265481166
0,7731,19,一番くじワンピースパンクハザード編,1416002,0.9169720537619438
0,7114,20,一番くじワンピースパンクハザード編,1423116,0.9215789252144293
0,6475,21,一番くじワンピースパンクハザード編,1429591,0.9257719941847475
0,7079,22,一番くじワンピースパンクハザード編,1436670,0.9303562003995558
0,6876,23,一番くじワンピースパンクハザード編,1443546,0.934808948235835
0,6345,24,一番くじワンピースパンクハザード編,1449891,0.9389178320376372
0,4153,25,一番くじワンピースパンクハザード編,1454044,0.9416072243826151
0,3531,26,一番くじワンピースパンクハザード編,1457575,0.9438938230751547
0,2918,27,一番くじワンピースパンクハザード編,1460493,0.9457834563192301
0,2815,28,一番くじワンピースパンクハザード編,1463308,0.9476063890067121
0,2968,29,一番くじワンピースパンクハザード編,1466276,0.9495284011617553
0,3743,30,一番くじワンピースパンクハザード編,1470019,0.951952286436798
0,3499,31,一番くじワンピースパンクハザード編,1473518,0.9542181626263182
0,2297,32,一番くじワンピースパンクハザード編,1475815,0.9557056497961748
0,2358,33,一番くじワンピースパンクハザード編,1478173,0.9572326392374119
0,2055,34,一番くじワンピースパンクハザード編,1480228,0.9585634124781847
0,2040,35,一番くじワンピースパンクハザード編,1482268,0.9598844720456672
0,2126,36,一番くじワンピースパンクハザード編,1484394,0.9612612233400142
0,2530,37,一番くじワンピースパンクハザード編,1486924,0.9628995962349802
0,2218,38,一番くじワンピースパンクハザード編,1489142,0.9643359247255078
0,1405,39,一番くじワンピースパンクハザード編,1490547,0.9652457721237004
0,1314,40,一番くじワンピースパンクハザード編,1491861,0.9660966899039317
0,1201,41,一番くじワンピースパンクハザード編,1493062,0.9668744313453761
0,1053,42,一番くじワンピースパンクハザード編,1494115,0.9675563312103561
0,1091,43,一番くじワンピースパンクハザード編,1495206,0.9682628390476715
0,1158,44,一番くじワンピースパンクハザード編,1496364,0.9690127346256836
0,998,45,一番くじワンピースパンクハザード編,1497362,0.9696590176885991
0,547,46,一番くじワンピースパンクハザード編,1497909,0.9700132429745858
0,493,47,一番くじワンピースパンクハザード編,1498402,0.9703324990367274
0,662,48,一番くじワンピースパンクハザード編,1499064,0.9707611958179398
0,494,49,一番くじワンピースパンクハザード編,1499558,0.9710810994583008
0,606,50,一番くじワンピースパンクハザード編,1500164,0.9714735318592295
0,573,51,一番くじワンピースパンクハザード編,1500737,0.9718445941789194
0,607,52,一番くじワンピースパンクハザード編,1501344,0.9722376741580674
0,527,53,一番くじワンピースパンクハザード編,1501871,0.972578947879667
0,308,54,一番くじワンピースパンクハザード編,1502179,0.9727784019712281
0,359,55,一番くじワンピースパンクハザード編,1502538,0.9730108825519762
0,462,56,一番くじワンピースパンクハザード編,1503000,0.9733100636893178
0,453,57,一番くじワンピースパンクハザード編,1503453,0.9736034166226853
0,414,58,一番くじワンピースパンクハザード編,1503867,0.973871514005498
0,454,59,一番くじワンピースパンクハザード編,1504321,0.9741655145170848
0,20599,0,一番くじシン・エヴァンゲリオン１３号機起動,20599,0.01709856472992502
598720,354703,1,一番くじシン・エヴァンゲリオン１３号機起動,375302,0.3115260711816263
605921,380324,2,一番くじシン・エヴァンゲリオン１３号機起動,755626,0.6272207423959573
0,182760,3,一番くじシン・エヴァンゲリオン１３号機起動,938386,0.7789239168238953
80,115619,4,一番くじシン・エヴァンゲリオン１３号機起動,1054005,0.8748955152271771
0,57161,5,一番くじシン・エヴァンゲリオン１３号機起動,1111166,0.9223430155197759
0,22047,6,一番くじシン・エヴァンゲリオン１３号機起動,1133213,0.940643518291787
0,13622,7,一番くじシン・エヴァンゲリオン１３号機起動,1146835,0.9519507006186495
0,9363,8,一番くじシン・エヴァンゲリオン１３号機起動,1156198,0.9597226245744865
0,6855,9,一番くじシン・エヴァンゲリオン１３号機起動,1163053,0.9654127387170972
0,7228,10,一番くじシン・エヴァンゲリオン１３号機起動,1170281,0.9714124681150241
0,5614,11,一番くじシン・エヴァンゲリオン１３号機起動,1175895,0.9760724682312336
0,4333,12,一番くじシン・エヴァンゲリオン１３号機起動,1180228,0.9796691516126971
0,2320,13,一番くじシン・エヴァンゲリオン１３号機起動,1182548,0.9815949086967024
0,1798,14,一番くじシン・エヴァンゲリオン１３号機起動,1184346,0.9830873704368065
0,1811,15,一番くじシン・エヴァンゲリオン１３号機起動,1186157,0.9845906230571227
0,1449,16,一番くじシン・エヴァンゲリオン１３号機起動,1187606,0.9857933911669174
0,1444,17,一番くじシン・エヴァンゲリオン１３号機起動,1189050,0.9869920089381691
0,1251,18,一番くじシン・エヴァンゲリオン１３号機起動,1190301,0.9880304236416565
0,779,19,一番くじシン・エヴァンゲリオン１３号機起動,1191080,0.9886770463866738
0,712,20,一番くじシン・エヴァンゲリオン１３号機起動,1191792,0.9892680545952134
0,363,21,一番くじシン・エヴァンゲリオン１３号機起動,1192155,0.9895693691734435
0,436,22,一番くじシン・エヴァンゲリオン１３号機起動,1192591,0.9899312786944031
0,417,23,一番くじシン・エヴァンゲリオン１３号機起動,1193008,0.9902774169288989
0,529,24,一番くじシン・エヴァンゲリオン１３号機起動,1193537,0.9907165227467605
0,446,25,一番くじシン・エヴァンゲリオン１３号機起動,1193983,0.9910867329448063
0,383,26,一番くじシン・エヴァンゲリオン１３号機起動,1194366,0.9914046488772089
0,246,27,一番くじシン・エヴァンゲリオン１３号機起動,1194612,0.9916088455335301
0,262,28,一番くじシン・エヴァンゲリオン１３号機起動,1194874,0.9918263232731894
0,295,29,一番くじシン・エヴァンゲリオン１３号機起動,1195169,0.9920711932472331
0,263,30,一番くじシン・エヴァンゲリオン１３号機起動,1195432,0.992289501054601
0,304,31,一番くじシン・エヴァンゲリオン１３号機起動,1195736,0.9925418416380224
0,290,32,一番くじシン・エヴァンゲリオン１３号機起動,1196026,0.992782561273523
0,267,33,一番くじシン・エヴァンゲリオン１３号機起動,1196293,0.9930041893517254
0,262,34,一番くじシン・エヴァンゲリオン１３号機起動,1196555,0.9932216670913846
0,123,35,一番くじシン・エヴァンゲリオン１３号機起動,1196678,0.9933237654195453
0,204,36,一番くじシン・エヴァンゲリオン１３号機起動,1196882,0.9934930992321044
0,109,37,一番くじシン・エヴァンゲリオン１３号機起動,1196991,0.9935835766123443
0,135,38,一番くじシン・エヴァンゲリオン１３号機起動,1197126,0.9936956357530083
0,88,39,一番くじシン・エヴァンゲリオン１３号機起動,1197214,0.9937686817113672
0,70,40,一番くじシン・エヴァンゲリオン１３号機起動,1197284,0.9938267864509708
0,63,41,一番くじシン・エヴァンゲリオン１３号機起動,1197347,0.993879080716614
0,55,42,一番くじシン・エヴァンゲリオン１３号機起動,1197402,0.9939247344405883
0,46,43,一番くじシン・エヴァンゲリオン１３号機起動,1197448,0.993962917555185
0,61,44,一番くじシン・エヴァンゲリオン１３号機起動,1197509,0.994013551685411
0,149,45,一番くじシン・エヴァンゲリオン１３号機起動,1197658,0.9941372317739958
0,138,46,一番くじシン・エヴァンゲリオン１３号機起動,1197796,0.9942517811177858
0,45,47,一番くじシン・エヴァンゲリオン１３号機起動,1197841,0.9942891341646738
0,24,48,一番くじシン・エヴァンゲリオン１３号機起動,1197865,0.9943090557896808
0,29,49,一番くじシン・エヴァンゲリオン１３号機起動,1197894,0.9943331277532308
0,34,50,一番くじシン・エヴァンゲリオン１３号機起動,1197928,0.994361350055324
0,107,51,一番くじシン・エヴァンゲリオン１３号機起動,1198035,0.9944501673001467
0,50,52,一番くじシン・エヴァンゲリオン１３号機起動,1198085,0.9944916706855779
0,45,53,一番くじシン・エヴァンゲリオン１３号機起動,1198130,0.9945290237324659
0,55,54,一番くじシン・エヴァンゲリオン１３号機起動,1198185,0.9945746774564401
0,47,55,一番くじシン・エヴァンゲリオン１３号機起動,1198232,0.9946136906387454
0,97,56,一番くじシン・エヴァンゲリオン１３号機起動,1198329,0.9946942072064818
0,144,57,一番くじシン・エヴァンゲリオン１３号機起動,1198473,0.9948137369565235
0,38,58,一番くじシン・エヴァンゲリオン１３号機起動,1198511,0.9948452795294512
0,50,59,一番くじシン・エヴァンゲリオン１３号機起動,1198561,0.9948867829148824
0,2101,0,一番くじ仮面ライダーＷ決戦編,2101,0.0017276539758243567
602600,32091,1,一番くじ仮面ライダーＷ決戦編,34192,0.028116108872625608
613500,80435,2,一番くじ仮面ライダーＷ決戦編,114627,0.09425787353013733
0,78533,3,一番くじ仮面ライダーＷ決戦編,193160,0.1588356220705534
0,62811,4,一番くじ仮面ライダーＷ決戦編,255971,0.21048515747060276
0,63995,5,一番くじ仮面ライダーＷ決戦編,319966,0.2631082970150481
0,62469,6,一番くじ仮面ライダーＷ決戦編,382435,0.3144766055423074
0,60623,7,一番くじ仮面ライダーＷ決戦編,443058,0.3643269467971384
0,68034,8,一番くじ仮面ライダーＷ決戦編,511092,0.42027135926321846
0,61054,9,一番くじ仮面ライダーＷ決戦編,572146,0.4704761121618288
0,55537,10,一番くじ仮面ライダーＷ決戦編,627683,0.5161442315599046
0,43483,11,一番くじ仮面ライダーＷ決戦編,671166,0.551900337143327
0,32962,12,一番くじ仮面ライダーＷ決戦編,704128,0.5790050160348655
0,29121,13,一番くじ仮面ライダーＷ決戦編,733249,0.6029512375627004
0,26477,14,一番くじ仮面ライダーＷ決戦編,759726,0.6247232957815969
0,26051,15,一番くじ仮面ライダーＷ決戦編,785777,0.6461450538607022
0,29644,16,一番くじ仮面ライダーＷ決戦編,815421,0.6705213387056985
0,27364,17,一番くじ仮面ライダーＷ決戦編,842785,0.6930227777320944
0,17967,18,一番くじ仮面ライダーＷ決戦編,860752,0.7077970561631445
0,16748,19,一番くじ仮面ライダーＷ決戦編,877500,0.7215689499218815
0,17466,20,一番くじ仮面ライダーＷ決戦編,894966,0.735931255653318
0,16179,21,一番くじ仮面ライダーＷ決戦編,911145,0.7492352602582024
0,15473,22,一番くじ仮面ライダーＷ決戦編,926618,0.7619587204999588
0,17930,23,一番くじ仮面ライダーＷ決戦編,944548,0.7767025738014965
0,15763,24,一番くじ仮面ライダーＷ決戦編,960311,0.7896645012745662
0,10455,25,一番くじ仮面ライダーＷ決戦編,970766,0.7982616561138064
0,10606,26,一番くじ仮面ライダーＷ決戦編,981372,0.806982978373489
0,8764,27,一番くじ仮面ライダーＷ決戦編,990136,0.8141896225639339
0,7773,28,一番くじ仮面ライダーＷ決戦編,997909,0.8205813666639257
0,7932,29,一番くじ仮面ライダーＷ決戦編,1005841,0.8271038565907409
0,10223,30,一番くじ仮面ライダーＷ決戦編,1016064,0.8355102376449305
0,8941,31,一番くじ仮面ライダーＷ決戦編,1025005,0.8428624290765562
0,5121,32,一番くじ仮面ライダーＷ決戦編,1030126,0.8470734314612285
0,4705,33,一番くじ仮面ライダーＷ決戦編,1034831,0.850942356714086
0,4566,34,一番くじ仮面ライダーＷ決戦編,1039397,0.8546969821560727
0,4715,35,一番くじ仮面ライダーＷ決戦編,1044112,0.8585741304169066
0,5273,36,一番くじ仮面ライダーＷ決戦編,1049385,0.8629101225228188
0,6868,37,一番くじ仮面ライダーＷ決戦編,1056253,0.8685576844009538
0,5673,38,一番くじ仮面ライダーＷ決戦編,1061926,0.873222596825919
0,3487,39,一番くじ仮面ライダーＷ決戦編,1065413,0.8760899597072609
0,3097,40,一番くじ仮面ライダーＷ決戦編,1068510,0.8786366252775265
0,3076,41,一番くじ仮面ライダーＷ決戦編,1071586,0.8811660225310418
0,2886,42,一番くじ仮面ライダーＷ決戦編,1074472,0.8835391826330071
0,3230,43,一番くじ仮面ライダーＷ決戦編,1077702,0.8861952142093578
0,4254,44,一番くじ仮面ライダーＷ決戦編,1081956,0.8896932818024833
0,3981,45,一番くじ仮面ライダーＷ決戦編,1085937,0.8929668612778554
0,3123,46,一番くじ仮面ライダーＷ決戦編,1089060,0.8955349066688595
0,1913,47,一番くじ仮面ライダーＷ決戦編,1090973,0.897107968094729
0,2007,48,一番くじ仮面ライダーＷ決戦編,1092980,0.898758325795576
0,2225,49,一番くじ仮面ライダーＷ決戦編,1095205,0.9005879450703067
0,2112,50,一番くじ仮面ライダーＷ決戦編,1097317,0.902324644354905
0,2898,51,一番くじ仮面ライダーＷ決戦編,1100215,0.9047076720664419
0,2546,52,一番くじ仮面ライダーＷ決戦編,1102761,0.9068012498972124
0,1669,53,一番くじ仮面ライダーＷ決戦編,1104430,0.9081736699284598
0,1623,54,一番くじ仮面ライダーＷ決戦編,1106053,0.9095082641230162
0,1642,55,一番くじ仮面ライダーＷ決戦編,1107695,0.9108584820327276
0,1580,56,一番くじ仮面ライダーＷ決戦編,1109275,0.9121577172929858
0,1667,57,一番くじ仮面ライダーＷ決戦編,1110942,0.9135284927226379
0,2254,58,一番くじ仮面ライダーＷ決戦編,1113196,0.9153819587205
0,1671,59,一番くじ仮面ライダーＷ決戦編,1114867,0.9167560233533426
0,1306,0,一番くじカードキャプターさくらプレゼント,1306,0.005538169266128964
109758,22101,1,一番くじカードキャプターさくらプレゼント,23407,0.09925875039225165
126060,25183,2,一番くじカードキャプターさくらプレゼント,48590,0.2060487324970952
0,19402,3,一番くじカードキャプターさくらプレゼント,67992,0.2883240465104445
0,17557,4,一番くじカードキャプターさくらプレゼント,85549,0.3627755302818275
0,12690,5,一番くじカードキャプターさくらプレゼント,98239,0.41658821633632714
0,8335,6,一番くじカードキャプターさくらプレゼント,106574,0.45193327057306903
0,6459,7,一番くじカードキャプターさくらプレゼント,113033,0.47932303725754605
0,6251,8,一番くじカードキャプターさくらプレゼント,119284,0.5058307677955033
0,5790,9,一番くじカードキャプターさくらプレゼント,125074,0.5303836009125682
0,6445,10,一番くじカードキャプターさくらプレゼント,131519,0.557713999779491
0,6407,11,一番くじカードキャプターさくらプレゼント,137926,0.584883257427338
0,5246,12,一番くじカードキャプターさくらプレゼント,143172,0.607129226776582
0,3341,13,一番くじカードキャプターさくらプレゼント,146513,0.6212969323800558
0,2798,14,一番くじカードキャプターさくらプレゼント,149311,0.6331620147741055
0,2802,15,一番くじカードキャプターさくらプレゼント,152113,0.645044059401742
0,2626,16,一番くじカードキャプターさくらプレゼント,154739,0.6561797657515541
0,2337,17,一番くじカードキャプターさくらプレゼント,157076,0.6660899507247114
0,2821,18,一番くじカードキャプターさくらプレゼント,159897,0.6780525659618859
0,2386,19,一番くじカードキャプターさくらプレゼント,162283,0.6881705382964829
0,6832,20,一番くじカードキャプターさくらプレゼント,169115,0.71714203326294
0,2343,21,一番くじカードキャプターさくらプレゼント,171458,0.7270776615864777
0,1453,22,一番くじカードキャプターさくらプレゼント,172911,0.733239192936926
0,1695,23,一番くじカードキャプターさくらプレゼント,174606,0.7404269394193828
0,1792,24,一番くじカードキャプターさくらプレゼント,176398,0.7480260200663224
0,1879,25,一番くじカードキャプターさくらプレゼント,178277,0.7559940292937775
0,1807,26,一番くじカードキャプターさくらプレゼント,180084,0.7636567183166679
0,1404,27,一番くじカードキャプターさくらプレゼント,181488,0.7696104623056764
0,1309,28,一番くじカードキャプターさくらプレゼント,182797,0.7751613532469955
0,1182,29,一番くじカードキャプターさくらプレゼント,183979,0.7801736932719301
0,1136,30,一番くじカードキャプターさくらプレゼント,185115,0.7849909676106149
0,1354,31,一番くじカードキャプターさくらプレゼント,186469,0.790732683679787
0,1326,32,一番くじカードキャプターさくらプレゼント,187795,0.7963556641138505
0,1432,33,一番くじカードキャプターさくらプレゼント,189227,0.8024281437379674
0,2659,34,一番くじカードキャプターさくらプレゼント,191886,0.8137037885148717
0,1088,35,一番くじカードキャプターさくらプレゼント,192974,0.8183175160505135
0,864,36,一番くじカードキャプターさくらプレゼント,193838,0.821981358505288
0,830,37,一番くじカードキャプターさくらプレゼント,194668,0.8255010219745736
0,3664,38,一番くじカードキャプターさくらプレゼント,198332,0.8410384279401911
0,939,39,一番くじカードキャプターさくらプレゼント,199271,0.8450203122747203
0,914,40,一番くじカードキャプターさくらプレゼント,200185,0.8488961826493313
0,768,41,一番くじカードキャプターさくらプレゼント,200953,0.8521529314980196
0,760,42,一番くじカードキャプターさくらプレゼント,201713,0.8553757558795342
0,635,43,一番くじカードキャプターさくらプレゼント,202348,0.8580685104614576
0,570,44,一番くじカードキャプターさくらプレゼント,202918,0.8604856287475935
0,703,45,一番くじカードキャプターさくらプレゼント,203621,0.8634667413004945
0,620,46,一番くじカードキャプターさくらプレゼント,204241,0.8660958875064668
0,798,47,一番くじカードキャプターさくらプレゼント,205039,0.8694798531070571
0,450,48,一番くじカードキャプターさくらプレゼント,205489,0.8713881043855854
0,514,49,一番くじカードキャプターさくらプレゼント,206003,0.8735677514015046
0,485,50,一番くじカードキャプターさくらプレゼント,206488,0.8756244222239185
0,522,51,一番くじカードキャプターさくらプレゼント,207010,0.8778379937070113
0,594,52,一番くじカードキャプターさくらプレゼント,207604,0.8803568853946687
0,568,53,一番くじカードキャプターさくらプレゼント,208172,0.8827655225640112
0,491,54,一番くじカードキャプターさくらプレゼント,208663,0.8848476367368056
0,413,55,一番くじカードキャプターさくらプレゼント,209076,0.8865989873546548
0,431,56,一番くじカードキャプターさくらプレゼント,209507,0.8884266680236453
0,452,57,一番くじカードキャプターさくらプレゼント,209959,0.8903434004189672
0,392,58,一番くじカードキャプターさくらプレゼント,210351,0.8920056993104852
0,449,59,一番くじカードキャプターさくらプレゼント,210800,0.8939097100306168
0,1940,0,一番くじ機動戦士ガンダム３０ｔｈ,1940,0.0015754425856748416
616600,29657,1,一番くじ機動戦士ガンダム３０ｔｈ,31597,0.025659412051323698
614600,103100,2,一番くじ機動戦士ガンダム３０ｔｈ,134697,0.10938525255806399
200,116679,3,一番くじ機動戦士ガンダム３０ｔｈ,251376,0.20413837908072113
0,101705,4,一番くじ機動戦士ガンダム３０ｔｈ,353081,0.28673136267662824
0,71908,5,一番くじ機動戦士ガンダム３０ｔｈ,424989,0.34512668507389965
0,66115,6,一番くじ機動戦士ガンダム３０ｔｈ,491104,0.39881760597693683
0,60482,7,一番くじ機動戦士ガンダム３０ｔｈ,551586,0.44793405879486764
0,58545,8,一番くじ機動戦士ガンダム３０ｔｈ,610131,0.4954775052785447
0,55737,9,一番くじ機動戦士ガンダム３０ｔｈ,665868,0.5407406204320286
0,62656,10,一番くじ機動戦士ガンダム３０ｔｈ,728524,0.5916225434464837
0,52048,11,一番くじ機動戦士ガンダム３０ｔｈ,780572,0.6338898814357642
0,33116,12,一番くじ機動戦士ガンダム３０ｔｈ,813688,0.6607828487899952
0,26926,13,一番くじ機動戦士ガンダム３０ｔｈ,840614,0.6826490173785935
0,26200,14,一番くじ機動戦士ガンダム３０ｔｈ,866814,0.7039256131232743
0,22747,15,一番くじ機動戦士ガンダム３０ｔｈ,889561,0.7223980834822153
0,22113,16,一番くじ機動戦士ガンダム３０ｔｈ,911674,0.7403556927074875
0,24994,17,一番くじ機動戦士ガンダム３０ｔｈ,936668,0.7606529153808673
0,21665,18,一番くじ機動戦士ガンダム３０ｔｈ,958333,0.7782467110605814
0,17003,19,一番くじ機動戦士ガンダム３０ｔｈ,975336,0.7920545720318337
0,11527,20,一番くじ機動戦士ガンダム３０ｔｈ,986863,0.8014154620756863
0,13308,21,一番くじ機動戦士ガンダム３０ｔｈ,1000171,0.8122226733798928
0,12645,22,一番くじ機動戦士ガンダム３０ｔｈ,1012816,0.822491473120026
0,12750,23,一番くじ機動戦士ガンダム３０ｔｈ,1025566,0.8328455416598993
0,14725,24,一番くじ機動戦士ガンダム３０ｔｈ,1040291,0.8448034757186942
0,12753,25,一番くじ機動戦士ガンダム３０ｔｈ,1053044,0.8551599805099886
0,8415,26,一番くじ機動戦士ガンダム３０ｔｈ,1061459,0.861993665746305
0,7580,27,一番くじ機動戦士ガンダム３０ｔｈ,1069039,0.8681492610037356
0,7219,28,一番くじ機動戦士ガンダム３０ｔｈ,1076258,0.8740116940068215
0,5495,29,一番くじ機動戦士ガンダム３０ｔｈ,1081753,0.8784740945265551
0,5569,30,一番くじ機動戦士ガンダム３０ｔｈ,1087322,0.8829965892480104
0,5999,31,一番くじ機動戦士ガンダム３０ｔｈ,1093321,0.8878682800064966
0,5255,32,一番くじ機動戦士ガンダム３０ｔｈ,1098576,0.8921357804125386
0,3472,33,一番くじ機動戦士ガンダム３０ｔｈ,1102048,0.8949553353906123
0,3297,34,一番くじ機動戦士ガンダム３０ｔｈ,1105345,0.8976327757024525
0,3159,35,一番くじ機動戦士ガンダム３０ｔｈ,1108504,0.9001981484489199
0,3003,36,一番くじ機動戦士ガンダム３０ｔｈ,1111507,0.9026368361214877
0,2901,37,一番くじ機動戦士ガンダム３０ｔｈ,1114408,0.9049926912457366
0,3365,38,一番くじ機動戦士ガンダム３０ｔｈ,1117773,0.9077253532564561
0,2963,39,一番くじ機動戦士ガンダム３０ｔｈ,1120736,0.9101315575767419
0,1849,40,一番くじ機動戦士ガンダム３０ｔｈ,1122585,0.9116331005359753
0,1931,41,一番くじ機動戦士ガンダム３０ｔｈ,1124516,0.9132012343673868
0,1877,42,一番くじ機動戦士ガンダム３０ｔｈ,1126393,0.9147255156732175
0,1636,43,一番くじ機動戦士ガンダム３０ｔｈ,1128029,0.9160540847815495
0,1771,44,一番くじ機動戦士ガンダム３０ｔｈ,1129800,0.9174922852038331
0,2105,45,一番くじ機動戦士ガンダム３０ｔｈ,1131905,0.919201721617671
0,1875,46,一番くじ機動戦士ガンダム３０ｔｈ,1133780,0.9207243787558876
0,1379,47,一番くじ機動戦士ガンダム３０ｔｈ,1135159,0.921844242325808
0,1314,48,一番くじ機動戦士ガンダム３０ｔｈ,1136473,0.9229113204482703
0,1645,49,一番くじ機動戦士ガンダム３０ｔｈ,1138118,0.9242471983108657
0,1337,50,一番くじ機動戦士ガンダム３０ｔｈ,1139455,0.92533295436089
0,1616,51,一番くじ機動戦士ガンダム３０ｔｈ,1141071,0.926645281793081
0,1867,52,一番くじ機動戦士ガンダム３０ｔｈ,1142938,0.9281614422608413
0,1580,53,一番くじ機動戦士ガンダム３０ｔｈ,1144518,0.9294445346759785
0,1409,54,一番くじ機動戦士ガンダム３０ｔｈ,1145927,0.9305887607601104
0,1278,55,一番くじ機動戦士ガンダム３０ｔｈ,1147205,0.9316266038655189
0,1259,56,一番くじ機動戦士ガンダム３０ｔｈ,1148464,0.9326490173785935
0,1360,57,一番くじ機動戦士ガンダム３０ｔｈ,1149824,0.9337534513561799
0,1486,58,一番くじ機動戦士ガンダム３０ｔｈ,1151310,0.9349602078934546
0,1349,59,一番くじ機動戦士ガンダム３０ｔｈ,1152659,0.9360557089491636
0,2346,0,一番くじ夏目友人帳ニャンコ先生かふぇ,2346,0.00754680563597761
150900,45366,1,一番くじ夏目友人帳ニャンコ先生かふぇ,47712,0.15348388342018915
159840,69533,2,一番くじ夏目友人帳ニャンコ先生かふぇ,117245,0.37716335327800293
120,44665,3,一番くじ夏目友人帳ニャンコ先生かふぇ,161910,0.520845396641575
0,28141,4,一番くじ夏目友人帳ニャンコ先生かふぇ,190051,0.6113716785691308
0,21469,5,一番くじ夏目友人帳ニャンコ先生かふぇ,211520,0.6804349224731391
0,15874,6,一番くじ夏目友人帳ニャンコ先生かふぇ,227394,0.7314997104806022
0,13064,7,一番くじ夏目友人帳ニャンコ先生かふぇ,240458,0.7735250595123206
0,12677,8,一番くじ夏目友人帳ニャンコ先生かふぇ,253135,0.8143054751335006
0,10430,9,一番くじ夏目友人帳ニャンコ先生かふぇ,263565,0.8478575564562826
0,7981,10,一番くじ夏目友人帳ニャンコ先生かふぇ,271546,0.8735314932767162
0,5239,11,一番くじ夏目友人帳ニャンコ先生かふぇ,276785,0.8903847391108538
0,3581,12,一番くじ夏目友人帳ニャンコ先生かふぇ,280366,0.9019043942610822
0,2998,13,一番くじ夏目友人帳ニャンコ先生かふぇ,283364,0.9115486070900084
0,2993,14,一番くじ夏目友人帳ニャンコ先生かふぇ,286357,0.9211767355079457
0,3070,15,一番くじ夏目友人帳ニャンコ先生かふぇ,289427,0.9310525638551116
0,2706,16,一番くじ夏目友人帳ニャンコ先生かふぇ,292133,0.9397574470822878
0,2024,17,一番くじ夏目友人帳ニャンコ先生かふぇ,294157,0.9462684166505823
0,1289,18,一番くじ夏目友人帳ニャンコ先生かふぇ,295446,0.9504149778035128
0,1071,19,一番くじ夏目友人帳ニャンコ先生かふぇ,296517,0.9538602586373287
0,714,20,一番くじ夏目友人帳ニャンコ先生かふぇ,297231,0.9561571125265392
0,845,21,一番くじ夏目友人帳ニャンコ先生かふぇ,298076,0.9588753779836582
0,923,22,一番くじ夏目友人帳ニャンコ先生かふぇ,298999,0.9618445602522036
0,914,23,一番くじ夏目友人帳ニャンコ先生かふぇ,299913,0.9647847905809689
0,741,24,一番くじ夏目友人帳ニャンコ先生かふぇ,300654,0.9671685002895194
0,867,25,一番くじ夏目友人帳ニャンコ先生かふぇ,301521,0.9699575371549893
0,372,26,一番くじ夏目友人帳ニャンコ先生かふぇ,301893,0.9711542173325612
0,300,27,一番くじ夏目友人帳ニャンコ先生かふぇ,302193,0.9721192819918935
0,390,28,一番くじ夏目友人帳ニャンコ先生かふぇ,302583,0.9733738660490253
0,360,29,一番くじ夏目友人帳ニャンコ先生かふぇ,302943,0.9745319436402239
0,447,30,一番くじ夏目友人帳ニャンコ先生かふぇ,303390,0.9759698899826288
0,263,31,一番くじ夏目友人帳ニャンコ先生かふぇ,303653,0.9768159300006434
0,235,32,一番くじ夏目友人帳ニャンコ先生かふぇ,303888,0.9775718973171202
0,125,33,一番くじ夏目友人帳ニャンコ先生かふぇ,304013,0.9779740075918419
0,210,34,一番くじ夏目友人帳ニャンコ先生かふぇ,304223,0.9786495528533745
0,137,35,一番くじ夏目友人帳ニャンコ先生かふぇ,304360,0.9790902657144696
0,194,36,一番くじ夏目友人帳ニャンコ先生かふぇ,304554,0.9797143408608376
0,168,37,一番くじ夏目友人帳ニャンコ先生かふぇ,304722,0.9802547770700637
0,157,38,一番くじ夏目友人帳ニャンコ先生かふぇ,304879,0.9807598275751142
0,69,39,一番くじ夏目友人帳ニャンコ先生かふぇ,304948,0.9809817924467606
0,100,40,一番くじ夏目友人帳ニャンコ先生かふぇ,305048,0.9813034806665379
0,49,41,一番くじ夏目友人帳ニャンコ先生かふぇ,305097,0.9814611078942289
0,75,42,一番くじ夏目友人帳ニャンコ先生かふぇ,305172,0.9817023740590619
0,76,43,一番くじ夏目友人帳ニャンコ先生かふぇ,305248,0.9819468571060928
0,79,44,一番くじ夏目友人帳ニャンコ先生かふぇ,305327,0.9822009907997169
0,82,45,一番くじ夏目友人帳ニャンコ先生かふぇ,305409,0.9824647751399344
0,76,46,一番くじ夏目友人帳ニャンコ先生かふぇ,305485,0.9827092581869652
0,70,47,一番くじ夏目友人帳ニャンコ先生かふぇ,305555,0.9829344399408093
0,68,48,一番くじ夏目友人帳ニャンコ先生かふぇ,305623,0.983153187930258
0,89,49,一番くじ夏目友人帳ニャンコ先生かふぇ,305712,0.9834394904458599
0,44,50,一番くじ夏目友人帳ニャンコ先生かふぇ,305756,0.983581033262562
0,88,51,一番くじ夏目友人帳ニャンコ先生かふぇ,305844,0.983864118895966
0,59,52,一番くじ夏目友人帳ニャンコ先生かふぇ,305903,0.9840539149456347
0,16,53,一番くじ夏目友人帳ニャンコ先生かふぇ,305919,0.984105385060799
0,46,54,一番くじ夏目友人帳ニャンコ先生かふぇ,305965,0.9842533616418967
0,54,55,一番くじ夏目友人帳ニャンコ先生かふぇ,306019,0.9844270732805764
0,39,56,一番くじ夏目友人帳ニャンコ先生かふぇ,306058,0.9845525316862896
0,43,57,一番くじ夏目友人帳ニャンコ先生かふぇ,306101,0.9846908576207939
0,28,58,一番くじ夏目友人帳ニャンコ先生かふぇ,306129,0.9847809303223316
0,13,59,一番くじ夏目友人帳ニャンコ先生かふぇ,306142,0.9848227497909027
0,2283,0,一番くじ物語シリーズセカンドシーズン,2283,0.005744841469552089
0,29547,1,一番くじ物語シリーズセカンドシーズン,31830,0.08009562154001007
397400,53902,2,一番くじ物語シリーズセカンドシーズン,85732,0.21573225968797183
0,41240,3,一番くじ物語シリーズセカンドシーズン,126972,0.31950679416205335
0,32611,4,一番くじ物語シリーズセカンドシーズン,159583,0.4015676899849019
0,25908,5,一番くじ物語シリーズセカンドシーズン,185491,0.46676144942123804
0,22182,6,一番くじ物語シリーズセカンドシーズン,207673,0.5225792652239557
0,18888,7,一番くじ物語シリーズセカンドシーズン,226561,0.5701082033215903
0,19328,8,一番くじ物語シリーズセカンドシーズン,245889,0.6187443381982889
0,16146,9,一番くじ物語シリーズセカンドシーズン,262035,0.6593734272773024
0,11231,10,一番くじ物語シリーズセカンドシーズン,273266,0.687634625062909
0,10239,11,一番くじ物語シリーズセカンドシーズン,283505,0.7133995973829894
0,8354,12,一番くじ物語シリーズセカンドシーズン,291859,0.7344212380473075
0,6185,13,一番くじ物語シリーズセカンドシーズン,298044,0.7499849018621036
0,7197,14,一番くじ物語シリーズセカンドシーズン,305241,0.7680951182687469
0,7423,15,一番くじ物語シリーズセカンドシーズン,312664,0.7867740312028183
0,5930,16,一番くじ物語シリーズセカンドシーズン,318594,0.8016960241570207
0,4668,17,一番くじ物語シリーズセカンドシーズン,323262,0.8134423754403624
0,3612,18,一番くじ物語シリーズセカンドシーズン,326874,0.8225314544539507
0,3543,19,一番くじ物語シリーズセカンドシーズン,330417,0.8314469048817312
0,2999,20,一番くじ物語シリーズセカンドシーズン,333416,0.8389934574735782
0,3114,21,一番くじ物語シリーズセカンドシーズン,336530,0.8468293910417715
0,3153,22,一番くじ物語シリーズセカンドシーズン,339683,0.8547634625062909
0,2706,23,一番くじ物語シリーズセカンドシーズン,342389,0.8615727226975339
0,1977,24,一番くじ物語シリーズセカンドシーズン,344366,0.8665475591343734
0,2251,25,一番くじ物語シリーズセカンドシーズン,346617,0.8722118772018118
0,1889,26,一番くじ物語シリーズセカンドシーズン,348506,0.8769652742828384
0,1785,27,一番くじ物語シリーズセカンドシーズン,350291,0.8814569703069954
0,1600,28,一番くじ物語シリーズセカンドシーズン,351891,0.8854831404126824
0,1656,29,一番くじ物語シリーズセカンドシーズン,353547,0.8896502264720685
0,1310,30,一番くじ物語シリーズセカンドシーズン,354857,0.8929466532460997
0,1364,31,一番くじ物語シリーズセカンドシーズン,356221,0.8963789632611978
0,889,32,一番くじ物語シリーズセカンドシーズン,357110,0.8986160040261701
0,709,33,一番くじ物語シリーズセカンドシーズン,357819,0.9004001006542527
0,658,34,一番くじ物語シリーズセカンドシーズン,358477,0.9020558631102165
0,657,35,一番くじ物語シリーズセカンドシーズン,359134,0.9037091092098641
0,888,36,一番くじ物語シリーズセカンドシーズン,360022,0.9059436336185204
0,769,37,一番くじ物語シリーズセカンドシーズン,360791,0.9078787116255662
0,558,38,一番くじ物語シリーズセカンドシーズン,361349,0.9092828384499245
0,705,39,一番くじ物語シリーズセカンドシーズン,362054,0.9110568696527428
0,407,40,一番くじ物語シリーズセカンドシーズン,362461,0.912081026673377
0,383,41,一番くじ物語シリーズセカンドシーズン,362844,0.9130447911424258
0,449,42,一番くじ物語シリーズセカンドシーズン,363293,0.9141746351283342
0,518,43,一番くじ物語シリーズセカンドシーズン,363811,0.9154781077000503
0,451,44,一番くじ物語シリーズセカンドシーズン,364262,0.9166129843985908
0,288,45,一番くじ物語シリーズセカンドシーズン,364550,0.9173376950176145
0,314,46,一番くじ物語シリーズセカンドシーズン,364864,0.9181278309008556
0,323,47,一番くじ物語シリーズセカンドシーズン,365187,0.9189406139909411
0,257,48,一番くじ物語シリーズセカンドシーズン,365444,0.9195873175641671
0,265,49,一番くじ物語シリーズセカンドシーズン,365709,0.9202541519879215
0,317,50,一番くじ物語シリーズセカンドシーズン,366026,0.9210518369401107
0,275,51,一番くじ物語シリーズセカンドシーズン,366301,0.9217438349270257
0,203,52,一番くじ物語シリーズセカンドシーズン,366504,0.9222546552591847
0,183,53,一番くじ物語シリーズセカンドシーズン,366687,0.9227151484650227
0,198,54,一番くじ物語シリーズセカンドシーズン,366885,0.9232133870156014
0,201,55,一番くじ物語シリーズセカンドシーズン,367086,0.9237191746351283
0,312,56,一番くじ物語シリーズセカンドシーズン,367398,0.9245042778057373
0,303,57,一番くじ物語シリーズセカンドシーズン,367701,0.9252667337695017
0,249,58,一番くじ物語シリーズセカンドシーズン,367950,0.9258933064921993
0,255,59,一番くじ物語シリーズセカンドシーズン,368205,0.9265349773527931
0,125,0,ディズニーマジックキャッスルカップ＆プレート,125,0.0009121291282964347
70440,1436,1,ディズニーマジックキャッスルカップ＆プレート,1561,0.011390668554165876
66562,3440,2,ディズニーマジックキャッスルカップ＆プレート,5001,0.036492462164883756
40,4181,3,ディズニーマジックキャッスルカップ＆プレート,9182,0.0670013572481429
0,3497,4,ディズニーマジックキャッスルカップ＆プレート,12679,0.09251908174136396
0,3027,5,ディズニーマジックキャッスルカップ＆プレート,15706,0.11460720071219042
0,3101,6,ディズニーマジックキャッスルカップ＆プレート,18807,0.13723530012696838
0,3008,7,ディズニーマジックキャッスルカップ＆プレート,21815,0.15918477547029378
0,2735,8,ディズニーマジックキャッスルカップ＆プレート,24550,0.17914216079741976
0,2869,9,ディズニーマジックキャッスルカップ＆プレート,27419,0.20007734855007953
0,3242,10,ディズニーマジックキャッスルカップ＆プレート,30661,0.22373432962157586
0,2918,11,ディズニーマジックキャッスルカップ＆プレート,33579,0.24502707199252785
0,2116,12,ディズニーマジックキャッスルカップ＆プレート,35695,0.2604675938763299
0,1768,13,ディズニーマジックキャッスルカップ＆プレート,37463,0.2733687482669547
0,1661,14,ディズニーマジックキャッスルカップ＆プレート,39124,0.28548912012375766
0,1734,15,ディズニーマジックキャッスルカップ＆プレート,40858,0.2981421753914858
0,2087,16,ディズニーマジックキャッスルカップ＆プレート,42945,0.3133710833175231
0,2666,17,ディズニーマジックキャッスルカップ＆プレート,45611,0.33282497336582945
0,2411,18,ディズニーマジックキャッスルカップ＆プレート,48022,0.35041811999241107
0,1920,19,ディズニーマジックキャッスルカップ＆プレート,49942,0.3644284234030443
0,1292,20,ディズニーマジックキャッスルカップ＆プレート,51234,0.37385619007311627
0,1310,21,ディズニーマジックキャッスルカップ＆プレート,52544,0.3834153033376629
0,1279,22,ディズニーマジックキャッスルカップ＆プレート,53823,0.39274820857839204
0,1378,23,ディズニーマジックキャッスルカップ＆プレート,55201,0.40280352008873194
0,2032,24,ディズニーマジックキャッスルカップ＆プレート,57233,0.41763109119831876
0,1586,25,ディズニーマジックキャッスルカップ＆プレート,58819,0.42920418557814394
0,884,26,ディズニーマジックキャッスルカップ＆プレート,59703,0.4356547627734563
0,892,27,ディズニーマジックキャッスルカップ＆プレート,60595,0.4421637162329797
0,814,28,ディズニーマジックキャッスルカップ＆プレート,61409,0.44810350111644603
0,745,29,ディズニーマジックキャッスルカップ＆プレート,62154,0.4535397907210928
0,889,30,ディズニーマジックキャッスルカップ＆プレート,63043,0.46002685308153707
0,1300,31,ディズニーマジックキャッスルカップ＆プレート,64343,0.46951299601581997
0,1069,32,ディズニーマジックキャッスルカップ＆プレート,65412,0.4773135243210111
0,636,33,ディズニーマジックキャッスルカップ＆プレート,66048,0.48195443732578336
0,629,34,ディズニーマジックキャッスルカップ＆プレート,66677,0.486544271099371
0,672,35,ディズニーマジックキャッスルカップ＆プレート,67349,0.49144787729309264
0,825,36,ディズニーマジックキャッスルカップ＆プレート,68174,0.4974679295398491
0,797,37,ディズニーマジックキャッスルカップ＆プレート,68971,0.5032836648618672
0,1132,38,ディズニーマジックキャッスルカップ＆プレート,70103,0.5115439062477197
0,980,39,ディズニーマジックキャッスルカップ＆プレート,71083,0.5186949986135637
0,596,40,ディズニーマジックキャッスルカップ＆プレート,71679,0.5230440302972811
0,639,41,ディズニーマジックキャッスルカップ＆プレート,72318,0.5277068344011325
0,627,42,ディズニーマジックキャッスルカップ＆プレート,72945,0.5322820741086675
0,614,43,ディズニーマジックキャッスルカップ＆プレート,73559,0.5367624523868595
0,642,44,ディズニーマジックキャッスルカップ＆プレート,74201,0.54144714758979
0,785,45,ディズニーマジックキャッスルカップ＆プレート,74986,0.5471753185154916
0,795,46,ディズニーマジックキャッスルカップ＆プレート,75781,0.5529764597714569
0,539,47,ディズニーマジックキャッスルカップ＆プレート,76320,0.5569095605726712
0,542,48,ディズニーマジックキャッスルカップ＆プレート,76862,0.5608645524729645
0,571,49,ディズニーマジックキャッスルカップ＆プレート,77433,0.5650311583310226
0,532,50,ディズニーマジックキャッスルカップ＆プレート,77965,0.5689131799010523
0,701,51,ディズニーマジックキャッスルカップ＆プレート,78666,0.5740284000525386
0,688,52,ディズニーマジックキャッスルカップ＆プレート,79354,0.5790487587746822
0,590,53,ディズニーマジックキャッスルカップ＆プレート,79944,0.5833540082602414
0,568,54,ディズニーマジックキャッスルカップ＆プレート,80512,0.5874987230192203
0,684,55,ディズニーマジックキャッスルカップ＆プレート,81196,0.5924898936092585
0,652,56,ディズニーマジックキャッスルカップ＆プレート,81848,0.5972475591424526
0,722,57,ディズニーマジックキャッスルカップ＆プレート,82570,0.6025160169874929
0,863,58,ディズニーマジックキャッスルカップ＆プレート,83433,0.6088133564892515
0,837,59,ディズニーマジックキャッスルカップ＆プレート,84270,0.6149209731323244
0,215,0,一番くじテニスの王子様サバイバル※,215,0.007185828877005348
13680,901,1,一番くじテニスの王子様サバイバル※,1116,0.03729946524064171
16080,1375,2,一番くじテニスの王子様サバイバル※,2491,0.08325534759358288
160,1236,3,一番くじテニスの王子様サバイバル※,3727,0.12456550802139038
0,754,4,一番くじテニスの王子様サバイバル※,4481,0.14976604278074868
0,488,5,一番くじテニスの王子様サバイバル※,4969,0.16607620320855615
0,321,6,一番くじテニスの王子様サバイバル※,5290,0.1768048128342246
0,580,7,一番くじテニスの王子様サバイバル※,5870,0.19618983957219252
0,308,8,一番くじテニスの王子様サバイバル※,6178,0.20648395721925134
0,239,9,一番くじテニスの王子様サバイバル※,6417,0.21447192513368984
0,250,10,一番くじテニスの王子様サバイバル※,6667,0.22282754010695188
0,286,11,一番くじテニスの王子様サバイバル※,6953,0.23238636363636364
0,334,12,一番くじテニスの王子様サバイバル※,7287,0.24354946524064172
0,374,13,一番くじテニスの王子様サバイバル※,7661,0.2560494652406417
0,188,14,一番くじテニスの王子様サバイバル※,7849,0.26233288770053476
0,208,15,一番くじテニスの王子様サバイバル※,8057,0.26928475935828877
0,216,16,一番くじテニスの王子様サバイバル※,8273,0.27650401069518715
0,244,17,一番くじテニスの王子様サバイバル※,8517,0.2846590909090909
0,216,18,一番くじテニスの王子様サバイバル※,8733,0.2918783422459893
0,105,19,一番くじテニスの王子様サバイバル※,8838,0.2953877005347594
0,108,20,一番くじテニスの王子様サバイバル※,8946,0.29899732620320857
0,223,21,一番くじテニスの王子様サバイバル※,9169,0.3064505347593583
0,229,22,一番くじテニスの王子様サバイバル※,9398,0.3141042780748663
0,251,23,一番くじテニスの王子様サバイバル※,9649,0.3224933155080214
0,295,24,一番くじテニスの王子様サバイバル※,9944,0.3323529411764706
0,193,25,一番くじテニスの王子様サバイバル※,10137,0.3388034759358289
0,210,26,一番くじテニスの王子様サバイバル※,10347,0.345822192513369
0,246,27,一番くじテニスの王子様サバイバル※,10593,0.35404411764705884
0,121,28,一番くじテニスの王子様サバイバル※,10714,0.35808823529411765
0,99,29,一番くじテニスの王子様サバイバル※,10813,0.3613970588235294
0,90,30,一番くじテニスの王子様サバイバル※,10903,0.3644050802139037
0,115,31,一番くじテニスの王子様サバイバル※,11018,0.36824866310160426
0,137,32,一番くじテニスの王子様サバイバル※,11155,0.37282754010695185
0,111,33,一番くじテニスの王子様サバイバル※,11266,0.3765374331550802
0,63,34,一番くじテニスの王子様サバイバル※,11329,0.37864304812834226
0,81,35,一番くじテニスの王子様サバイバル※,11410,0.38135026737967914
0,88,36,一番くじテニスの王子様サバイバル※,11498,0.38429144385026737
0,57,37,一番くじテニスの王子様サバイバル※,11555,0.3861965240641711
0,120,38,一番くじテニスの王子様サバイバル※,11675,0.3902072192513369
0,156,39,一番くじテニスの王子様サバイバル※,11831,0.39542112299465243
0,77,40,一番くじテニスの王子様サバイバル※,11908,0.3979946524064171
0,86,41,一番くじテニスの王子様サバイバル※,11994,0.40086898395721926
0,88,42,一番くじテニスの王子様サバイバル※,12082,0.4038101604278075
0,64,43,一番くじテニスの王子様サバイバル※,12146,0.40594919786096256
0,103,44,一番くじテニスの王子様サバイバル※,12249,0.4093917112299465
0,71,45,一番くじテニスの王子様サバイバル※,12320,0.4117647058823529
0,96,46,一番くじテニスの王子様サバイバル※,12416,0.41497326203208557
0,78,47,一番くじテニスの王子様サバイバル※,12494,0.41758021390374334
0,32,48,一番くじテニスの王子様サバイバル※,12526,0.41864973262032085
0,56,49,一番くじテニスの王子様サバイバル※,12582,0.42052139037433156
0,93,50,一番くじテニスの王子様サバイバル※,12675,0.42362967914438504
0,41,51,一番くじテニスの王子様サバイバル※,12716,0.425
0,82,52,一番くじテニスの王子様サバイバル※,12798,0.42774064171122994
0,83,53,一番くじテニスの王子様サバイバル※,12881,0.43051470588235297
0,58,54,一番くじテニスの王子様サバイバル※,12939,0.4324532085561497
0,31,55,一番くじテニスの王子様サバイバル※,12970,0.4334893048128342
0,47,56,一番くじテニスの王子様サバイバル※,13017,0.4350601604278075
0,98,57,一番くじテニスの王子様サバイバル※,13115,0.4383355614973262
0,53,58,一番くじテニスの王子様サバイバル※,13168,0.44010695187165777
0,81,59,一番くじテニスの王子様サバイバル※,13249,0.44281417112299465
0,3485,0,一番くじハンター×ハンター緋色の追憶編,3485,0.00655206968318816
267880,40299,1,一番くじハンター×ハンター緋色の追憶編,43784,0.08231730818040471
264001,77738,2,一番くじハンター×ハンター緋色の追憶編,121522,0.22847076385664034
0,66834,3,一番くじハンター×ハンター緋色の追憶編,188356,0.35412385573790217
0,55878,4,一番くじハンター×ハンター緋色の追憶編,244234,0.45917881980022296
0,63419,5,一番くじハンター×ハンター緋色の追憶編,307653,0.5784114474151756
0,47433,6,一番くじハンター×ハンター緋色の追憶編,355086,0.667589157969742
0,27023,7,一番くじハンター×ハンター緋色の追憶編,382109,0.7183944891171721
0,19451,8,一番くじハンター×ハンター緋色の追憶編,401560,0.7549638743130668
0,16426,9,一番くじハンター×ハンター緋色の追憶編,417986,0.7858460254224063
0,12723,10,一番くじハンター×ハンター緋色の追憶編,430709,0.8097662499788492
0,10682,11,一番くじハンター×ハンター緋色の追憶編,441391,0.8298492365945782
0,12547,12,一番くじハンター×ハンター緋色の追憶編,453938,0.8534385675314395
0,10205,13,一番くじハンター×ハンター緋色の追憶編,464143,0.8726247572350078
0,5779,14,一番くじハンター×ハンター緋色の追憶編,469922,0.8834897244370579
0,4840,15,一番くじハンター×ハンター緋色の追憶編,474762,0.8925892989755458
0,4184,16,一番くじハンター×ハンター緋色の追憶編,478946,0.9004555427501396
0,4073,17,一番くじハンター×ハンター緋色の追憶編,483019,0.908113097935111
0,4054,18,一番くじハンター×ハンター緋色の追憶編,487073,0.9157349316497867
0,3929,19,一番くじハンター×ハンター緋色の追憶編,491002,0.9231217556914643
0,3419,20,一番くじハンター×ハンター緋色の追憶編,494421,0.9295497402673094
0,2141,21,一番くじハンター×ハンター緋色の追憶編,496562,0.9335749859464215
0,1609,22,一番くじハンター×ハンター緋色の追憶編,498171,0.9366000304572536
0,1644,23,一番くじハンター×ハンター緋色の追憶編,499815,0.9396908776765251
0,1295,24,一番くじハンター×ハンター緋色の追憶編,501110,0.9421255778887859
0,1267,25,一番くじハンター×ハンター緋色の追憶編,502377,0.9445076359342951
0,1371,26,一番くじハンター×ハンター緋色の追憶編,503748,0.9470852220277387
0,1388,27,一番くじハンター×ハンター緋色の追憶編,505136,0.94969476943671
0,729,28,一番くじハンター×ハンター緋色の追憶編,505865,0.9510653458496352
0,673,29,一番くじハンター×ハンター緋色の追憶編,506538,0.9523306379290571
0,714,30,一番くじハンター×ハンター緋色の追憶編,507252,0.9536730131812226
0,525,31,一番くじハンター×ハンター緋色の追憶編,507777,0.9546600538078147
0,696,32,一番くじハンター×ハンター緋色の追憶編,508473,0.9559685876670684
0,744,33,一番くじハンター×ハンター緋色の追憶編,509217,0.9573673652407533
0,677,34,一番くじハンター×ハンター緋色の追憶編,509894,0.9586401776297112
0,668,35,一番くじハンター×ハンター緋色の追憶編,510562,0.9598960693222133
0,379,36,一番くじハンター×ハンター緋色の追憶編,510941,0.9606086186507437
0,279,37,一番くじハンター×ハンター緋色の追憶編,511220,0.9611331602408755
0,307,38,一番くじハンター×ハンター緋色の追憶編,511527,0.9617103439977589
0,340,39,一番くじハンター×ハンター緋色の追憶編,511867,0.9623495703083139
0,532,40,一番くじハンター×ハンター緋色の追憶編,512399,0.963349771476594
0,435,41,一番くじハンター×ハンター緋色の追憶編,512834,0.9641676051386275
0,275,42,一番くじハンター×ハンター緋色の追憶編,513109,0.9646846264192234
0,190,43,一番くじハンター×ハンター緋色の追憶編,513299,0.9650418411221806
0,228,44,一番くじハンター×ハンター緋色の追憶編,513527,0.9654704987657292
0,233,45,一番くじハンター×ハンター緋色の追憶編,513760,0.9659085567961977
0,279,46,一番くじハンター×ハンター緋色の追憶編,514039,0.9664330983863296
0,252,47,一番くじハンター×ハンター緋色の追憶編,514291,0.9669068778870938
0,367,48,一番くじハンター×ハンター緋色の追憶編,514658,0.9675968662870164
0,268,49,一番くじハンター×ハンター緋色の追憶編,514926,0.9681007270259244
0,248,50,一番くじハンター×ハンター緋色の追憶編,515174,0.9685669862171526
0,219,51,一番くじハンター×ハンター緋色の追憶編,515393,0.9689787231642455
0,211,52,一番くじハンター×ハンター緋色の追憶編,515604,0.9693754194922664
0,182,53,一番くじハンター×ハンター緋色の追憶編,515786,0.9697175935761516
0,241,54,一番くじハンター×ハンター緋色の追憶編,516027,0.970170692225692
12,237,55,一番くじハンター×ハンター緋色の追憶編,516264,0.9706162705656964
0,205,56,一番くじハンター×ハンター緋色の追憶編,516469,0.9710016864294134
0,115,57,一番くじハンター×ハンター緋色の追憶編,516584,0.9712178953285717
0,98,58,一番くじハンター×ハンター緋色の追憶編,516682,0.9714021429122023
0,120,59,一番くじハンター×ハンター緋色の追憶編,516802,0.9716277521982805
0,8,0,とるパカ！タヌキとキツネ,8,0.00392156862745098
864,192,1,とるパカ！タヌキとキツネ,200,0.09803921568627451
1176,213,2,とるパカ！タヌキとキツネ,413,0.20245098039215687
0,158,3,とるパカ！タヌキとキツネ,571,0.27990196078431373
0,161,4,とるパカ！タヌキとキツネ,732,0.3588235294117647
0,119,5,とるパカ！タヌキとキツネ,851,0.41715686274509806
0,94,6,とるパカ！タヌキとキツネ,945,0.4632352941176471
0,118,7,とるパカ！タヌキとキツネ,1063,0.5210784313725491
0,53,8,とるパカ！タヌキとキツネ,1116,0.5470588235294118
0,47,9,とるパカ！タヌキとキツネ,1163,0.5700980392156862
0,49,10,とるパカ！タヌキとキツネ,1212,0.5941176470588235
0,35,11,とるパカ！タヌキとキツネ,1247,0.6112745098039216
0,28,12,とるパカ！タヌキとキツネ,1275,0.625
0,25,13,とるパカ！タヌキとキツネ,1300,0.6372549019607843
0,26,14,とるパカ！タヌキとキツネ,1326,0.65
0,19,15,とるパカ！タヌキとキツネ,1345,0.6593137254901961
0,29,16,とるパカ！タヌキとキツネ,1374,0.6735294117647059
0,11,17,とるパカ！タヌキとキツネ,1385,0.678921568627451
0,5,18,とるパカ！タヌキとキツネ,1390,0.6813725490196079
0,14,19,とるパカ！タヌキとキツネ,1404,0.6882352941176471
0,7,20,とるパカ！タヌキとキツネ,1411,0.6916666666666667
0,31,21,とるパカ！タヌキとキツネ,1442,0.7068627450980393
0,9,22,とるパカ！タヌキとキツネ,1451,0.7112745098039216
0,20,23,とるパカ！タヌキとキツネ,1471,0.721078431372549
0,5,24,とるパカ！タヌキとキツネ,1476,0.7235294117647059
0,3,25,とるパカ！タヌキとキツネ,1479,0.725
0,5,26,とるパカ！タヌキとキツネ,1484,0.7274509803921568
0,0,27,とるパカ！タヌキとキツネ,1484,0.7274509803921568
0,6,28,とるパカ！タヌキとキツネ,1490,0.7303921568627451
0,10,29,とるパカ！タヌキとキツネ,1500,0.7352941176470589
0,2,30,とるパカ！タヌキとキツネ,1502,0.7362745098039216
0,5,31,とるパカ！タヌキとキツネ,1507,0.7387254901960785
0,12,32,とるパカ！タヌキとキツネ,1519,0.7446078431372549
0,16,33,とるパカ！タヌキとキツネ,1535,0.7524509803921569
0,3,34,とるパカ！タヌキとキツネ,1538,0.753921568627451
0,11,35,とるパカ！タヌキとキツネ,1549,0.759313725490196
0,4,36,とるパカ！タヌキとキツネ,1553,0.7612745098039215
0,3,37,とるパカ！タヌキとキツネ,1556,0.7627450980392156
0,8,38,とるパカ！タヌキとキツネ,1564,0.7666666666666667
0,4,39,とるパカ！タヌキとキツネ,1568,0.7686274509803922
0,7,40,とるパカ！タヌキとキツネ,1575,0.7720588235294118
0,2,41,とるパカ！タヌキとキツネ,1577,0.7730392156862745
0,8,42,とるパカ！タヌキとキツネ,1585,0.7769607843137255
0,4,43,とるパカ！タヌキとキツネ,1589,0.778921568627451
0,8,44,とるパカ！タヌキとキツネ,1597,0.782843137254902
0,2,45,とるパカ！タヌキとキツネ,1599,0.7838235294117647
0,5,46,とるパカ！タヌキとキツネ,1604,0.7862745098039216
0,3,47,とるパカ！タヌキとキツネ,1607,0.7877450980392157
0,1,48,とるパカ！タヌキとキツネ,1608,0.788235294117647
0,6,49,とるパカ！タヌキとキツネ,1614,0.7911764705882353
0,2,50,とるパカ！タヌキとキツネ,1616,0.792156862745098
0,3,51,とるパカ！タヌキとキツネ,1619,0.7936274509803921
0,8,52,とるパカ！タヌキとキツネ,1627,0.7975490196078432
0,3,53,とるパカ！タヌキとキツネ,1630,0.7990196078431373
0,3,54,とるパカ！タヌキとキツネ,1633,0.8004901960784314
0,3,55,とるパカ！タヌキとキツネ,1636,0.8019607843137255
0,4,56,とるパカ！タヌキとキツネ,1640,0.803921568627451
0,1,57,とるパカ！タヌキとキツネ,1641,0.8044117647058824
0,1,58,とるパカ！タヌキとキツネ,1642,0.8049019607843138
0,1,59,とるパカ！タヌキとキツネ,1643,0.8053921568627451
0,2485,0,ポケモンコレクションくじ２０１８,2485,0.0041775729057919484
308461,39230,1,ポケモンコレクションくじ２０１８,41715,0.0701277479940085
283862,64705,2,ポケモンコレクションくじ２０１８,106420,0.17890434955105802
180,51208,3,ポケモンコレクションくじ２０１８,157628,0.264990930379949
60,48251,4,ポケモンコレクションくじ２０１８,205879,0.3461064516183262
0,45759,5,ポケモンコレクションくじ２０１８,251638,0.42303263213990916
60,38623,6,ポケモンコレクションくじ２０１８,290261,0.4879623699026466
0,37440,7,ポケモンコレクションくじ２０１８,327701,0.550903347606007
0,40068,8,ポケモンコレクションくじ２０１８,367769,0.6182622977827763
0,31801,9,ポケモンコレクションくじ２０１８,399570,0.671723463165911
0,24391,10,ポケモンコレクションくじ２０１８,423961,0.7127275600452556
0,15740,11,ポケモンコレクションくじ２０１８,439701,0.7391883236417004
0,13687,12,ポケモンコレクションくじ２０１８,453388,0.7621977563827766
0,12173,13,ポケモンコレクションくじ２０１８,465561,0.7826619797156561
0,12325,14,ポケモンコレクションくじ２０１８,477886,0.8033817326588697
0,12547,15,ポケモンコレクションくじ２０１８,490433,0.8244746933224397
0,9961,16,ポケモンコレクションくじ２０１８,500394,0.8412202883786142
0,6559,17,ポケモンコレクションくじ２０１８,506953,0.8522467272877045
0,5975,18,ポケモンコレクションくじ２０１８,512928,0.8622913945360372
0,6413,19,ポケモンコレクションくじ２０１８,519341,0.8730723905299381
2160,5521,20,ポケモンコレクションくじ２０１８,524862,0.8823538311789834
0,5587,21,ポケモンコレクションくじ２０１８,530449,0.891746225474621
0,5343,22,ポケモンコレクションくじ２０１８,535792,0.9007284275010381
0,4703,23,ポケモンコレクションくじ２０１８,540495,0.9086347153786798
0,3336,24,ポケモンコレクションくじ２０１８,543831,0.9142429178791714
0,3261,25,ポケモンコレクションくじ２０１８,547092,0.9197250366903535
0,2727,26,ポケモンコレクションくじ２０１８,549819,0.9243094396336512
0,2564,27,ポケモンコレクションくじ２０１８,552383,0.9286198206921826
0,2549,28,ポケモンコレクションくじ２０１８,554932,0.9329049850128521
0,2575,29,ポケモンコレクションくじ２０１８,557507,0.9372338583458156
0,2496,30,ポケモンコレクションくじ２０１８,560003,0.9414299235260396
0,1845,31,ポケモンコレクションくじ２０１８,561848,0.9445315822830562
0,1704,32,ポケモンコレクションくじ２０１８,563552,0.9473962037041707
0,1440,33,ポケモンコレクションくじ２０１８,564992,0.9498170105389153
0,1331,34,ポケモンコレクションくじ２０１８,566323,0.9520545757451966
0,1474,35,ポケモンコレクションくじ２０１８,567797,0.954532540519095
0,1719,36,ポケモンコレクションくじ２０１８,569516,0.9574223786780713
60,1621,37,ポケモンコレクションくじ２０１８,571137,0.9601474674830165
0,1319,38,ポケモンコレクションくじ２０１８,572456,0.9623648592990083
0,1298,39,ポケモンコレクションくじ２０１８,573754,0.9645469476819934
0,1136,40,ポケモンコレクションくじ２０１８,574890,0.9664566952960697
0,922,41,ポケモンコレクションくじ２０１８,575812,0.9680066841166493
0,816,42,ポケモンコレクションくじ２０１８,576628,0.9693784746563379
0,861,43,ポケモンコレクションくじ２０１８,577489,0.9708259154096123
0,740,44,ポケモンコレクションくじ２０１８,578229,0.9720699411441338
0,539,45,ポケモンコレクションくじ２０１８,578768,0.9729760625913056
0,596,46,ポケモンコレクションくじ２０１８,579364,0.9739780076423527
0,441,47,ポケモンコレクションくじ２０１８,579805,0.9747193797354933
0,506,48,ポケモンコレクションくじ２０１８,580311,0.9755700243593688
0,604,49,ポケモンコレクションくじ２０１８,580915,0.9765854183372755
0,717,50,ポケモンコレクションくじ２０１８,581632,0.9777907784070755
0,509,51,ポケモンコレクションくじ２０１８,582141,0.9786464663785234
0,452,52,ポケモンコレクションくじ２０１８,582593,0.9794063307460961
0,417,53,ポケモンコレクションくじ２０１８,583010,0.9801073560586575
0,338,54,ポケモンコレクションくじ２０１８,583348,0.9806755732184795
0,307,55,ポケモンコレクションくじ２０１８,583655,0.9811916757867202
0,323,56,ポケモンコレクションくじ２０１８,583978,0.9817346762086803
0,435,57,ポケモンコレクションくじ２０１８,584413,0.9824659616066761
0,367,58,ポケモンコレクションくじ２０１８,584780,0.9830829311263645
0,177,59,ポケモンコレクションくじ２０１８,584957,0.9833804886331351
0,4723,0,一番くじテイルズオブシリーズ２０ｔｈ,4723,0.01243847261982202
193815,36500,1,一番くじテイルズオブシリーズ２０ｔｈ,41223,0.10856471666460368
185759,64188,2,一番くじテイルズオブシリーズ２０ｔｈ,105411,0.27760995920560216
135,37447,3,一番くじテイルズオブシリーズ２０ｔｈ,142858,0.37623021840409365
0,25230,4,一番くじテイルズオブシリーズ２０ｔｈ,168088,0.4426758386027195
0,20247,5,一番くじテイルズオブシリーズ２０ｔｈ,188335,0.4959982512924371
0,15248,6,一番くじテイルズオブシリーズ２０ｔｈ,203583,0.5361553189416105
0,12296,7,一番くじテイルズオブシリーズ２０ｔｈ,215879,0.5685380120039293
0,11956,8,一番くじテイルズオブシリーズ２０ｔｈ,227835,0.6000252825189817
0,11509,9,一番くじテイルズオブシリーズ２０ｔｈ,239344,0.6303353357439513
0,9757,10,一番くじテイルズオブシリーズ２０ｔｈ,249101,0.6560313292547714
0,7681,11,一番くじテイルズオブシリーズ２０ｔｈ,256782,0.6762599780358116
0,7692,12,一番くじテイルズオブシリーズ２０ｔｈ,264474,0.6965175963698517
0,6205,13,一番くじテイルズオブシリーズ２０ｔｈ,270679,0.7128590578574645
0,6120,14,一番くじテイルズオブシリーズ２０ｔｈ,276799,0.7289766637082608
0,7817,15,一番くじテイルズオブシリーズ２０ｔｈ,284616,0.7495634815082076
0,7583,16,一番くじテイルズオブシリーズ２０ｔｈ,292199,0.7695340379079769
0,6409,17,一番くじテイルズオブシリーズ２０ｔｈ,298608,0.7864127529239496
0,4525,18,一番くじテイルズオブシリーズ２０ｔｈ,303133,0.7983297735897753
0,3566,19,一番くじテイルズオブシリーズ２０ｔｈ,306699,0.8077211759531642
0,3385,20,一番くじテイルズオブシリーズ２０ｔｈ,310084,0.8166358974899199
0,2901,21,一番くじテイルズオブシリーズ２０ｔｈ,312985,0.8242759586946846
0,2458,22,一番くじテイルズオブシリーズ２０ｔｈ,315443,0.8307493369922757
0,3482,23,一番くじテイルズオブシリーズ２０ｔｈ,318925,0.8399195173145751
0,2803,24,一番くじテイルズオブシリーズ２０ｔｈ,321728,0.8473014861380689
0,2014,25,一番くじテイルズオブシリーズ２０ｔｈ,323742,0.852605547932759
0,1682,26,一番くじテイルズオブシリーズ２０ｔｈ,325424,0.8570352559460007
0,1638,27,一番くじテイルズオブシリーズ２０ｔｈ,327062,0.8613490857472433
0,1131,28,一番くじテイルズオブシリーズ２０ｔｈ,328193,0.8643276825147679
0,1186,29,一番くじテイルズオブシリーズ２０ｔｈ,329379,0.8674511270472914
0,1487,30,一番くじテイルズオブシリーズ２０ｔｈ,330866,0.8713672838937186
0,1193,31,一番くじテイルズオブシリーズ２０ｔｈ,332059,0.874509163596333
0,899,32,一番くじテイルズオブシリーズ２０ｔｈ,332958,0.8768767661551345
0,963,33,一番くじテイルズオブシリーズ２０ｔｈ,333921,0.8794129188404805
0,964,34,一番くじテイルズオブシリーズ２０ｔｈ,334885,0.8819517051215536
0,720,35,一番くじテイルズオブシリーズ２０ｔｈ,335605,0.8838478940451767
0,847,36,一番くじテイルズオブシリーズ２０ｔｈ,336452,0.8860785496261611
0,845,37,一番くじテイルズオブシリーズ２０ｔｈ,337297,0.888303938015691
0,737,38,一番くじテイルズオブシリーズ２０ｔｈ,338034,0.8902448980666774
0,612,39,一番くじテイルズオブシリーズ２０ｔｈ,338646,0.891856658651757
0,639,40,一番くじテイルズオブシリーズ２０ｔｈ,339285,0.8935395263214725
0,531,41,一番くじテイルズオブシリーズ２０ｔｈ,339816,0.8949379656526445
0,467,42,一番くじテイルズオブシリーズ２０ｔｈ,340283,0.8961678548572722
0,704,43,一番くじテイルズオブシリーズ２０ｔｈ,340987,0.8980219062492593
0,580,44,一番くじテイルズオブシリーズ２０ｔｈ,341567,0.8995493917710667
0,731,45,一番くじテイルズオブシリーズ２０ｔｈ,342298,0.9014745502476896
0,444,46,一番くじテイルズオブシリーズ２０ｔｈ,342742,0.9026438667505906
0,465,47,一番くじテイルズオブシリーズ２０ｔｈ,343207,0.9038684887637638
0,643,48,一番くじテイルズオブシリーズ２０ｔｈ,343850,0.9055618908163884
0,511,49,一番くじテイルズオブシリーズ２０ｔｈ,344361,0.9069076582330153
0,487,50,一番くじテイルズオブシリーズ２０ｔｈ,344848,0.9081902193521881
0,668,51,一番くじテイルズオブシリーズ２０ｔｈ,345516,0.909949461297994
0,419,52,一番くじテイルズオブシリーズ２０ｔｈ,345935,0.9110529379077136
0,394,53,一番くじテイルズオブシリーズ２０ｔｈ,346329,0.9120905746242517
0,315,54,一番くじテイルズオブシリーズ２０ｔｈ,346644,0.9129201572783369
0,393,55,一番くじテイルズオブシリーズ２０ｔｈ,347037,0.9139551603991478
0,380,56,一番くじテイルズオブシリーズ２０ｔｈ,347417,0.9149559267755044
0,393,57,一番くじテイルズオブシリーズ２０ｔｈ,347810,0.9159909298963154
0,430,58,一番くじテイルズオブシリーズ２０ｔｈ,348240,0.9171233760590347
0,343,59,一番くじテイルズオブシリーズ２０ｔｈ,348583,0.9180266993934829
7200,645,0,一番くじふなっしー全力で作ったなっしー※,645,0.0030151458489154825
106960,6999,1,一番くじふなっしー全力で作ったなっしー※,7644,0.035732984293193715
91920,15022,2,一番くじふなっしー全力で作ったなっしー※,22666,0.10595549738219895
7760,13254,3,一番くじふなっしー全力で作ったなっしー※,35920,0.16791323859386686
0,11702,4,一番くじふなっしー全力で作ったなっしー※,47622,0.22261593118922962
0,9985,5,一番くじふなっしー全力で作ったなっしー※,57607,0.2692922587883321
0,8791,6,一番くじふなっしー全力で作ったなっしー※,66398,0.31038706058339566
0,8199,7,一番くじふなっしー全力で作ったなっしー※,74597,0.3487144727000748
0,7634,8,一番くじふなっしー全力で作ったなっしー※,82231,0.3844007105459985
0,7349,9,一番くじふなっしー全力で作ったなっしー※,89580,0.418754674644727
80,6043,10,一番くじふなっしー全力で作ったなっしー※,95623,0.44700355272999254
0,5412,11,一番くじふなっしー全力で作ったなっしー※,101035,0.47230272999252054
0,5215,12,一番くじふなっしー全力で作ったなっしー※,106250,0.4966810022438295
0,5442,13,一番くじふなっしー全力で作ったなっしー※,111692,0.5221204188481675
0,4747,14,一番くじふなっしー全力で作ったなっしー※,116439,0.5443109573672401
0,4627,15,一番くじふなっしー全力で作ったなっしー※,121066,0.5659405385190726
0,4364,16,一番くじふなっしー全力で作ったなっしー※,125430,0.5863406881077038
0,3872,17,一番くじふなっしー全力で作ったなっしー※,129302,0.6044409124906507
0,3092,18,一番くじふなっしー全力で作ったなっしー※,132394,0.6188949139865371
0,2911,19,一番くじふなっしー全力で作ったなっしー※,135305,0.6325028047868362
0,2685,20,一番くじふなっしー全力で作ったなっしー※,137990,0.6450542258788332
0,2438,21,一番くじふなっしー全力で作ったなっしー※,140428,0.656451009723261
0,2535,22,一番くじふなっしー全力で作ったなっしー※,142963,0.6683012341062079
0,3159,23,一番くじふなっしー全力で作ったなっしー※,146122,0.6830684367988032
0,2276,24,一番くじふなっしー全力で作ったなっしー※,148398,0.693707928197457
0,2137,25,一番くじふなっしー全力で作ったなっしー※,150535,0.7036976439790575
0,1898,26,一番くじふなっしー全力で作ったなっしー※,152433,0.712570119670905
0,1969,27,一番くじふなっしー全力で作ったなっしー※,154402,0.7217744951383694
0,1707,28,一番くじふなっしー全力で作ったなっしー※,156109,0.7297541136873598
0,1822,29,一番くじふなっしー全力で作ったなっしー※,157931,0.7382713163799551
0,2143,30,一番くじふなっしー全力で作ったなっしー※,160074,0.7482890800299177
0,1988,31,一番くじふなっしー全力で作ったなっしー※,162062,0.7575822737471952
0,1267,32,一番くじふなっしー全力で作ったなっしー※,163329,0.7635050486163052
0,1303,33,一番くじふなっしー全力で作ったなっしー※,164632,0.7695961106955871
0,1164,34,一番くじふなっしー全力で作ったなっしー※,165796,0.775037397157816
0,1121,35,一番くじふなっしー全力で作ったなっしー※,166917,0.7802776738967838
0,1151,36,一番くじふなっしー全力で作ったなっしー※,168068,0.7856581899775618
0,1302,37,一番くじふなっしー全力で作ったなっしー※,169370,0.7917445774121167
0,1176,38,一番くじふなっしー全力で作ったなっしー※,170546,0.7972419596110696
0,932,39,一番くじふなっしー全力で作ったなっしー※,171478,0.8015987284966343
0,794,40,一番くじふなっしー全力で作ったなっしー※,172272,0.8053103964098729
0,810,41,一番くじふなっしー全力で作ったなっしー※,173082,0.8090968586387435
0,776,42,一番くじふなっしー全力で作ったなっしー※,173858,0.8127243829468961
0,822,43,一番くじふなっしー全力で作ったなっしー※,174680,0.8165669409124906
0,904,44,一番くじふなっしー全力で作ったなっしー※,175584,0.8207928197456993
0,1011,45,一番くじふなっしー全力で作ったなっしー※,176595,0.8255188855646971
0,775,46,一番くじふなっしー全力で作ったなっしー※,177370,0.8291417352281226
0,621,47,一番くじふなっしー全力で作ったなっしー※,177991,0.8320446896035901
0,581,48,一番くじふなっしー全力で作ったなっしー※,178572,0.8347606581899776
0,701,49,一番くじふなっしー全力で作ったなっしー※,179273,0.8380375841436051
0,676,50,一番くじふなっしー全力で作ったなっしー※,179949,0.8411976439790576
0,714,51,一番くじふなっしー全力で作ったなっしー※,180663,0.8445353403141361
0,710,52,一番くじふなっしー全力で作ったなっしー※,181373,0.8478543380703066
0,528,53,一番くじふなっしー全力で作ったなっしー※,181901,0.850322550486163
0,660,54,一番くじふなっしー全力で作ったなっしー※,182561,0.8534078160059836
0,355,55,一番くじふなっしー全力で作ったなっしー※,182916,0.8550673148840688
0,502,56,一番くじふなっしー全力で作ったなっしー※,183418,0.8574139865370232
0,443,57,一番くじふなっしー全力で作ったなっしー※,183861,0.8594848541510846
0,567,58,一番くじふなっしー全力で作ったなっしー※,184428,0.8621353777112939
0,488,59,一番くじふなっしー全力で作ったなっしー※,184916,0.8644166043380703
0,34,0,一番くじＷＣＦスター・ウォーズ※,34,0.00166015625
12000,205,1,一番くじＷＣＦスター・ウォーズ※,239,0.011669921875
8400,479,2,一番くじＷＣＦスター・ウォーズ※,718,0.03505859375
0,368,3,一番くじＷＣＦスター・ウォーズ※,1086,0.05302734375
0,379,4,一番くじＷＣＦスター・ウォーズ※,1465,0.071533203125
0,274,5,一番くじＷＣＦスター・ウォーズ※,1739,0.084912109375
0,446,6,一番くじＷＣＦスター・ウォーズ※,2185,0.106689453125
0,336,7,一番くじＷＣＦスター・ウォーズ※,2521,0.123095703125
0,319,8,一番くじＷＣＦスター・ウォーズ※,2840,0.138671875
0,393,9,一番くじＷＣＦスター・ウォーズ※,3233,0.157861328125
0,314,10,一番くじＷＣＦスター・ウォーズ※,3547,0.173193359375
0,310,11,一番くじＷＣＦスター・ウォーズ※,3857,0.188330078125
0,322,12,一番くじＷＣＦスター・ウォーズ※,4179,0.204052734375
80,235,13,一番くじＷＣＦスター・ウォーズ※,4414,0.21552734375
0,326,14,一番くじＷＣＦスター・ウォーズ※,4740,0.2314453125
0,276,15,一番くじＷＣＦスター・ウォーズ※,5016,0.244921875
0,362,16,一番くじＷＣＦスター・ウォーズ※,5378,0.26259765625
0,227,17,一番くじＷＣＦスター・ウォーズ※,5605,0.273681640625
0,298,18,一番くじＷＣＦスター・ウォーズ※,5903,0.288232421875
0,260,19,一番くじＷＣＦスター・ウォーズ※,6163,0.300927734375
0,237,20,一番くじＷＣＦスター・ウォーズ※,6400,0.3125
0,262,21,一番くじＷＣＦスター・ウォーズ※,6662,0.32529296875
0,222,22,一番くじＷＣＦスター・ウォーズ※,6884,0.3361328125
0,260,23,一番くじＷＣＦスター・ウォーズ※,7144,0.348828125
0,266,24,一番くじＷＣＦスター・ウォーズ※,7410,0.36181640625
0,241,25,一番くじＷＣＦスター・ウォーズ※,7651,0.373583984375
0,194,26,一番くじＷＣＦスター・ウォーズ※,7845,0.383056640625
0,152,27,一番くじＷＣＦスター・ウォーズ※,7997,0.390478515625
0,175,28,一番くじＷＣＦスター・ウォーズ※,8172,0.3990234375
0,176,29,一番くじＷＣＦスター・ウォーズ※,8348,0.4076171875
0,148,30,一番くじＷＣＦスター・ウォーズ※,8496,0.41484375
0,282,31,一番くじＷＣＦスター・ウォーズ※,8778,0.42861328125
0,174,32,一番くじＷＣＦスター・ウォーズ※,8952,0.437109375
0,175,33,一番くじＷＣＦスター・ウォーズ※,9127,0.445654296875
0,130,34,一番くじＷＣＦスター・ウォーズ※,9257,0.452001953125
0,214,35,一番くじＷＣＦスター・ウォーズ※,9471,0.462451171875
0,148,36,一番くじＷＣＦスター・ウォーズ※,9619,0.469677734375
0,121,37,一番くじＷＣＦスター・ウォーズ※,9740,0.4755859375
0,260,38,一番くじＷＣＦスター・ウォーズ※,10000,0.48828125
0,205,39,一番くじＷＣＦスター・ウォーズ※,10205,0.498291015625
0,113,40,一番くじＷＣＦスター・ウォーズ※,10318,0.50380859375
0,128,41,一番くじＷＣＦスター・ウォーズ※,10446,0.51005859375
0,123,42,一番くじＷＣＦスター・ウォーズ※,10569,0.516064453125
0,104,43,一番くじＷＣＦスター・ウォーズ※,10673,0.521142578125
0,126,44,一番くじＷＣＦスター・ウォーズ※,10799,0.527294921875
0,154,45,一番くじＷＣＦスター・ウォーズ※,10953,0.534814453125
0,138,46,一番くじＷＣＦスター・ウォーズ※,11091,0.541552734375
0,84,47,一番くじＷＣＦスター・ウォーズ※,11175,0.545654296875
0,83,48,一番くじＷＣＦスター・ウォーズ※,11258,0.54970703125
0,74,49,一番くじＷＣＦスター・ウォーズ※,11332,0.5533203125
0,108,50,一番くじＷＣＦスター・ウォーズ※,11440,0.55859375
0,65,51,一番くじＷＣＦスター・ウォーズ※,11505,0.561767578125
0,86,52,一番くじＷＣＦスター・ウォーズ※,11591,0.565966796875
0,128,53,一番くじＷＣＦスター・ウォーズ※,11719,0.572216796875
0,34,54,一番くじＷＣＦスター・ウォーズ※,11753,0.573876953125
0,45,55,一番くじＷＣＦスター・ウォーズ※,11798,0.57607421875
0,44,56,一番くじＷＣＦスター・ウォーズ※,11842,0.57822265625
0,47,57,一番くじＷＣＦスター・ウォーズ※,11889,0.580517578125
0,91,58,一番くじＷＣＦスター・ウォーズ※,11980,0.5849609375
0,85,59,一番くじＷＣＦスター・ウォーズ※,12065,0.589111328125
11000,45005,0,一番くじワンピースマリンフォード最終決戦編,45005,0.030003333333333333
740000,375151,1,一番くじワンピースマリンフォード最終決戦編,420156,0.280104
715700,400952,2,一番くじワンピースマリンフォード最終決戦編,821108,0.5474053333333333
0,166110,3,一番くじワンピースマリンフォード最終決戦編,987218,0.6581453333333334
0,135289,4,一番くじワンピースマリンフォード最終決戦編,1122507,0.748338
16300,81153,5,一番くじワンピースマリンフォード最終決戦編,1203660,0.80244
7400,46457,6,一番くじワンピースマリンフォード最終決戦編,1250117,0.8334113333333333
0,31877,7,一番くじワンピースマリンフォード最終決戦編,1281994,0.8546626666666667
7100,27646,8,一番くじワンピースマリンフォード最終決戦編,1309640,0.8730933333333334
0,23750,9,一番くじワンピースマリンフォード最終決戦編,1333390,0.8889266666666666
0,14586,10,一番くじワンピースマリンフォード最終決戦編,1347976,0.8986506666666667
200,11836,11,一番くじワンピースマリンフォード最終決戦編,1359812,0.9065413333333333
0,9315,12,一番くじワンピースマリンフォード最終決戦編,1369127,0.9127513333333334
0,6694,13,一番くじワンピースマリンフォード最終決戦編,1375821,0.917214
0,7492,14,一番くじワンピースマリンフォード最終決戦編,1383313,0.9222086666666667
0,6399,15,一番くじワンピースマリンフォード最終決戦編,1389712,0.9264746666666667
300,5090,16,一番くじワンピースマリンフォード最終決戦編,1394802,0.929868
0,3893,17,一番くじワンピースマリンフォード最終決戦編,1398695,0.9324633333333333
0,2977,18,一番くじワンピースマリンフォード最終決戦編,1401672,0.934448
0,2562,19,一番くじワンピースマリンフォード最終決戦編,1404234,0.936156
0,2296,20,一番くじワンピースマリンフォード最終決戦編,1406530,0.9376866666666667
100,2137,21,一番くじワンピースマリンフォード最終決戦編,1408667,0.9391113333333333
0,2251,22,一番くじワンピースマリンフォード最終決戦編,1410918,0.940612
0,1594,23,一番くじワンピースマリンフォード最終決戦編,1412512,0.9416746666666667
0,1375,24,一番くじワンピースマリンフォード最終決戦編,1413887,0.9425913333333333
0,1267,25,一番くじワンピースマリンフォード最終決戦編,1415154,0.943436
0,959,26,一番くじワンピースマリンフォード最終決戦編,1416113,0.9440753333333334
0,839,27,一番くじワンピースマリンフォード最終決戦編,1416952,0.9446346666666666
0,634,28,一番くじワンピースマリンフォード最終決戦編,1417586,0.9450573333333333
200,687,29,一番くじワンピースマリンフォード最終決戦編,1418273,0.9455153333333334
0,787,30,一番くじワンピースマリンフォード最終決戦編,1419060,0.94604
0,644,31,一番くじワンピースマリンフォード最終決戦編,1419704,0.9464693333333334
0,649,32,一番くじワンピースマリンフォード最終決戦編,1420353,0.946902
100,432,33,一番くじワンピースマリンフォード最終決戦編,1420785,0.94719
0,521,34,一番くじワンピースマリンフォード最終決戦編,1421306,0.9475373333333333
0,462,35,一番くじワンピースマリンフォード最終決戦編,1421768,0.9478453333333333
100,596,36,一番くじワンピースマリンフォード最終決戦編,1422364,0.9482426666666667
0,417,37,一番くじワンピースマリンフォード最終決戦編,1422781,0.9485206666666667
0,307,38,一番くじワンピースマリンフォード最終決戦編,1423088,0.9487253333333333
0,364,39,一番くじワンピースマリンフォード最終決戦編,1423452,0.948968
0,272,40,一番くじワンピースマリンフォード最終決戦編,1423724,0.9491493333333333
100,481,41,一番くじワンピースマリンフォード最終決戦編,1424205,0.94947
0,298,42,一番くじワンピースマリンフォード最終決戦編,1424503,0.9496686666666667
0,281,43,一番くじワンピースマリンフォード最終決戦編,1424784,0.949856
0,282,44,一番くじワンピースマリンフォード最終決戦編,1425066,0.950044
0,293,45,一番くじワンピースマリンフォード最終決戦編,1425359,0.9502393333333333
0,231,46,一番くじワンピースマリンフォード最終決戦編,1425590,0.9503933333333333
1300,188,47,一番くじワンピースマリンフォード最終決戦編,1425778,0.9505186666666666
0,267,48,一番くじワンピースマリンフォード最終決戦編,1426045,0.9506966666666666
0,237,49,一番くじワンピースマリンフォード最終決戦編,1426282,0.9508546666666666
0,147,50,一番くじワンピースマリンフォード最終決戦編,1426429,0.9509526666666667
0,118,51,一番くじワンピースマリンフォード最終決戦編,1426547,0.9510313333333333
0,179,52,一番くじワンピースマリンフォード最終決戦編,1426726,0.9511506666666667
0,171,53,一番くじワンピースマリンフォード最終決戦編,1426897,0.9512646666666666
0,184,54,一番くじワンピースマリンフォード最終決戦編,1427081,0.9513873333333334
0,178,55,一番くじワンピースマリンフォード最終決戦編,1427259,0.951506
0,96,56,一番くじワンピースマリンフォード最終決戦編,1427355,0.95157
0,100,57,一番くじワンピースマリンフォード最終決戦編,1427455,0.9516366666666667
0,78,58,一番くじワンピースマリンフォード最終決戦編,1427533,0.9516886666666666
0,66,59,一番くじワンピースマリンフォード最終決戦編,1427599,0.9517326666666667
0,15798,0,一番くじワンピースマリンフォード最終決戦編,15798,0.023404444444444443
334300,162704,1,一番くじワンピースマリンフォード最終決戦編,178502,0.2644474074074074
340550,236609,2,一番くじワンピースマリンフォード最終決戦編,415111,0.6149792592592592
150,106431,3,一番くじワンピースマリンフォード最終決戦編,521542,0.7726548148148148
0,41927,4,一番くじワンピースマリンフォード最終決戦編,563469,0.8347688888888889
0,24070,5,一番くじワンピースマリンフォード最終決戦編,587539,0.8704281481481482
0,16100,6,一番くじワンピースマリンフォード最終決戦編,603639,0.89428
0,11336,7,一番くじワンピースマリンフォード最終決戦編,614975,0.911074074074074
0,8308,8,一番くじワンピースマリンフォード最終決戦編,623283,0.9233822222222222
0,7291,9,一番くじワンピースマリンフォード最終決戦編,630574,0.9341837037037037
0,5337,10,一番くじワンピースマリンフォード最終決戦編,635911,0.9420903703703704
0,3576,11,一番くじワンピースマリンフォード最終決戦編,639487,0.9473881481481482
0,2248,12,一番くじワンピースマリンフォード最終決戦編,641735,0.9507185185185185
0,1568,13,一番くじワンピースマリンフォード最終決戦編,643303,0.9530414814814815
0,1788,14,一番くじワンピースマリンフォード最終決戦編,645091,0.9556903703703704
0,1940,15,一番くじワンピースマリンフォード最終決戦編,647031,0.9585644444444444
0,1249,16,一番くじワンピースマリンフォード最終決戦編,648280,0.9604148148148148
0,950,17,一番くじワンピースマリンフォード最終決戦編,649230,0.9618222222222222
0,675,18,一番くじワンピースマリンフォード最終決戦編,649905,0.9628222222222222
0,674,19,一番くじワンピースマリンフォード最終決戦編,650579,0.9638207407407408
0,594,20,一番くじワンピースマリンフォード最終決戦編,651173,0.9647007407407407
0,561,21,一番くじワンピースマリンフォード最終決戦編,651734,0.9655318518518519
0,632,22,一番くじワンピースマリンフォード最終決戦編,652366,0.9664681481481482
0,639,23,一番くじワンピースマリンフォード最終決戦編,653005,0.9674148148148148
0,525,24,一番くじワンピースマリンフォード最終決戦編,653530,0.9681925925925926
0,373,25,一番くじワンピースマリンフォード最終決戦編,653903,0.9687451851851852
0,300,26,一番くじワンピースマリンフォード最終決戦編,654203,0.9691896296296296
0,277,27,一番くじワンピースマリンフォード最終決戦編,654480,0.9696
0,287,28,一番くじワンピースマリンフォード最終決戦編,654767,0.9700251851851852
0,337,29,一番くじワンピースマリンフォード最終決戦編,655104,0.9705244444444444
0,471,30,一番くじワンピースマリンフォード最終決戦編,655575,0.9712222222222222
0,342,31,一番くじワンピースマリンフォード最終決戦編,655917,0.9717288888888889
0,273,32,一番くじワンピースマリンフォード最終決戦編,656190,0.9721333333333333
0,227,33,一番くじワンピースマリンフォード最終決戦編,656417,0.9724696296296297
0,212,34,一番くじワンピースマリンフォード最終決戦編,656629,0.9727837037037037
0,189,35,一番くじワンピースマリンフォード最終決戦編,656818,0.9730637037037037
0,273,36,一番くじワンピースマリンフォード最終決戦編,657091,0.9734681481481482
0,300,37,一番くじワンピースマリンフォード最終決戦編,657391,0.9739125925925926
0,202,38,一番くじワンピースマリンフォード最終決戦編,657593,0.9742118518518519
0,144,39,一番くじワンピースマリンフォード最終決戦編,657737,0.9744251851851852
0,171,40,一番くじワンピースマリンフォード最終決戦編,657908,0.9746785185185185
0,337,41,一番くじワンピースマリンフォード最終決戦編,658245,0.9751777777777778
0,176,42,一番くじワンピースマリンフォード最終決戦編,658421,0.9754385185185185
0,156,43,一番くじワンピースマリンフォード最終決戦編,658577,0.9756696296296297
0,191,44,一番くじワンピースマリンフォード最終決戦編,658768,0.9759525925925926
0,205,45,一番くじワンピースマリンフォード最終決戦編,658973,0.9762562962962963
3366,4230,0,一番くじスーパーマリオ３５ｔｈスペシャル,4230,0.007012901749743855
318120,66514,1,一番くじスーパーマリオ３５ｔｈスペシャル,70744,0.11728622254938044
281688,92228,2,一番くじスーパーマリオ３５ｔｈスペシャル,162972,0.27019069124332284
0,58037,3,一番くじスーパーマリオ３５ｔｈスペシャル,221009,0.36641002430476116
0,44658,4,一番くじスーパーマリオ３５ｔｈスペシャル,265667,0.4404483615009931
0,36595,5,一番くじスーパーマリオ３５ｔｈスペシャル,302262,0.5011190800664485
0,31666,6,一番くじスーパーマリオ３５ｔｈスペシャル,333928,0.5536180273022379
0,32394,7,一番くじスーパーマリオ３５ｔｈスペシャル,366322,0.6073239231133968
0,34621,8,一番くじスーパーマリオ３５ｔｈスペシャル,400943,0.6647219541956384
0,34484,9,一番くじスーパーマリオ３５ｔｈスペシャル,435427,0.7218928534718009
0,13678,10,一番くじスーパーマリオ３５ｔｈスペシャル,449105,0.744569560359034
0,12276,11,一番くじスーパーマリオ３５ｔｈスペシャル,461381,0.7649218965008439
0,16550,12,一番くじスーパーマリオ３５ｔｈスペシャル,477931,0.792360081833766
0,14427,13,一番くじスーパーマリオ３５ｔｈスペシャル,492358,0.8162785531206583
0,16346,14,一番くじスーパーマリオ３５ｔｈスペシャル,508704,0.8433785275890539
0,20595,15,一番くじスーパーマリオ３５ｔｈスペシャル,529299,0.8775229038386934
0,13775,16,一番くじスーパーマリオ３５ｔｈスペシャル,543074,0.9003604266762162
0,5730,17,一番くじスーパーマリオ３５ｔｈスペシャル,548804,0.9098601730180678
0,4743,18,一番くじスーパーマリオ３５ｔｈスペシャル,553547,0.9177235756183124
0,4480,19,一番くじスーパーマリオ３５ｔｈスペシャル,558027,0.925150951466741
0,5423,20,一番くじスーパーマリオ３５ｔｈスペシャル,563450,0.9341417236154078
0,3137,21,一番くじスーパーマリオ３５ｔｈスペシャル,566587,0.9393425446057025
0,3885,22,一番くじスーパーマリオ３５ｔｈスペシャル,570472,0.9457834720992616
0,3286,23,一番くじスーパーマリオ３５ｔｈスペシャル,573758,0.9512313196523723
0,1535,24,一番くじスーパーマリオ３５ｔｈスペシャル,575293,0.9537761906182959
0,1551,25,一番くじスーパーマリオ３５ｔｈスペシャル,576844,0.9563475879265353
0,1285,26,一番くじスーパーマリオ３５ｔｈスペシャル,578129,0.9584779847937742
0,1420,27,一番くじスーパーマリオ３５ｔｈスペシャル,579549,0.960832197674303
0,1366,28,一番くじスーパーマリオ３５ｔｈスペシャル,580915,0.9630968841495158
0,1928,29,一番くじスーパーマリオ３５ｔｈスペシャル,582843,0.9662933083985715
0,1589,30,一番くじスーパーマリオ３５ｔｈスペシャル,584432,0.968927705769811
0,841,31,一番くじスーパーマリオ３５ｔｈスペシャル,585273,0.9703219966377861
0,944,32,一番くじスーパーマリオ３５ｔｈスペシャル,586217,0.9718870508344193
0,608,33,一番くじスーパーマリオ３５ｔｈスペシャル,586825,0.9728950518424203
0,575,34,一番くじスーパーマリオ３５ｔｈスペシャル,587400,0.9738483422693949
0,669,35,一番くじスーパーマリオ３５ｔｈスペシャル,588069,0.974957474957475
0,872,36,一番くじスーパーマリオ３５ｔｈスペシャル,588941,0.9764031606136869
0,696,37,一番くじスーパーマリオ３５ｔｈスペシャル,589637,0.9775570565044249
0,348,38,一番くじスーパーマリオ３５ｔｈスペシャル,589985,0.9781340044497939
0,255,39,一番くじスーパーマリオ３５ｔｈスペシャル,590240,0.9785567680304522
0,356,40,一番くじスーパーマリオ３５ｔｈスペシャル,590596,0.9791469791469791
0,303,41,一番くじスーパーマリオ３５ｔｈスペシャル,590899,0.979649321754585
0,227,42,一番くじスーパーマリオ３５ｔｈスペシャル,591126,0.9800256642361905
0,342,43,一番くじスーパーマリオ３５ｔｈスペシャル,591468,0.9805926648031911
0,329,44,一番くじスーパーマリオ３５ｔｈスペシャル,591797,0.9811381127170601
0,167,45,一番くじスーパーマリオ３５ｔｈスペシャル,591964,0.9814149814149814
0,159,46,一番くじスーパーマリオ３５ｔｈスペシャル,592123,0.9816785869417448
0,157,47,一番くじスーパーマリオ３５ｔｈスペシャル,592280,0.9819388766757188
0,167,48,一番くじスーパーマリオ３５ｔｈスペシャル,592447,0.9822157453736401
0,211,49,一番くじスーパーマリオ３５ｔｈスペシャル,592658,0.98256556151293
0,254,50,一番くじスーパーマリオ３５ｔｈスペシャル,592912,0.9829866671971935
0,263,51,一番くじスーパーマリオ３５ｔｈスペシャル,593175,0.9834226939490097
0,167,52,一番くじスーパーマリオ３５ｔｈスペシャル,593342,0.983699562646931
0,109,53,一番くじスーパーマリオ３５ｔｈスペシャル,593451,0.9838802733539576
0,183,54,一番くじスーパーマリオ３５ｔｈスペシャル,593634,0.9841836683941947
0,127,55,一番くじスーパーマリオ３５ｔｈスペシャル,593761,0.9843942212363265
0,137,56,一番くじスーパーマリオ３５ｔｈスペシャル,593898,0.9846213530424057
0,200,57,一番くじスーパーマリオ３５ｔｈスペシャル,594098,0.9849529323213534
0,143,58,一番くじスーパーマリオ３５ｔｈスペシャル,594241,0.985190011505801
0,132,59,一番くじスーパーマリオ３５ｔｈスペシャル,594373,0.9854088538299065
0,6013,0,一番くじＡＫＢ４８クリスマスプレゼント,6013,0.00467907156263715
648480,54941,1,一番くじＡＫＢ４８クリスマスプレゼント,60954,0.04743191884732827
636364,109488,2,一番くじＡＫＢ４８クリスマスプレゼント,170442,0.13263101867270932
240,114958,3,一番くじＡＫＢ４８クリスマスプレゼント,285400,0.22208664958866503
0,109283,4,一番くじＡＫＢ４８クリスマスプレゼント,394683,0.3071262267680556
0,70501,5,一番くじＡＫＢ４８クリスマスプレゼント,465184,0.3619872319630468
0,59518,6,一番くじＡＫＢ４８クリスマスプレゼント,524702,0.40830171412919314
0,51423,7,一番くじＡＫＢ４８クリスマスプレゼント,576125,0.44831699717683826
0,46958,8,一番くじＡＫＢ４８クリスマスプレゼント,623083,0.4848577991788864
0,44227,9,一番くじＡＫＢ４８クリスマスプレゼント,667310,0.5192734482726421
0,47835,10,一番くじＡＫＢ４８クリスマスプレゼント,715145,0.5564966959358298
0,47043,11,一番くじＡＫＢ４８クリスマスプレゼント,762188,0.5931036414740204
0,41122,12,一番くじＡＫＢ４８クリスマスプレゼント,803310,0.6251031061004573
0,37632,13,一番くじＡＫＢ４８クリスマスプレゼント,840942,0.6543867949488127
0,31439,14,一番くじＡＫＢ４８クリスマスプレゼント,872381,0.6788513435697588
0,28093,15,一番くじＡＫＢ４８クリスマスプレゼント,900474,0.7007121713444413
0,25511,16,一番くじＡＫＢ４８クリスマスプレゼント,925985,0.7205637919388928
0,25049,17,一番くじＡＫＢ４８クリスマスプレゼント,951034,0.740055902960429
0,20013,18,一番くじＡＫＢ４８クリスマスプレゼント,971047,0.7556292040053413
0,19371,19,一番くじＡＫＢ４８クリスマスプレゼント,990418,0.7707029268125664
0,20455,20,一番くじＡＫＢ４８クリスマスプレゼント,1010873,0.786620174245419
0,16516,21,一番くじＡＫＢ４８クリスマスプレゼント,1027389,0.7994722523975086
0,13934,22,一番くじＡＫＢ４８クリスマスプレゼント,1041323,0.8103151233693673
0,11995,23,一番くじＡＫＢ４８クリスマスプレゼント,1053318,0.8196491435579308
0,11149,24,一番くじＡＫＢ４８クリスマスプレゼント,1064467,0.8283248410220655
0,9813,25,一番くじＡＫＢ４８クリスマスプレゼント,1074280,0.8359609177298916
0,8106,26,一番くじＡＫＢ４８クリスマスプレゼント,1082386,0.8422686766001288
0,7307,27,一番くじＡＫＢ４８クリスマスプレゼント,1089693,0.8479546862306278
0,6280,28,一番くじＡＫＢ４８クリスマスプレゼント,1095973,0.8528415263126768
0,5953,29,一番くじＡＫＢ４８クリスマスプレゼント,1101926,0.8574739083203899
0,5661,30,一番くじＡＫＢ４８クリスマスプレゼント,1107587,0.8618790678274728
0,6683,31,一番くじＡＫＢ４８クリスマスプレゼント,1114270,0.8670795060867617
0,5843,32,一番くじＡＫＢ４８クリスマスプレゼント,1120113,0.871626290577114
0,3913,33,一番くじＡＫＢ４８クリスマスプレゼント,1124026,0.8746712277174099
0,3535,34,一番くじＡＫＢ４８クリスマスプレゼント,1127561,0.8774220206616844
0,3419,35,一番くじＡＫＢ４８クリスマスプレゼント,1130980,0.8800825471331057
0,2871,36,一番くじＡＫＢ４８クリスマスプレゼント,1133851,0.8823166423362209
0,3260,37,一番くじＡＫＢ４８クリスマスプレゼント,1137111,0.8848534414870934
0,4140,38,一番くじＡＫＢ４８クリスマスプレゼント,1141251,0.888075020776852
0,3654,39,一番くじＡＫＢ４８クリスマスプレゼント,1144905,0.8909184146717257
0,2578,40,一番くじＡＫＢ４８クリスマスプレゼント,1147483,0.8929245092149618
0,2393,41,一番くじＡＫＢ４８クリスマスプレゼント,1149876,0.8947866442971821
0,2355,42,一番くじＡＫＢ４８クリスマスプレゼント,1152231,0.8966192093279506
0,2306,43,一番くじＡＫＢ４８クリスマスプレゼント,1154537,0.898413644555531
0,2766,44,一番くじＡＫＢ４８クリスマスプレゼント,1157303,0.900566033037529
0,2872,45,一番くじＡＫＢ４８クリスマスプレゼント,1160175,0.902800906399893
0,2659,46,一番くじＡＫＢ４８クリスマスプレゼント,1162834,0.9048700318422764
0,1751,47,一番くじＡＫＢ４８クリスマスプレゼント,1164585,0.9062325886868096
0,1533,48,一番くじＡＫＢ４８クリスマスプレゼント,1166118,0.9074255068151187
0,1606,49,一番くじＡＫＢ４８クリスマスプレゼント,1167724,0.9086752305685853
0,1824,50,一番くじＡＫＢ４８クリスマスプレゼント,1169548,0.9100945930382761
0,1282,51,一番くじＡＫＢ４８クリスマスプレゼント,1170830,0.911092193195153
0,1495,52,一番くじＡＫＢ４８クリスマスプレゼント,1172325,0.9122555412720103
0,1437,53,一番くじＡＫＢ４８クリスマスプレゼント,1173762,0.9133737561124409
0,841,54,一番くじＡＫＢ４８クリスマスプレゼント,1174603,0.9140281880406261
0,1024,55,一番くじＡＫＢ４８クリスマスプレゼント,1175627,0.9148250231113297
0,868,56,一番くじＡＫＢ４８クリスマスプレゼント,1176495,0.9155004653392308
0,958,57,一番くじＡＫＢ４８クリスマスプレゼント,1177453,0.9162459418995178
0,1073,58,一番くじＡＫＢ４８クリスマスプレゼント,1178526,0.9170809067734094
0,1107,59,一番くじＡＫＢ４８クリスマスプレゼント,1179633,0.9179423290617579
0,10766,0,一番くじラブライブサンシャインムービー,10766,0.011129719224248439
503400,142252,1,一番くじラブライブサンシャインムービー,153018,0.15818756978042425
463920,127572,2,一番くじラブライブサンシャインムービー,280590,0.290069470289046
0,57742,3,一番くじラブライブサンシャインムービー,338332,0.3497622296654675
0,41637,4,一番くじラブライブサンシャインムービー,379969,0.3928058967042964
0,35798,5,一番くじラブライブサンシャインムービー,415767,0.4298132985981888
0,28322,6,一番くじラブライブサンシャインムービー,444089,0.45909213083571104
0,23732,7,一番くじラブライブサンシャインムービー,467821,0.48362589422321467
0,24892,8,一番くじラブライブサンシャインムービー,492713,0.5093588471240127
0,19769,9,一番くじラブライブサンシャインムービー,512482,0.5297957242691147
0,14111,10,一番くじラブライブサンシャインムービー,526593,0.5443834511847165
0,13176,11,一番くじラブライブサンシャインムービー,539769,0.5580045900012406
0,11185,12,一番くじラブライブサンシャインムービー,550954,0.5695674647479635
0,10343,13,一番くじラブライブサンシャインムービー,561297,0.5802598933134847
0,12602,14,一番くじラブライブサンシャインムービー,573899,0.5932876400777406
0,12131,15,一番くじラブライブサンシャインムービー,586030,0.6058284745482364
0,11164,16,一番くじラブライブサンシャインムービー,597194,0.6173696398296323
0,9752,17,一番くじラブライブサンシャインムービー,606946,0.6274511020138114
0,9095,18,一番くじラブライブサンシャインムービー,616041,0.6368533680684778
0,8102,19,一番くじラブライブサンシャインムービー,624143,0.6452290865484017
0,8240,20,一番くじラブライブサンシャインムービー,632383,0.6537474672290452
0,8066,21,一番くじラブライブサンシャインムービー,640449,0.6620859694826945
0,8023,22,一番くじラブライブサンシャインムービー,648472,0.6703800190216268
0,7181,23,一番くじラブライブサンシャインムービー,655653,0.6778036223793574
0,5723,24,一番くじラブライブサンシャインムービー,661376,0.6837199685729645
0,6356,25,一番くじラブライブサンシャインムービー,667732,0.6902907000785676
0,6099,26,一番くじラブライブサンシャインムービー,673831,0.6965957490799322
0,5309,27,一番くじラブライブサンシャインムービー,679140,0.7020841086713807
0,7070,28,一番くじラブライブサンシャインムービー,686210,0.7093929619980979
0,8072,29,一番くじラブライブサンシャインムービー,694282,0.7177376669561262
0,6649,30,一番くじラブライブサンシャインムービー,700931,0.7246112971922425
0,5556,31,一番くじラブライブサンシャインムービー,706487,0.7303550014472977
0,4508,32,一番くじラブライブサンシャインムービー,710995,0.7350153000041352
0,4708,33,一番くじラブライブサンシャインムービー,715703,0.7398823553736096
0,4328,34,一番くじラブライブサンシャインムービー,720031,0.7443565727990737
0,4707,35,一番くじラブライブサンシャインムービー,724738,0.749222594384485
0,5865,36,一番くじラブライブサンシャインムービー,730603,0.7552857379150643
0,5739,37,一番くじラブライブサンシャインムービー,736342,0.7612186246536823
0,4349,38,一番くじラブライブサンシャインムービー,740691,0.7657145515444734
0,3884,39,一番くじラブライブサンシャインムービー,744575,0.7697297688458835
0,3659,40,一番くじラブライブサンシャインムービー,748234,0.7735123847330769
0,3200,41,一番くじラブライブサンシャインムービー,751434,0.7768204937352686
0,3498,42,一番くじラブライブサンシャインムービー,754932,0.7804366703882893
0,4074,43,一番くじラブライブサンシャインムービー,759006,0.7846483066617045
0,3584,44,一番くじラブライブサンシャインムービー,762590,0.7883533887441592
0,2838,45,一番くじラブライブサンシャインムービー,765428,0.7912872679154778
0,2955,46,一番くじラブライブサンシャインムービー,768383,0.7943420998221892
0,2551,47,一番くじラブライブサンシャインムービー,770934,0.7969792829673737
0,2566,48,一番くじラブライブサンシャインムービー,773500,0.7996319728735062
0,3474,49,一番くじラブライブサンシャインムービー,776974,0.8032233387090104
0,3759,50,一番くじラブライブサンシャインムービー,780733,0.8071093330025224
0,3283,51,一番くじラブライブサンシャインムービー,784016,0.8105032460819585
0,2459,52,一番くじラブライブサンシャインムービー,786475,0.81304532109333
0,2243,53,一番くじラブライブサンシャインムービー,788718,0.8153640987470537
0,1641,54,一番くじラブライブサンシャインムービー,790359,0.8170605383947401
0,1915,55,一番くじラブライブサンシャインムービー,792274,0.8190402348757392
0,2161,56,一番くじラブライブサンシャインムービー,794435,0.8212742422362816
0,2451,57,一番くじラブライブサンシャインムービー,796886,0.8238080469751479
0,2470,58,一番くじラブライブサンシャインムービー,799356,0.8263614936112145
0,2186,59,一番くじラブライブサンシャインムービー,801542,0.8286213455733367
70,2083,0,一番くじマリオカートnan,2083,0.002585778837082278
416500,24872,1,一番くじマリオカートnan,26955,0.03346119469685684
388710,41511,2,一番くじマリオカートnan,68466,0.0849918069417548
140,29692,3,一番くじマリオカートnan,98158,0.12185063806544516
0,27964,4,一番くじマリオカートnan,126122,0.15656437757584785
140,27010,5,一番くじマリオカートnan,153132,0.19009384775808133
0,25982,6,一番くじマリオカートnan,179114,0.22234718705000248
0,27872,7,一番くじマリオカートnan,206986,0.256946720293957
0,33473,8,一番くじマリオカートnan,240459,0.29849918069417547
0,31970,9,一番くじマリオカートnan,272429,0.3381858582849198
0,25945,10,一番くじマリオカートnan,298374,0.3703932667957694
0,21239,11,一番くじマリオカートnan,319613,0.39675877650330205
0,20832,12,一番くじマリオカートnan,340445,0.4226190476190476
0,19529,13,一番くじマリオカートnan,359974,0.4468618104175977
0,20454,14,一番くじマリオカートnan,380428,0.4722528427429366
0,21515,15,一番くじマリオカートnan,401943,0.4989609712498138
0,21957,16,一番くじマリオカートnan,423900,0.5262177863846268
0,20150,17,一番くじマリオカートnan,444050,0.5512314414817022
0,26240,18,一番くじマリオカートnan,470290,0.5838050548686627
0,20894,19,一番くじマリオカートnan,491184,0.6097422910770147
0,17176,20,一番くじマリオカートnan,508360,0.6310641044739064
0,14021,21,一番くじマリオカートnan,522381,0.648469387755102
0,12674,22,一番くじマリオカートnan,535055,0.6642025423308009
0,11178,23,一番くじマリオカートnan,546233,0.6780786037042554
0,8054,24,一番くじマリオカートnan,554287,0.6880766175083172
0,6972,25,一番くじマリオカートnan,561259,0.6967314663091514
0,6330,26,一番くじマリオカートnan,567589,0.7045893539897711
0,6352,27,一番くじマリオカートnan,573941,0.7124745518645414
0,7452,28,一番くじマリオカートnan,581393,0.7217252594468444
0,9952,29,一番くじマリオカートnan,591345,0.7340793981826307
0,10243,30,一番くじマリオカートnan,601588,0.7467947763046825
0,7734,31,一番くじマリオカートnan,609322,0.7563955509210983
0,4647,32,一番くじマリオカートnan,613969,0.7621642087491931
0,4853,33,一番くじマリオカートnan,618822,0.7681885893043349
0,4124,34,一番くじマリオカートnan,622946,0.7733080093351209
0,4598,35,一番くじマリオカートnan,627544,0.7790158399126074
0,7021,36,一番くじマリオカートnan,634565,0.7877315159640499
0,6638,37,一番くじマリオカートnan,641203,0.7959717463627787
0,3344,38,一番くじマリオカートnan,644547,0.8001228958736779
0,3250,39,一番くじマリオカートnan,647797,0.8041573563732062
0,3254,40,一番くじマリオカートnan,651051,0.8081967823625801
0,3053,41,一番くじマリオカートnan,654104,0.8119866924872139
0,4016,42,一番くじマリオカートnan,658120,0.8169720442921694
0,5349,43,一番くじマリオカートnan,663469,0.8236121455881623
0,4987,44,一番くじマリオカートnan,668456,0.8298028700531307
0,2371,45,一番くじマリオカートnan,670827,0.8327461641590943
0,2403,46,一番くじマリオカートnan,673230,0.8357291821838224
0,2529,47,一番くじマリオカートnan,675759,0.8388686131386861
0,2230,48,一番くじマリオカートnan,677989,0.8416368737275932
0,2550,49,一番くじマリオカートnan,680539,0.8448023735041462
0,3635,50,一番くじマリオカートnan,684174,0.8493147624013109
0,3409,51,一番くじマリオカートnan,687583,0.8535466011222007
0,1744,52,一番くじマリオカートnan,689327,0.8557115546948707
0,1610,53,一番くじマリオカートnan,690937,0.8577101643577139
0,1686,54,一番くじマリオカートnan,692623,0.859803118327623
0,1751,55,一番くじマリオカートnan,694374,0.8619767615075227
0,1817,56,一番くじマリオカートnan,696191,0.8642323352698744
0,2562,57,一番くじマリオカートnan,698753,0.8674127315159641
0,2530,58,一番くじマリオカートnan,701283,0.8705534038432892
0,1884,59,一番くじマリオカートnan,703167,0.8728921495605542
0,2083,0,一番くじミッキーマウス９０ｔｈ,2083,0.0026416577892761123
409680,28370,1,一番くじミッキーマウス９０ｔｈ,30453,0.038620453507837466
378660,44256,2,一番くじミッキーマウス９０ｔｈ,74709,0.09474585299041242
0,34423,3,一番くじミッキーマウス９０ｔｈ,109132,0.13840105514127732
0,29973,4,一番くじミッキーマウス９０ｔｈ,139105,0.1764127732968092
0,28343,5,一番くじミッキーマウス９０ｔｈ,167448,0.21235732765180337
0,28452,6,一番くじミッキーマウス９０ｔｈ,195900,0.24844011565971694
0,27070,7,一番くじミッキーマウス９０ｔｈ,222970,0.2827702531324507
0,31175,8,一番くじミッキーマウス９０ｔｈ,254145,0.3223063460660478
0,28662,9,一番くじミッキーマウス９０ｔｈ,282807,0.35865545579059505
0,18690,10,一番くじミッキーマウス９０ｔｈ,301497,0.38235808857099374
0,17599,11,一番くじミッキーマウス９０ｔｈ,319096,0.40467711662354794
0,16786,12,一番くじミッキーマウス９０ｔｈ,335882,0.42596509917313446
60,18901,13,一番くじミッキーマウス９０ｔｈ,354783,0.4499353218688175
60,20411,14,一番くじミッキーマウス９０ｔｈ,375194,0.4758205245269619
0,18498,15,一番くじミッキーマウス９０ｔｈ,393692,0.4992796631664384
0,15877,16,一番くじミッキーマウス９０ｔｈ,409569,0.5194148531425963
0,11934,17,一番くじミッキーマウス９０ｔｈ,421503,0.5345495358392939
0,11051,18,一番くじミッキーマウス９０ｔｈ,432554,0.5485643991274793
0,10564,19,一番くじミッキーマウス９０ｔｈ,443118,0.5619616496728047
0,10607,20,一番くじミッキーマウス９０ｔｈ,453725,0.5754134327601076
0,11348,21,一番くじミッキーマウス９０ｔｈ,465073,0.5898049510475321
0,14391,22,一番くじミッキーマウス９０ｔｈ,479464,0.6080555978288439
0,12129,23,一番くじミッキーマウス９０ｔｈ,491593,0.6234375792624157
0,7934,24,一番くじミッキーマウス９０ｔｈ,499527,0.6334994673565667
0,7406,25,一番くじミッキーマウス９０ｔｈ,506933,0.6428917465631817
0,7310,26,一番くじミッキーマウス９０ｔｈ,514243,0.6521622786993355
0,6262,27,一番くじミッキーマウス９０ｔｈ,520505,0.6601037386496221
0,6656,28,一番くじミッキーマウス９０ｔｈ,527161,0.6685448688682595
0,8261,29,一番くじミッキーマウス９０ｔｈ,535422,0.6790214579211687
0,6766,30,一番くじミッキーマウス９０ｔｈ,542188,0.6876020899913763
0,5318,31,一番くじミッキーマウス９０ｔｈ,547506,0.6943463704154619
0,5177,32,一番くじミッキーマウス９０ｔｈ,552683,0.7009118348298078
0,4573,33,一番くじミッキーマウス９０ｔｈ,557256,0.7067113072591691
0,4704,34,一番くじミッキーマウス９０ｔｈ,561960,0.7126769137117638
0,5612,35,一番くじミッキーマウス９０ｔｈ,567572,0.7197940445391366
60,6019,36,一番くじミッキーマウス９０ｔｈ,573591,0.7274273322173185
0,5367,37,一番くじミッキーマウス９０ｔｈ,578958,0.7342337543752854
0,4011,38,一番くじミッキーマウス９０ｔｈ,582969,0.7393204991629889
0,3696,39,一番くじミッキーマウス９０ｔｈ,586665,0.7440077613757419
0,3074,40,一番くじミッキーマウス９０ｔｈ,589739,0.747906204027799
0,3260,41,一番くじミッキーマウス９０ｔｈ,592999,0.7520405316288743
0,3363,42,一番くじミッキーマウス９０ｔｈ,596362,0.7563054836909654
0,4336,43,一番くじミッキーマウス９０ｔｈ,600698,0.7618043930401258
0,3844,44,一番くじミッキーマウス９０ｔｈ,604542,0.766679348653173
0,3589,45,一番くじミッキーマウス９０ｔｈ,608131,0.7712309136103079
0,3051,46,一番くじミッキーマウス９０ｔｈ,611182,0.7751001876934003
0,2900,47,一番くじミッキーマウス９０ｔｈ,614082,0.7787779637802466
0,2887,48,一番くじミッキーマウス９０ｔｈ,616969,0.7824392532846345
0,3293,49,一番くじミッキーマウス９０ｔｈ,620262,0.786615431441181
0,3469,50,一番くじミッキーマウス９０ｔｈ,623731,0.7910148125602394
0,2982,51,一番くじミッキーマウス９０ｔｈ,626713,0.7947965809364379
0,3289,52,一番くじミッキーマウス９０ｔｈ,630002,0.7989676862983818
0,3817,53,一番くじミッキーマウス９０ｔｈ,633819,0.8038084005478618
0,3001,54,一番くじミッキーマウス９０ｔｈ,636820,0.8076142646984223
0,2909,55,一番くじミッキーマウス９０ｔｈ,639729,0.8113034545731244
0,2490,56,一番くじミッキーマウス９０ｔｈ,642219,0.8144612692132096
0,2236,57,一番くじミッキーマウス９０ｔｈ,644455,0.817296961396033
0,2226,58,一番くじミッキーマウス９０ｔｈ,646681,0.8201199715923502
0,1714,59,一番くじミッキーマウス９０ｔｈ,648395,0.8222936640795414
0,1,0,一番くじ夏目友人帳～えんむすび物語～,1,0.00125
800,116,1,一番くじ夏目友人帳～えんむすび物語～,117,0.14625
0,70,2,一番くじ夏目友人帳～えんむすび物語～,187,0.23375
0,49,3,一番くじ夏目友人帳～えんむすび物語～,236,0.295
0,33,4,一番くじ夏目友人帳～えんむすび物語～,269,0.33625
0,35,5,一番くじ夏目友人帳～えんむすび物語～,304,0.38
0,40,6,一番くじ夏目友人帳～えんむすび物語～,344,0.43
0,26,7,一番くじ夏目友人帳～えんむすび物語～,370,0.4625
0,34,8,一番くじ夏目友人帳～えんむすび物語～,404,0.505
0,28,9,一番くじ夏目友人帳～えんむすび物語～,432,0.54
0,16,10,一番くじ夏目友人帳～えんむすび物語～,448,0.56
0,23,11,一番くじ夏目友人帳～えんむすび物語～,471,0.58875
0,7,12,一番くじ夏目友人帳～えんむすび物語～,478,0.5975
0,35,13,一番くじ夏目友人帳～えんむすび物語～,513,0.64125
0,29,14,一番くじ夏目友人帳～えんむすび物語～,542,0.6775
0,5,15,一番くじ夏目友人帳～えんむすび物語～,547,0.68375
0,33,16,一番くじ夏目友人帳～えんむすび物語～,580,0.725
0,9,17,一番くじ夏目友人帳～えんむすび物語～,589,0.73625
0,8,18,一番くじ夏目友人帳～えんむすび物語～,597,0.74625
0,2,19,一番くじ夏目友人帳～えんむすび物語～,599,0.74875
0,10,20,一番くじ夏目友人帳～えんむすび物語～,609,0.76125
0,20,21,一番くじ夏目友人帳～えんむすび物語～,629,0.78625
0,28,22,一番くじ夏目友人帳～えんむすび物語～,657,0.82125
0,9,23,一番くじ夏目友人帳～えんむすび物語～,666,0.8325
0,13,24,一番くじ夏目友人帳～えんむすび物語～,679,0.84875
0,19,25,一番くじ夏目友人帳～えんむすび物語～,698,0.8725
0,6,26,一番くじ夏目友人帳～えんむすび物語～,704,0.88
0,16,27,一番くじ夏目友人帳～えんむすび物語～,720,0.9
0,5,28,一番くじ夏目友人帳～えんむすび物語～,725,0.90625
0,9,29,一番くじ夏目友人帳～えんむすび物語～,734,0.9175
0,4,30,一番くじ夏目友人帳～えんむすび物語～,738,0.9225
0,3,31,一番くじ夏目友人帳～えんむすび物語～,741,0.92625
0,8,32,一番くじ夏目友人帳～えんむすび物語～,749,0.93625
0,1,33,一番くじ夏目友人帳～えんむすび物語～,750,0.9375
0,12,34,一番くじ夏目友人帳～えんむすび物語～,762,0.9525
0,0,35,一番くじ夏目友人帳～えんむすび物語～,762,0.9525
0,3,36,一番くじ夏目友人帳～えんむすび物語～,765,0.95625
0,0,37,一番くじ夏目友人帳～えんむすび物語～,765,0.95625
0,8,38,一番くじ夏目友人帳～えんむすび物語～,773,0.96625
0,0,39,一番くじ夏目友人帳～えんむすび物語～,773,0.96625
0,0,40,一番くじ夏目友人帳～えんむすび物語～,773,0.96625
0,2,41,一番くじ夏目友人帳～えんむすび物語～,775,0.96875
0,0,42,一番くじ夏目友人帳～えんむすび物語～,775,0.96875
0,5,43,一番くじ夏目友人帳～えんむすび物語～,780,0.975
0,2,44,一番くじ夏目友人帳～えんむすび物語～,782,0.9775
0,1,45,一番くじ夏目友人帳～えんむすび物語～,783,0.97875
0,0,46,一番くじ夏目友人帳～えんむすび物語～,783,0.97875
0,0,47,一番くじ夏目友人帳～えんむすび物語～,783,0.97875
0,0,48,一番くじ夏目友人帳～えんむすび物語～,783,0.97875
0,0,49,一番くじ夏目友人帳～えんむすび物語～,783,0.97875
0,0,50,一番くじ夏目友人帳～えんむすび物語～,783,0.97875
0,0,51,一番くじ夏目友人帳～えんむすび物語～,783,0.97875
0,0,52,一番くじ夏目友人帳～えんむすび物語～,783,0.97875
0,0,53,一番くじ夏目友人帳～えんむすび物語～,783,0.97875
0,1,54,一番くじ夏目友人帳～えんむすび物語～,784,0.98
0,0,55,一番くじ夏目友人帳～えんむすび物語～,784,0.98
0,0,56,一番くじ夏目友人帳～えんむすび物語～,784,0.98
0,0,57,一番くじ夏目友人帳～えんむすび物語～,784,0.98
0,0,58,一番くじ夏目友人帳～えんむすび物語～,784,0.98
0,0,59,一番くじ夏目友人帳～えんむすび物語～,784,0.98
0,1110,0,一番くじパズドラ３ｒｄＡｎｎｉｖｅｒｓａｒｙ,1110,0.0019892437468750058
269821,27799,1,一番くじパズドラ３ｒｄＡｎｎｉｖｅｒｓａｒｙ,28909,0.051808150881450035
288120,42656,2,一番くじパズドラ３ｒｄＡｎｎｉｖｅｒｓａｒｙ,71565,0.12825245832892773
60,49831,3,一番くじパズドラ３ｒｄＡｎｎｉｖｅｒｓａｒｙ,121396,0.2175551656717461
0,57399,4,一番くじパズドラ３ｒｄＡｎｎｉｖｅｒｓａｒｙ,178795,0.32042057272298796
0,39443,5,一番くじパズドラ３ｒｄＡｎｎｉｖｅｒｓａｒｙ,218238,0.39110682597343016
0,21532,6,一番くじパズドラ３ｒｄＡｎｎｉｖｅｒｓａｒｙ,239770,0.42969457043983794
0,20191,7,一番くじパズドラ３ｒｄＡｎｎｉｖｅｒｓａｒｙ,259961,0.46587909340664263
0,26530,8,一番くじパズドラ３ｒｄＡｎｎｉｖｅｒｓａｒｙ,286491,0.5134238110684389
0,13669,9,一番くじパズドラ３ｒｄＡｎｎｉｖｅｒｓａｒｙ,300160,0.5379201829387402
0,13395,10,一番くじパズドラ３ｒｄＡｎｎｉｖｅｒｓａｒｙ,313555,0.5619255162625156
0,18178,11,一番くじパズドラ３ｒｄＡｎｎｉｖｅｒｓａｒｙ,331733,0.5945025188126903
0,15534,12,一番くじパズドラ３ｒｄＡｎｎｉｖｅｒｓａｒｙ,347267,0.6223411786000383
0,8935,13,一番くじパズドラ３ｒｄＡｎｎｉｖｅｒｓａｒｙ,356202,0.6383536947066403
0,7490,14,一番くじパズドラ３ｒｄＡｎｎｉｖｅｒｓａｒｙ,363692,0.6517766097193374
0,7090,15,一番くじパズドラ３ｒｄＡｎｎｉｖｅｒｓａｒｙ,370782,0.664482680138566
0,7153,16,一番くじパズドラ３ｒｄＡｎｎｉｖｅｒｓａｒｙ,377935,0.677301653581266
0,7339,17,一番くじパズドラ３ｒｄＡｎｎｉｖｅｒｓａｒｙ,385274,0.6904539597599287
0,10817,18,一番くじパズドラ３ｒｄＡｎｎｉｖｅｒｓａｒｙ,396091,0.7098392296787999
0,8847,19,一番くじパズドラ３ｒｄＡｎｎｉｖｅｒｓａｒｙ,404938,0.7256940399748387
0,4807,20,一番くじパズドラ３ｒｄＡｎｎｉｖｅｒｓａｒｙ,409745,0.7343087198768461
0,4225,21,一番くじパズドラ３ｒｄＡｎｎｉｖｅｒｓａｒｙ,413970,0.7418803908953568
0,4986,22,一番くじパズドラ３ｒｄＡｎｎｉｖｅｒｓａｒｙ,418956,0.7508158587529413
0,4107,23,一番くじパズドラ３ｒｄＡｎｎｉｖｅｒｓａｒｙ,423063,0.7581760606163789
0,4731,24,一番くじパズドラ３ｒｄＡｎｎｉｖｅｒｓａｒｙ,427794,0.7666545400456272
0,6904,25,一番くじパズドラ３ｒｄＡｎｎｉｖｅｒｓａｒｙ,434698,0.7790272777288929
0,4939,26,一番くじパズドラ３ｒｄＡｎｎｉｖｅｒｓａｒｙ,439637,0.7878785163467449
0,3048,27,一番くじパズドラ３ｒｄＡｎｎｉｖｅｒｓａｒｙ,442685,0.7933408721489746
0,2610,28,一番くじパズドラ３ｒｄＡｎｎｉｖｅｒｓａｒｙ,445295,0.7980182831213564
0,2826,29,一番くじパズドラ３ｒｄＡｎｎｉｖｅｒｓａｒｙ,448121,0.8030827901742111
0,2743,30,一番くじパズドラ３ｒｄＡｎｎｉｖｅｒｓａｒｙ,450864,0.8079985519739212
0,2679,31,一番くじパズドラ３ｒｄＡｎｎｉｖｅｒｓａｒｙ,453543,0.8127996186386762
0,3411,32,一番くじパズドラ３ｒｄＡｎｎｉｖｅｒｓａｒｙ,456954,0.8189125109094787
0,2852,33,一番くじパズドラ３ｒｄＡｎｎｉｖｅｒｓａｒｙ,459806,0.8240236128609089
0,1553,34,一番くじパズドラ３ｒｄＡｎｎｉｖｅｒｓａｒｙ,461359,0.8268067619950502
0,1569,35,一番くじパズドラ３ｒｄＡｎｎｉｖｅｒｓａｒｙ,462928,0.8296185849129303
0,1543,36,一番くじパズドラ３ｒｄＡｎｎｉｖｅｒｓａｒｙ,464471,0.8323838129322348
0,1518,37,一番くじパズドラ３ｒｄＡｎｎｉｖｅｒｓａｒｙ,465989,0.8351042381644478
0,1750,38,一番くじパズドラ３ｒｄＡｎｎｉｖｅｒｓａｒｙ,467739,0.8382404332608723
0,2277,39,一番くじパズドラ３ｒｄＡｎｎｉｖｅｒｓａｒｙ,470016,0.8423210711091915
0,1962,40,一番くじパズドラ３ｒｄＡｎｎｉｖｅｒｓａｒｙ,471978,0.8458371938401544
0,1436,41,一番くじパズドラ３ｒｄＡｎｎｉｖｅｒｓａｒｙ,473414,0.8484106659307062
0,1398,42,一番くじパズドラ３ｒｄＡｎｎｉｖｅｒｓａｒｙ,474812,0.8509160377848786
0,1291,43,一番くじパズドラ３ｒｄＡｎｎｉｖｅｒｓａｒｙ,476103,0.853229653710298
0,1436,44,一番くじパズドラ３ｒｄＡｎｎｉｖｅｒｓａｒｙ,477539,0.8558031258008498
0,1771,45,一番くじパズドラ３ｒｄＡｎｎｉｖｅｒｓａｒｙ,479310,0.8589769552384314
0,1796,46,一番くじパズドラ３ｒｄＡｎｎｉｖｅｒｓａｒｙ,481106,0.8621955874631049
0,1550,47,一番くじパズドラ３ｒｄＡｎｎｉｖｅｒｓａｒｙ,482656,0.8649733602627953
0,1026,48,一番くじパズドラ３ｒｄＡｎｎｉｖｅｒｓａｒｙ,483682,0.8668120666450418
0,1076,49,一番くじパズドラ３ｒｄＡｎｎｉｖｅｒｓａｒｙ,484758,0.868740378601472
0,1263,50,一番くじパズドラ３ｒｄＡｎｎｉｖｅｒｓａｒｙ,486021,0.8710038154053488
0,1164,51,一番くじパズドラ３ｒｄＡｎｎｉｖｅｒｓａｒｙ,487185,0.873089833172342
0,1219,52,一番くじパズドラ３ｒｄＡｎｎｉｖｅｒｓａｒｙ,488404,0.8752744170709371
0,1493,53,一番くじパズドラ３ｒｄＡｎｎｉｖｅｒｓａｒｙ,489897,0.8779500395160582
0,1274,54,一番くじパズドラ３ｒｄＡｎｎｉｖｅｒｓａｒｙ,491171,0.8802331895462553
0,1187,55,一番くじパズドラ３ｒｄＡｎｎｉｖｅｒｓａｒｙ,492358,0.882360425877373
0,1124,56,一番くじパズドラ３ｒｄＡｎｎｉｖｅｒｓａｒｙ,493482,0.8843747591850194
0,944,57,一番くじパズドラ３ｒｄＡｎｎｉｖｅｒｓａｒｙ,494426,0.886066512425605
0,1003,58,一番くじパズドラ３ｒｄＡｎｎｉｖｅｒｓａｒｙ,495429,0.8878640002437271
0,943,59,一番くじパズドラ３ｒｄＡｎｎｉｖｅｒｓａｒｙ,496372,0.889553961372829
50,1607,0,一番くじミッキー＆ドナルドクリスマス,1607,0.002260222337241488
357500,22478,1,一番くじミッキー＆ドナルドクリスマス,24085,0.03387520534689561
353292,46292,2,一番くじミッキー＆ドナルドクリスマス,70377,0.09898423610954835
0,48599,3,一番くじミッキー＆ドナルドクリスマス,118976,0.16733802911987758
50,46269,4,一番くじミッキー＆ドナルドクリスマス,165245,0.2324147107140446
0,47471,5,一番くじミッキー＆ドナルドクリスマス,212716,0.2991819879829872
0,41919,6,一番くじミッキー＆ドナルドクリスマス,254635,0.3581404572765938
0,28522,7,一番くじミッキー＆ドナルドクリスマス,283157,0.398256239170061
0,27114,8,一番くじミッキー＆ドナルドクリスマス,310271,0.43639168935796746
0,25626,9,一番くじミッキー＆ドナルドクリスマス,335897,0.4724342889934064
50,22341,10,一番くじミッキー＆ドナルドクリスマス,358238,0.5038565834777325
0,21789,11,一番くじミッキー＆ドナルドクリスマス,380027,0.5345024979184013
50,23609,12,一番くじミッキー＆ドナルドクリスマス,403636,0.5677082161262011
0,20126,13,一番くじミッキー＆ドナルドクリスマス,423762,0.5960151450367936
0,13792,14,一番くじミッキー＆ドナルドクリスマス,437554,0.6154133942435358
0,12418,15,一番くじミッキー＆ドナルドクリスマス,449972,0.6328791322546526
0,10884,16,一番くじミッキー＆ドナルドクリスマス,460856,0.6481873213763305
0,10271,17,一番くじミッキー＆ドナルドクリスマス,471127,0.6626333348335847
0,10994,18,一番くじミッキー＆ドナルドクリスマス,482121,0.6780962373697594
0,12498,19,一番くじミッキー＆ドナルドクリスマス,494619,0.6956744942277832
0,12293,20,一番くじミッキー＆ドナルドクリスマス,506912,0.712964421540608
0,9743,21,一番くじミッキー＆ドナルドクリスマス,516655,0.7266678106082769
0,9043,22,一番くじミッキー＆ドナルドクリスマス,525698,0.7393866597655108
0,9958,23,一番くじミッキー＆ドナルドクリスマス,535656,0.7533924432342417
0,8379,24,一番くじミッキー＆ドナルドクリスマス,544035,0.7651773859621487
0,7043,25,一番くじミッキー＆ドナルドクリスマス,551078,0.7750832639467111
0,6242,26,一番くじミッキー＆ドナルドクリスマス,557320,0.7838625469766186
0,5752,27,一番くじミッキー＆ドナルドクリスマス,563072,0.7919526520692216
0,5749,28,一番くじミッキー＆ドナルドクリスマス,568821,0.8000385377050656
0,5337,29,一番くじミッキー＆ドナルドクリスマス,574158,0.8075449512793393
0,6414,30,一番くじミッキー＆ドナルドクリスマス,580572,0.8165661498300966
0,5219,31,一番くじミッキー＆ドナルドクリスマス,585791,0.8239065981051826
0,4574,32,一番くじミッキー＆ドナルドクリスマス,590365,0.8303398631770822
0,3851,33,一番くじミッキー＆ドナルドクリスマス,594216,0.835756239170061
0,3332,34,一番くじミッキー＆ドナルドクリスマス,597548,0.8404426491437316
0,2787,35,一番くじミッキー＆ドナルドクリスマス,600335,0.8443625244728492
0,2687,36,一番くじミッキー＆ドナルドクリスマス,603022,0.8481417512433332
0,2306,37,一番くじミッキー＆ドナルドクリスマス,605328,0.8513851070054234
0,2393,38,一番くじミッキー＆ドナルドクリスマス,607721,0.8547508270135248
0,2797,39,一番くじミッキー＆ドナルドクリスマス,610518,0.8586847671985057
0,3180,40,一番くじミッキー＆ドナルドクリスマス,613698,0.8631573913630534
0,2827,41,一番くじミッキー＆ドナルドクリスマス,616525,0.8671335261156243
0,2390,42,一番くじミッキー＆ドナルドクリスマス,618915,0.8704950266669668
0,1731,43,一番くじミッキー＆ドナルドクリスマス,620646,0.8729296532169138
0,1813,44,一番くじミッキー＆ドナルドクリスマス,622459,0.8754796115849405
0,1663,45,一番くじミッキー＆ドナルドクリスマス,624122,0.8778185971150168
0,1488,46,一番くじミッキー＆ドナルドクリスマス,625610,0.8799114476674843
0,1922,47,一番くじミッキー＆ドナルドクリスマス,627532,0.8826147129644215
0,1814,48,一番くじミッキー＆ドナルドクリスマス,629346,0.8851660778180345
0,1329,49,一番くじミッキー＆ドナルドクリスマス,630675,0.8870352971622747
0,1262,50,一番くじミッキー＆ドナルドクリスマス,631937,0.8888102819722303
0,1063,51,一番くじミッキー＆ドナルドクリスマス,633000,0.8903053761505052
0,1066,52,一番くじミッキー＆ドナルドクリスマス,634066,0.8918046897855391
0,1433,53,一番くじミッキー＆ドナルドクリスマス,635499,0.8938201836307581
0,1688,54,一番くじミッキー＆ドナルドクリスマス,637187,0.8961943313004929
0,1472,55,一番くじミッキー＆ドナルドクリスマス,638659,0.898264678083579
0,960,56,一番くじミッキー＆ドナルドクリスマス,639619,0.8996149042464613
0,833,57,一番くじミッキー＆ドナルドクリスマス,640452,0.9007865067398789
0,872,58,一番くじミッキー＆ドナルドクリスマス,641324,0.9020129621711637
0,772,59,一番くじミッキー＆ドナルドクリスマス,642096,0.9030987690438148
0,10920,0,一番くじスプラトゥーン,10920,0.022118695564107758
238550,142788,1,一番くじスプラトゥーン,153708,0.3113388697589629
255000,206175,2,一番くじスプラトゥーン,359883,0.7289507798258051
0,69382,3,一番くじスプラトゥーン,429265,0.8694855175207616
0,23183,4,一番くじスプラトゥーン,452448,0.9164431841199109
0,12615,5,一番くじスプラトゥーン,465063,0.9419951387482277
0,8133,6,一番くじスプラトゥーン,473196,0.9584687056917156
50,3589,7,一番くじスプラトゥーン,476785,0.9657383026129228
50,2893,8,一番くじスプラトゥーン,479678,0.9715981365201539
0,2627,9,一番くじスプラトゥーン,482305,0.976919181689285
0,1402,10,一番くじスプラトゥーン,483707,0.9797589629329553
0,787,11,一番くじスプラトゥーン,484494,0.9813530484099655
0,525,12,一番くじスプラトゥーン,485019,0.9824164472351631
0,390,13,一番くじスプラトゥーン,485409,0.9832064006481669
50,384,14,一番くじスプラトゥーン,485793,0.9839842009317399
0,617,15,一番くじスプラトゥーン,486410,0.9852339477415435
0,572,16,一番くじスプラトゥーン,486982,0.9863925460806158
0,364,17,一番くじスプラトゥーン,487346,0.9871298359327527
0,177,18,一番くじスプラトゥーン,487523,0.9874883532509621
0,106,19,一番くじスプラトゥーン,487629,0.9877030585375735
0,106,20,一番くじスプラトゥーン,487735,0.9879177638241847
0,86,21,一番くじスプラトゥーン,487821,0.98809195867936
0,173,22,一番くじスプラトゥーン,487994,0.9884423739112822
0,796,23,一番くじスプラトゥーン,488790,0.9900546890824388
0,64,24,一番くじスプラトゥーン,488854,0.9901843224630342
0,51,25,一番くじスプラトゥーン,488905,0.9902876240631963
0,26,26,一番くじスプラトゥーン,488931,0.9903402876240632
0,57,27,一番くじスプラトゥーン,488988,0.9904557423536561
0,19,28,一番くじスプラトゥーン,489007,0.9904942272635203
0,15,29,一番くじスプラトゥーン,489022,0.9905246100870975
0,25,30,一番くじスプラトゥーン,489047,0.9905752481263925
0,16,31,一番くじスプラトゥーン,489063,0.9906076564715415
0,9,32,一番くじスプラトゥーン,489072,0.9906258861656877
0,27,33,一番くじスプラトゥーン,489099,0.9906805752481264
0,6,34,一番くじスプラトゥーン,489105,0.9906927283775572
0,17,35,一番くじスプラトゥーン,489122,0.9907271622442779
0,82,36,一番くじスプラトゥーン,489204,0.9908932550131659
0,40,37,一番くじスプラトゥーン,489244,0.990974275876038
0,25,38,一番くじスプラトゥーン,489269,0.9910249139153332
0,10,39,一番くじスプラトゥーン,489279,0.9910451691310512
0,13,40,一番くじスプラトゥーン,489292,0.9910715009114847
0,9,41,一番くじスプラトゥーン,489301,0.991089730605631
0,6,42,一番くじスプラトゥーン,489307,0.9911018837350618
0,7,43,一番くじスプラトゥーン,489314,0.9911160623860644
0,6,44,一番くじスプラトゥーン,489320,0.9911282155154952
0,3,45,一番くじスプラトゥーン,489323,0.9911342920802106
0,31,46,一番くじスプラトゥーン,489354,0.9911970832489366
0,0,47,一番くじスプラトゥーン,489354,0.9911970832489366
0,0,48,一番くじスプラトゥーン,489354,0.9911970832489366
0,0,49,一番くじスプラトゥーン,489354,0.9911970832489366
0,6,50,一番くじスプラトゥーン,489360,0.9912092363783674
0,31,51,一番くじスプラトゥーン,489391,0.9912720275470934
0,7,52,一番くじスプラトゥーン,489398,0.991286206198096
0,6,53,一番くじスプラトゥーン,489404,0.9912983593275269
0,12,54,一番くじスプラトゥーン,489416,0.9913226655863885
0,4,55,一番くじスプラトゥーン,489420,0.9913307676726757
0,7,56,一番くじスプラトゥーン,489427,0.9913449463236783
0,7,57,一番くじスプラトゥーン,489434,0.9913591249746809
0,7,58,一番くじスプラトゥーン,489441,0.9913733036256837
0,16,59,一番くじスプラトゥーン,489457,0.9914057119708325
2574,960,0,一番くじガンダムシリーズアムロヒストリー,960,0.0029794048638784403
159918,9995,1,一番くじガンダムシリーズアムロヒストリー,10955,0.033999354462279495
159720,20288,2,一番くじガンダムシリーズアムロヒストリー,31243,0.0969641105855772
0,15366,3,一番くじガンダムシリーズアムロヒストリー,46609,0.14465320968803147
0,11836,4,一番くじガンダムシリーズアムロヒストリー,58445,0.18138678882226608
0,11081,5,一番くじガンダムシリーズアムロヒストリー,69526,0.21577719017292962
0,9649,6,一番くじガンダムシリーズアムロヒストリー,79175,0.24572331260164115
0,9277,7,一番くじガンダムシリーズアムロヒストリー,88452,0.27451491564559977
0,9826,8,一番くじガンダムシリーズアムロヒストリー,98278,0.3050103658460889
0,10565,9,一番くじガンダムシリーズアムロヒストリー,108843,0.33779933708241777
0,8696,10,一番くじガンダムシリーズアムロヒストリー,117539,0.36478777947438334
0,5542,11,一番くじガンダムシリーズアムロヒストリー,123081,0.3819876354698149
0,5771,12,一番くじガンダムシリーズアムロヒストリー,128852,0.39989820366715084
0,6302,13,一番くじガンダムシリーズアムロヒストリー,135154,0.4194567551798195
0,4605,14,一番くじガンダムシリーズアムロヒストリー,139759,0.4337485878862364
0,4928,15,一番くじガンダムシリーズアムロヒストリー,144687,0.4490428661874791
0,5586,16,一番くじガンダムシリーズアムロヒストリー,150273,0.46637927823917175
0,4932,17,一番くじガンダムシリーズアムロヒストリー,155205,0.4816859707273472
0,4390,18,一番くじガンダムシリーズアムロヒストリー,159595,0.49531054088612464
0,4345,19,一番くじガンダムシリーズアムロヒストリー,163940,0.5087954514419079
0,3659,20,一番くじガンダムシリーズアムロヒストリー,167599,0.5201513289387112
0,3972,21,一番くじガンダムシリーズアムロヒストリー,171571,0.5324786165630082
0,3879,22,一番くじガンダムシリーズアムロヒストリー,175450,0.5445172743411171
0,4611,23,一番くじガンダムシリーズアムロヒストリー,180061,0.5588277283279331
0,4199,24,一番くじガンダムシリーズアムロヒストリー,184260,0.5718595210606682
0,3178,25,一番くじガンダムシリーズアムロヒストリー,187438,0.5817225925787991
0,2736,26,一番くじガンダムシリーズアムロヒストリー,190174,0.5902138964408526
0,3010,27,一番くじガンダムシリーズアムロヒストリー,193184,0.5995555721078047
0,3145,28,一番くじガンダムシリーズアムロヒストリー,196329,0.6093162265837399
0,2874,29,一番くじガンダムシリーズアムロヒストリー,199203,0.618235819894976
0,2893,30,一番くじガンダムシリーズアムロヒストリー,202096,0.627214380594143
0,2655,31,一番くじガンダムシリーズアムロヒストリー,204751,0.6354542971708068
0,1823,32,一番くじガンダムシリーズアムロヒストリー,206574,0.6411120628654426
0,1610,33,一番くじガンダムシリーズアムロヒストリー,208184,0.6461087731059054
0,1787,34,一番くじガンダムシリーズアムロヒストリー,209971,0.6516548111181458
0,1604,35,一番くじガンダムシリーズアムロヒストリー,211575,0.6566329000782094
0,1892,36,一番くじガンダムシリーズアムロヒストリー,213467,0.6625048104974365
0,2437,37,一番くじガンダムシリーズアムロヒストリー,215904,0.6700681538862612
0,1980,38,一番くじガンダムシリーズアムロヒストリー,217884,0.6762131764180105
0,1507,39,一番くじガンダムシリーズアムロヒストリー,219391,0.680890221344953
0,1522,40,一番くじガンダムシリーズアムロヒストリー,220913,0.6856138194728936
0,1529,41,一番くじガンダムシリーズアムロヒストリー,222442,0.6903591424279667
0,1259,42,一番くじガンダムシリーズアムロヒストリー,223701,0.6942665077650739
0,1671,43,一番くじガンダムシリーズアムロヒストリー,225372,0.6994525343562623
0,2083,44,一番くじガンダムシリーズアムロヒストリー,227455,0.7059172222015319
0,1644,45,一番くじガンダムシリーズアムロヒストリー,229099,0.7110194530309237
0,1150,46,一番くじガンダムシリーズアムロヒストリー,230249,0.7145885317741114
0,1122,47,一番くじガンダムシリーズアムロヒストリー,231371,0.7180707112087694
0,1040,48,一番くじガンダムシリーズアムロヒストリー,232411,0.7212983998113044
0,1205,49,一番くじガンダムシリーズアムロヒストリー,233616,0.7250381736248185
0,1253,50,一番くじガンダムシリーズアムロヒストリー,234869,0.7289269176815264
0,1609,51,一番くじガンダムシリーズアムロヒストリー,236478,0.733920524375256
0,1450,52,一番くじガンダムシリーズアムロヒストリー,237928,0.7384206671384058
0,1153,53,一番くじガンダムシリーズアムロヒストリー,239081,0.7419990565217931
0,786,54,一番くじガンダムシリーズアムロヒストリー,239867,0.7444384442540936
0,810,55,一番くじガンダムシリーズアムロヒストリー,240677,0.746952317107991
0,929,56,一番くじガンダムシリーズアムロヒストリー,241606,0.74983551202314
0,1275,57,一番くじガンダムシリーズアムロヒストリー,242881,0.7537925341079786
0,1193,58,一番くじガンダムシリーズアムロヒストリー,244074,0.7574950653606942
0,1136,59,一番くじガンダムシリーズアムロヒストリー,245210,0.7610206944496171
0,2255,0,一番くじ美女と野獣ディズニープリンセス,2255,0.005336646550704058
202800,38243,1,一番くじ美女と野獣ディズニープリンセス,40498,0.09584191219973967
219650,68091,2,一番くじ美女と野獣ディズニープリンセス,108589,0.25698497219263994
50,49605,3,一番くじ美女と野獣ディズニープリンセス,158194,0.37437936338894806
0,32683,4,一番くじ美女と野獣ディズニープリンセス,190877,0.45172642290853154
0,28014,5,一番くじ美女と野獣ディズニープリンセス,218891,0.5180239024967459
50,26440,6,一番くじ美女と野獣ディズニープリンセス,245331,0.5805963791267306
0,22262,7,一番くじ美女と野獣ディズニープリンセス,267593,0.6332812684889362
0,17662,8,一番くじ美女と野獣ディズニープリンセス,285255,0.6750798722044729
0,14338,9,一番くじ美女と野獣ディズニープリンセス,299593,0.709011951248373
0,11075,10,一番くじ美女と野獣ディズニープリンセス,310668,0.7352218672346468
0,6957,11,一番くじ美女と野獣ディズニープリンセス,317625,0.7516861909833156
0,5896,12,一番くじ美女と野獣ディズニープリンセス,323521,0.7656395692817418
0,5915,13,一番くじ美女と野獣ディズニープリンセス,329436,0.7796379126730565
0,5017,14,一番くじ美女と野獣ディズニープリンセス,334453,0.7915110637794344
0,4938,15,一番くじ美女と野獣ディズニープリンセス,339391,0.80319725476275
0,5721,16,一番くじ美女と野獣ディズニープリンセス,345112,0.8167364808898355
0,5467,17,一番くじ美女と野獣ディズニープリンセス,350579,0.829674594722518
0,3109,18,一番くじ美女と野獣ディズニープリンセス,353688,0.8370323038693646
0,3066,19,一番くじ美女と野獣ディズニープリンセス,356754,0.8442882499112531
0,2728,20,一番くじ美女と野獣ディズニープリンセス,359482,0.850744290616495
0,2217,21,一番くじ美女と野獣ディズニープリンセス,361699,0.8559910069814223
0,2641,22,一番くじ美女と野獣ディズニープリンセス,364340,0.8622411548929121
0,3435,23,一番くじ美女と野獣ディズニープリンセス,367775,0.8703703703703703
0,2716,24,一番くじ美女と野獣ディズニープリンセス,370491,0.8767980120695775
0,3109,25,一番くじ美女と野獣ディズニープリンセス,373600,0.884155721216424
0,3066,26,一番くじ美女と野獣ディズニープリンセス,376666,0.8914116672583127
0,2728,27,一番くじ美女と野獣ディズニープリンセス,379394,0.8978677079635546
0,2217,28,一番くじ美女と野獣ディズニープリンセス,381611,0.9031144243284819
0,2641,29,一番くじ美女と野獣ディズニープリンセス,384252,0.9093645722399716
0,3435,30,一番くじ美女と野獣ディズニープリンセス,387687,0.9174937877174298
0,2716,31,一番くじ美女と野獣ディズニープリンセス,390403,0.9239214294166371
0,1884,32,一番くじ美女と野獣ディズニープリンセス,392287,0.9283800733640989
0,1491,33,一番くじ美女と野獣ディズニープリンセス,393778,0.9319086498639214
0,1374,34,一番くじ美女と野獣ディズニープリンセス,395152,0.9351603360549048
0,1508,35,一番くじ美女と野獣ディズニープリンセス,396660,0.9387291444799432
0,1476,36,一番くじ美女と野獣ディズニープリンセス,398136,0.9422222222222222
0,1960,37,一番くじ美女と野獣ディズニープリンセス,400096,0.9468607265412378
0,1761,38,一番くじ美女と野獣ディズニープリンセス,401857,0.951028280676843
0,1257,39,一番くじ美女と野獣ディズニープリンセス,403114,0.9540030765589871
0,893,40,一番くじ美女と野獣ディズニープリンセス,404007,0.9561164359247426
0,945,41,一番くじ美女と野獣ディズニープリンセス,404952,0.9583528576499822
0,763,42,一番くじ美女と野獣ディズニープリンセス,405715,0.9601585611170276
0,1034,43,一番くじ美女と野獣ディズニープリンセス,406749,0.9626056088036918
0,1257,44,一番くじ美女と野獣ディズニープリンセス,408006,0.965580404685836
0,1138,45,一番くじ美女と野獣ディズニープリンセス,409144,0.9682735770914684
0,693,46,一番くじ美女と野獣ディズニープリンセス,409837,0.9699136196899775
0,602,47,一番くじ美女と野獣ディズニープリンセス,410439,0.9713383031593894
0,495,48,一番くじ美女と野獣ディズニープリンセス,410934,0.9725097621583244
0,576,49,一番くじ美女と野獣ディズニープリンセス,411510,0.9738729144479943
0,762,50,一番くじ美女と野獣ディズニープリンセス,412272,0.9756762513312034
0,909,51,一番くじ美女と野獣ディズニープリンセス,413181,0.9778274760383386
0,819,52,一番くじ美女と野獣ディズニープリンセス,414000,0.979765708200213
0,443,53,一番くじ美女と野獣ディズニープリンセス,414443,0.9808141048396639
0,401,54,一番くじ美女と野獣ディズニープリンセス,414844,0.9817631049579931
0,400,55,一番くじ美女と野獣ディズニープリンセス,415244,0.9827097384924861
0,513,56,一番くじ美女と野獣ディズニープリンセス,415757,0.9839237960004733
0,531,57,一番くじ美女と野獣ディズニープリンセス,416288,0.9851804520175127
0,705,58,一番くじ美女と野獣ディズニープリンセス,416993,0.9868488936220565
0,603,59,一番くじ美女と野獣ディズニープリンセス,417596,0.9882759436753047
80,7788,0,一番くじワンピース２０ｔｈアニバーサリー,7788,0.006395348837209302
612000,117844,1,一番くじワンピース２０ｔｈアニバーサリー,125632,0.10316646958349757
605200,152039,2,一番くじワンピース２０ｔｈアニバーサリー,277671,0.2280178360268033
0,107875,3,一番くじワンピース２０ｔｈアニバーサリー,385546,0.31660261463671
80,87279,4,一番くじワンピース２０ｔｈアニバーサリー,472825,0.3882743726185784
160,73345,5,一番くじワンピース２０ｔｈアニバーサリー,546170,0.44850381027460257
80,64305,6,一番くじワンピース２０ｔｈアニバーサリー,610475,0.5013097818946262
0,62487,7,一番くじワンピース２０ｔｈアニバーサリー,672962,0.5526228485087373
80,67012,8,一番くじワンピース２０ｔｈアニバーサリー,739974,0.607651754040205
0,57096,9,一番くじワンピース２０ｔｈアニバーサリー,797070,0.6545378399684667
80,35269,10,一番くじワンピース２０ｔｈアニバーサリー,832339,0.6835000328471948
0,29362,11,一番くじワンピース２０ｔｈアニバーサリー,861701,0.7076115162265143
0,26366,12,一番くじワンピース２０ｔｈアニバーサリー,888067,0.7292627447116016
0,23355,13,一番くじワンピース２０ｔｈアニバーサリー,911422,0.7484414006043884
0,22182,14,一番くじワンピース２０ｔｈアニバーサリー,933604,0.7666568125082118
0,23888,15,一番くじワンピース２０ｔｈアニバーサリー,957492,0.7862731572723689
0,23770,16,一番くじワンピース２０ｔｈアニバーサリー,981262,0.8057926028117198
0,15982,17,一番くじワンピース２０ｔｈアニバーサリー,997244,0.8189166995138615
0,14329,18,一番くじワンピース２０ｔｈアニバーサリー,1011573,0.830683385888845
0,12709,19,一番くじワンピース２０ｔｈアニバーサリー,1024282,0.8411197608724215
0,12032,20,一番くじワンピース２０ｔｈアニバーサリー,1036314,0.8510001970831691
0,12724,21,一番くじワンピース２０ｔｈアニバーサリー,1049038,0.861448889764814
0,11699,22,一番くじワンピース２０ｔｈアニバーサリー,1060737,0.8710558730784391
0,10577,23,一番くじワンピース２０ｔｈアニバーサリー,1071314,0.879741492576534
0,11115,24,一番くじワンピース２０ｔｈアニバーサリー,1082429,0.8888689068453554
0,8471,25,一番くじワンピース２０ｔｈアニバーサリー,1090900,0.8958251215346209
0,7161,26,一番くじワンピース２０ｔｈアニバーサリー,1098061,0.9017055905925634
0,6179,27,一番くじワンピース２０ｔｈアニバーサリー,1104240,0.9067796610169492
0,5141,28,一番くじワンピース２０ｔｈアニバーサリー,1109381,0.9110013467349888
0,5294,29,一番くじワンピース２０ｔｈアニバーサリー,1114675,0.9153486729733281
0,4670,30,一番くじワンピース２０ｔｈアニバーサリー,1119345,0.9191835829720142
0,3411,31,一番くじワンピース２０ｔｈアニバーサリー,1122756,0.9219846275128104
0,2893,32,一番くじワンピース２０ｔｈアニバーサリー,1125649,0.9243603008803049
0,2651,33,一番くじワンピース２０ｔｈアニバーサリー,1128300,0.9265372487189594
0,2706,34,一番くじワンピース２０ｔｈアニバーサリー,1131006,0.9287593614505322
0,2730,35,一番くじワンピース２０ｔｈアニバーサリー,1133736,0.9310011824990145
0,3197,36,一番くじワンピース２０ｔｈアニバーサリー,1136933,0.9336264945473657
0,2883,37,一番くじワンピース２０ｔｈアニバーサリー,1139816,0.9359939561161477
0,1809,38,一番くじワンピース２０ｔｈアニバーサリー,1141625,0.937479470503219
0,1751,39,一番くじワンピース２０ｔｈアニバーサリー,1143376,0.9389173564577585
0,1754,40,一番くじワンピース２０ｔｈアニバーサリー,1145130,0.9403577059519117
0,1573,41,一番くじワンピース２０ｔｈアニバーサリー,1146703,0.9416494218893706
0,1712,42,一番くじワンピース２０ｔｈアニバーサリー,1148415,0.9430552818289318
0,2105,43,一番くじワンピース２０ｔｈアニバーサリー,1150520,0.94478386545789
0,2176,44,一番くじワンピース２０ｔｈアニバーサリー,1152696,0.946570752857706
0,1136,45,一番くじワンピース２０ｔｈアニバーサリー,1153832,0.9475036131914335
0,1165,46,一番くじワンピース２０ｔｈアニバーサリー,1154997,0.9484602877414269
0,1041,47,一番くじワンピース２０ｔｈアニバーサリー,1156038,0.9493151359873867
0,1340,48,一番くじワンピース２０ｔｈアニバーサリー,1157378,0.9504155170148469
0,1203,49,一番くじワンピース２０ｔｈアニバーサリー,1158581,0.9514033963999474
0,1620,50,一番くじワンピース２０ｔｈアニバーサリー,1160201,0.9527337077913546
0,1363,51,一番くじワンピース２０ｔｈアニバーサリー,1161564,0.9538529759558534
0,920,52,一番くじワンピース２０ｔｈアニバーサリー,1162484,0.9546084614373932
0,768,53,一番くじワンピース２０ｔｈアニバーサリー,1163252,0.9552391275785048
0,849,54,一番くじワンピース２０ｔｈアニバーサリー,1164101,0.9559363092891867
0,740,55,一番くじワンピース２０ｔｈアニバーサリー,1164841,0.9565439823939036
0,704,56,一番くじワンピース２０ｔｈアニバーサリー,1165545,0.9571220930232558
0,767,57,一番くじワンピース２０ｔｈアニバーサリー,1166312,0.9577519379844961
0,736,58,一番くじワンピース２０ｔｈアニバーサリー,1167048,0.958356326369728
0,482,59,一番くじワンピース２０ｔｈアニバーサリー,1167530,0.9587521350676652
132,2336,0,一番くじどうぶつの森2019,2336,0.004579961101700232
259776,52763,1,一番くじどうぶつの森2019,55099,0.10802708764665286
250008,70669,2,一番くじどうぶつの森2019,125768,0.2465807139720183
0,45196,3,一番くじどうぶつの森2019,170964,0.3351919819311124
0,36675,4,一番くじどうぶつの森2019,207639,0.4070969791078487
66,33392,5,一番くじどうぶつの森2019,241031,0.4725653271848924
0,31923,6,一番くじどうぶつの森2019,272954,0.5351535541752933
0,22862,7,一番くじどうぶつの森2019,295816,0.5799767864985256
0,24252,8,一番くじどうぶつの森2019,320068,0.6275252525252525
0,19862,9,一番くじどうぶつの森2019,339930,0.6664666854884246
0,15426,10,一番くじどうぶつの森2019,355356,0.6967108977978543
0,12384,11,一番くじどうぶつの森2019,367740,0.7209909655561829
0,11502,12,一番くじどうぶつの森2019,379242,0.7435417843026538
0,10434,13,一番くじどうぶつの森2019,389676,0.7639986824769434
0,9922,14,一番くじどうぶつの森2019,399598,0.7834517535604492
66,9557,15,一番くじどうぶつの森2019,409155,0.8021892057218144
0,8065,16,一番くじどうぶつの森2019,417220,0.818001443001443
0,5104,17,一番くじどうぶつの森2019,422324,0.8280083443126921
0,4314,18,一番くじどうぶつの森2019,426638,0.8364663717924588
0,4110,19,一番くじどうぶつの森2019,430748,0.8445244369157413
0,3788,20,一番くじどうぶつの森2019,434536,0.8519511889077106
0,3729,21,一番くじどうぶつの森2019,438265,0.8592622655122655
0,3917,22,一番くじどうぶつの森2019,442182,0.8669419348767174
0,3459,23,一番くじどうぶつの森2019,445641,0.8737236495388669
0,2016,24,一番くじどうぶつの森2019,447657,0.8776762187088274
0,1768,25,一番くじどうぶつの森2019,449425,0.8811425591316896
0,1493,26,一番くじどうぶつの森2019,450918,0.8840697346132129
0,1568,27,一番くじどうぶつの森2019,452486,0.8871439550787377
0,1667,28,一番くじどうぶつの森2019,454153,0.8904122749231445
0,2486,29,一番くじどうぶつの森2019,456639,0.8952863259928477
0,1949,30,一番くじどうぶつの森2019,458588,0.8991075349771002
0,1511,31,一番くじどうぶつの森2019,460099,0.9020700012547839
0,1254,32,一番くじどうぶつの森2019,461353,0.9045285933872891
0,1029,33,一番くじどうぶつの森2019,462382,0.9065460505677897
0,1071,34,一番くじどうぶつの森2019,463453,0.9086458529393312
0,1280,35,一番くじどうぶつの森2019,464733,0.9111554206662902
0,1553,36,一番くじどうぶつの森2019,466286,0.9142002321350148
0,1353,37,一番くじどうぶつの森2019,467639,0.9168529236464019
0,767,38,一番くじどうぶつの森2019,468406,0.9183567036827907
0,671,39,一番くじどうぶつの森2019,469077,0.9196722661396575
0,676,40,一番くじどうぶつの森2019,469753,0.9209976315954577
0,643,41,一番くじどうぶつの森2019,470396,0.9222582972582972
0,768,42,一番くじどうぶつの森2019,471164,0.9237640378944727
0,1094,43,一番くじどうぶつの森2019,472258,0.925908934061108
0,960,44,一番くじどうぶつの森2019,473218,0.9277911098563273
0,874,45,一番くじどうぶつの森2019,474092,0.9295046740698915
0,874,46,一番くじどうぶつの森2019,474966,0.9312182382834556
0,761,47,一番くじどうぶつの森2019,475727,0.9327102547211242
0,771,48,一番くじどうぶつの森2019,476498,0.9342218771566597
0,749,49,一番くじどうぶつの森2019,477247,0.9356903663968882
0,844,50,一番くじどうぶつの森2019,478091,0.9373451126168517
0,618,51,一番くじどうぶつの森2019,478709,0.9385567632850241
0,547,52,一番くじどうぶつの森2019,479256,0.9396292113683418
0,379,53,一番くじどうぶつの森2019,479635,0.9403722786874961
0,319,54,一番くじどうぶつの森2019,479954,0.9409977100194491
0,314,55,一番くじどうぶつの森2019,480268,0.9416133383524687
0,377,56,一番くじどうぶつの森2019,480645,0.9423524844720497
0,518,57,一番くじどうぶつの森2019,481163,0.9433680751615534
0,462,58,一番くじどうぶつの森2019,481625,0.9442738722630027
0,257,59,一番くじどうぶつの森2019,481882,0.9447777464081812
320,3401,0,一番くじ進撃の巨人くじ奪還作戦,3401,0.0026545426162972213
242160,40497,1,一番くじ進撃の巨人くじ奪還作戦,43898,0.034263190758663756
397600,111936,2,一番くじ進撃の巨人くじ奪還作戦,155834,0.12163128317202622
640720,231040,3,一番くじ進撃の巨人くじ奪還作戦,386874,0.3019622229160162
80,145852,4,一番くじ進撃の巨人くじ奪還作戦,532726,0.41580237277552295
0,124538,5,一番くじ進撃の巨人くじ奪還作戦,657264,0.5130065563534186
80,138876,6,一番くじ進撃の巨人くじ奪還作戦,796140,0.6214018108023728
0,97785,7,一番くじ進撃の巨人くじ奪還作戦,893925,0.6977247892600686
0,50411,8,一番くじ進撃の巨人くじ奪還作戦,944336,0.7370714954729941
0,41439,9,一番くじ進撃の巨人くじ奪還作戦,985775,0.7694153918201686
0,33853,10,一番くじ進撃の巨人くじ奪還作戦,1019628,0.7958382766156729
0,25440,11,一番くじ進撃の巨人くじ奪還作戦,1045068,0.8156946612550734
80,22489,12,一番くじ進撃の巨人くじ奪還作戦,1067557,0.833247736497034
0,28283,13,一番くじ進撃の巨人くじ奪還作戦,1095840,0.8553231345613488
0,21847,14,一番くじ進撃の巨人くじ奪還作戦,1117687,0.8723751170777396
0,11249,15,一番くじ進撃の巨人くじ奪還作戦,1128936,0.8811551670309086
0,8954,16,一番くじ進撃の巨人くじ奪還作戦,1137890,0.8881439275679051
0,8079,17,一番くじ進撃の巨人くじ奪還作戦,1145969,0.8944497346237902
0,7191,18,一番くじ進撃の巨人くじ奪還作戦,1153160,0.9000624414611302
0,8602,19,一番くじ進撃の巨人くじ奪還作戦,1161762,0.9067764595691539
0,9660,20,一番くじ進撃の巨人くじ奪還作戦,1171422,0.9143162660006244
0,8471,21,一番くじ進撃の巨人くじ奪還作戦,1179893,0.9209280362160475
0,5286,22,一番くじ進撃の巨人くじ奪還作戦,1185179,0.9250538557602248
0,5702,23,一番くじ進撃の巨人くじ奪還作戦,1190881,0.9295043709022791
0,4087,24,一番くじ進撃の巨人くじ奪還作戦,1194968,0.9326943490477677
0,2894,25,一番くじ進撃の巨人くじ奪還作戦,1197862,0.9349531689041524
0,3266,26,一番くじ進撃の巨人くじ奪還作戦,1201128,0.9375023415547924
0,4597,27,一番くじ進撃の巨人くじ奪還作戦,1205725,0.9410903840149859
0,4395,28,一番くじ進撃の巨人くじ奪還作戦,1210120,0.9445207617858258
0,3785,29,一番くじ進撃の巨人くじ奪還作戦,1213905,0.9474750234155479
0,3357,30,一番くじ進撃の巨人くじ奪還作戦,1217262,0.9500952232282236
80,1767,31,一番くじ進撃の巨人くじ奪還作戦,1219029,0.9514743990009367
0,1797,32,一番くじ進撃の巨人くじ奪還作戦,1220826,0.9528769903215735
0,1563,33,一番くじ進撃の巨人くじ奪還作戦,1222389,0.9540969403684046
0,2109,34,一番くじ進撃の巨人くじ奪還作戦,1224498,0.9557430533874492
80,2026,35,一番くじ進撃の巨人くじ奪還作戦,1226524,0.9573243833905714
0,1121,36,一番くじ進撃の巨人くじ奪還作戦,1227645,0.9581993443646581
0,968,37,一番くじ進撃の巨人くじ奪還作戦,1228613,0.9589548860443334
0,1247,38,一番くじ進撃の巨人くじ奪還作戦,1229860,0.9599281923197003
0,1202,39,一番くじ進撃の巨人くじ奪還作戦,1231062,0.9608663752731814
0,1313,40,一番くじ進撃の巨人くじ奪還作戦,1232375,0.9618911957539806
0,1562,41,一番くじ進撃の巨人くじ奪還作戦,1233937,0.9631103652825476
0,1418,42,一番くじ進撃の巨人くじ奪還作戦,1235355,0.9642171401810803
0,869,43,一番くじ進撃の巨人くじ奪還作戦,1236224,0.964895410552607
0,803,44,一番くじ進撃の巨人くじ奪還作戦,1237027,0.9655221667187012
0,900,45,一番くじ進撃の巨人くじ奪還作戦,1237927,0.9662246331564158
0,879,46,一番くじ進撃の巨人くじ奪還作戦,1238806,0.9669107087105838
0,944,47,一番くじ進撃の巨人くじ奪還作戦,1239750,0.96764751795192
0,950,48,一番くじ進撃の巨人くじ奪還作戦,1240700,0.9683890103028411
0,797,49,一番くじ進撃の巨人くじ奪還作戦,1241497,0.9690110833593506
0,452,50,一番くじ進撃の巨人くじ奪還作戦,1241949,0.9693638776147362
0,358,51,一番くじ進撃の巨人くじ奪還作戦,1242307,0.9696433031532938
0,356,52,一番くじ進撃の巨人くじ奪還作戦,1242663,0.9699211676553231
0,547,53,一番くじ進撃の巨人くじ奪還作戦,1243210,0.9703481111458008
0,420,54,一番くじ進撃の巨人くじ奪還作戦,1243630,0.9706759288167343
0,537,55,一番くじ進撃の巨人くじ奪還作戦,1244167,0.9710950671245707
0,425,56,一番くじ進撃の巨人くじ奪還作戦,1244592,0.9714267873868249
0,292,57,一番くじ進撃の巨人くじ奪還作戦,1244884,0.97165469871995
0,258,58,一番くじ進撃の巨人くじ奪還作戦,1245142,0.9718560724320949
0,265,59,一番くじ進撃の巨人くじ奪還作戦,1245407,0.9720629097720886
0,3681,0,一番くじエヴァンゲリオンアニバーサリー,3681,0.004834832862678137
378600,37592,1,一番くじエヴァンゲリオンアニバーサリー,41273,0.05421028436330203
382450,101157,2,一番くじエヴァンゲリオンアニバーサリー,142430,0.18707558941354174
150,81799,3,一番くじエヴァンゲリオンアニバーサリー,224229,0.2945150062389177
0,55382,4,一番くじエヴァンゲリオンアニバーサリー,279611,0.36725684639127865
50,54287,5,一番くじエヴァンゲリオンアニバーサリー,333898,0.438560451828988
0,38509,6,一番くじエヴァンゲリオンアニバーサリー,372407,0.48914034281211005
50,32575,7,一番くじエヴァンゲリオンアニバーサリー,404982,0.5319261837525449
0,29850,8,一番くじエヴァンゲリオンアニバーサリー,434832,0.5711328561108557
0,30901,9,一番くじエヴァンゲリオンアニバーサリー,465733,0.61171997110396
0,23942,10,一番くじエヴァンゲリオンアニバーサリー,489675,0.6431667432849544
0,16989,11,一番くじエヴァンゲリオンアニバーサリー,506664,0.665481053392001
0,16396,12,一番くじエヴァンゲリオンアニバーサリー,523060,0.6870164838773232
50,15113,13,一番くじエヴァンゲリオンアニバーサリー,538173,0.7068667498522362
0,12430,14,一番くじエヴァンゲリオンアニバーサリー,550603,0.7231930124121626
0,12297,15,一番くじエヴァンゲリオンアニバーサリー,562900,0.7393445852761542
0,11541,16,一番くじエヴァンゲリオンアニバーサリー,574441,0.754503185131674
0,9653,17,一番くじエヴァンゲリオンアニバーサリー,584094,0.7671819793787351
0,7371,18,一番くじエヴァンゲリオンアニバーサリー,591465,0.7768634662113352
0,5900,19,一番くじエヴァンゲリオンアニバーサリー,597365,0.7846128587377684
0,5002,20,一番くじエヴァンゲリオンアニバーサリー,602367,0.7911827674525513
0,5755,21,一番くじエヴァンゲリオンアニバーサリー,608122,0.7987417088067249
0,6044,22,一番くじエヴァンゲリオンアニバーサリー,614166,0.8066802390490576
0,6948,23,一番くじエヴァンゲリオンアニバーサリー,621114,0.8158061338412032
0,6329,24,一番くじエヴァンゲリオンアニバーサリー,627443,0.8241189991462534
0,4972,25,一番くじエヴァンゲリオンアニバーサリー,632415,0.830649504170224
0,3846,26,一番くじエヴァンゲリオンアニバーサリー,636261,0.8357010573323701
0,4626,27,一番くじエヴァンゲリオンアニバーサリー,640887,0.841777106455638
0,4047,28,一番くじエヴァンゲリオンアニバーサリー,644934,0.8470926643462271
0,3644,29,一番くじエヴァンゲリオンアニバーサリー,648578,0.85187889932357
0,4668,30,一番くじエヴァンゲリオンアニバーサリー,653246,0.8580101136139752
0,4026,31,一番くじエヴァンゲリオンアニバーサリー,657272,0.8632980889209956
0,2793,32,一番くじエヴァンゲリオンアニバーサリー,660065,0.8669665725356275
0,2223,33,一番くじエヴァンゲリオンアニバーサリー,662288,0.8698863860248244
0,2435,34,一番くじエヴァンゲリオンアニバーサリー,664723,0.8730846522624286
0,1799,35,一番くじエヴァンゲリオンアニバーサリー,666522,0.8754475602548105
0,1871,36,一番くじエヴァンゲリオンアニバーサリー,668393,0.8779050371051422
0,2432,37,一番くじエヴァンゲリオンアニバーサリー,670825,0.8810993629736652
0,1904,38,一番くじエヴァンゲリオンアニバーサリー,672729,0.8836001838838905
0,1563,39,一番くじエヴァンゲリオンアニバーサリー,674292,0.885653116175215
0,1329,40,一番くじエヴァンゲリオンアニバーサリー,675621,0.8873986996782032
0,1300,41,一番くじエヴァンゲリオンアニバーサリー,676921,0.8891061929467393
0,1481,42,一番くじエヴァンゲリオンアニバーサリー,678402,0.8910514218165101
0,1537,43,一番くじエヴァンゲリオンアニバーサリー,679939,0.8930702042424641
0,1755,44,一番くじエヴァンゲリオンアニバーサリー,681694,0.8953753201549879
0,1521,45,一番くじエヴァンゲリオンアニバーサリー,683215,0.8973730872791752
0,1032,46,一番くじエヴァンゲリオンアニバーサリー,684247,0.8987285742431208
0,1005,47,一番くじエヴァンゲリオンアニバーサリー,685252,0.9000485978853353
0,1218,48,一番くじエヴァンゲリオンアニバーサリー,686470,0.9016483877323176
0,895,49,一番くじエヴァンゲリオンアニバーサリー,687365,0.9028239311748867
0,1065,50,一番くじエヴァンゲリオンアニバーサリー,688430,0.904222762198726
0,1150,51,一番くじエヴァンゲリオンアニバーサリー,689580,0.9057332370132002
0,1025,52,一番くじエヴァンゲリオンアニバーサリー,690605,0.907079529782623
0,751,53,一番くじエヴァンゲリオンアニバーサリー,691356,0.9080659355092927
0,775,54,一番くじエヴァンゲリオンアニバーサリー,692131,0.9090838641886123
0,694,55,一番くじエヴァンゲリオンアニバーサリー,692825,0.9099954029027385
0,524,56,一番くじエヴァンゲリオンアニバーサリー,693349,0.9106836540355947
0,816,57,一番くじエヴァンゲリオンアニバーサリー,694165,0.9117554344256912
0,694,58,一番くじエヴァンゲリオンアニバーサリー,694859,0.9126669731398175
0,676,59,一番くじエヴァンゲリオンアニバーサリー,695535,0.9135548696394562
0,83,0,ポケモンマスコットピカチュウパン屋さん,83,0.0029184247538677917
14760,1497,1,ポケモンマスコットピカチュウパン屋さん,1580,0.05555555555555555
13680,1805,2,ポケモンマスコットピカチュウパン屋さん,3385,0.1190225035161744
0,1448,3,ポケモンマスコットピカチュウパン屋さん,4833,0.16993670886075948
0,1200,4,ポケモンマスコットピカチュウパン屋さん,6033,0.21213080168776371
0,1118,5,ポケモンマスコットピカチュウパン屋さん,7151,0.25144163150492266
0,1197,6,ポケモンマスコットピカチュウパン屋さん,8348,0.29353023909985937
0,1021,7,ポケモンマスコットピカチュウパン屋さん,9369,0.3294303797468354
0,966,8,ポケモンマスコットピカチュウパン屋さん,10335,0.3633966244725738
0,770,9,ポケモンマスコットピカチュウパン屋さん,11105,0.39047116736990156
0,544,10,ポケモンマスコットピカチュウパン屋さん,11649,0.40959915611814346
0,495,11,ポケモンマスコットピカチュウパン屋さん,12144,0.4270042194092827
0,478,12,ポケモンマスコットピカチュウパン屋さん,12622,0.4438115330520394
0,485,13,ポケモンマスコットピカチュウパン屋さん,13107,0.4608649789029536
0,556,14,ポケモンマスコットピカチュウパン屋さん,13663,0.48041490857946556
0,630,15,ポケモンマスコットピカチュウパン屋さん,14293,0.5025668073136428
0,487,16,ポケモンマスコットピカチュウパン屋さん,14780,0.519690576652602
0,303,17,ポケモンマスコットピカチュウパン屋さん,15083,0.5303445850914206
0,259,18,ポケモンマスコットピカチュウパン屋さん,15342,0.5394514767932489
0,310,19,ポケモンマスコットピカチュウパン屋さん,15652,0.550351617440225
0,248,20,ポケモンマスコットピカチュウパン屋さん,15900,0.5590717299578059
0,301,21,ポケモンマスコットピカチュウパン屋さん,16201,0.5696554149085795
0,363,22,ポケモンマスコットピカチュウパン屋さん,16564,0.5824191279887483
0,279,23,ポケモンマスコットピカチュウパン屋さん,16843,0.5922292545710267
0,208,24,ポケモンマスコットピカチュウパン屋さん,17051,0.5995428973277075
0,190,25,ポケモンマスコットピカチュウパン屋さん,17241,0.6062236286919831
0,179,26,ポケモンマスコットピカチュウパン屋さん,17420,0.6125175808720112
0,204,27,ポケモンマスコットピカチュウパン屋さん,17624,0.619690576652602
0,240,28,ポケモンマスコットピカチュウパン屋さん,17864,0.6281293952180028
0,309,29,ポケモンマスコットピカチュウパン屋さん,18173,0.6389943741209564
0,235,30,ポケモンマスコットピカチュウパン屋さん,18408,0.6472573839662448
0,159,31,ポケモンマスコットピカチュウパン屋さん,18567,0.6528481012658228
0,136,32,ポケモンマスコットピカチュウパン屋さん,18703,0.6576300984528832
0,146,33,ポケモンマスコットピカチュウパン屋さん,18849,0.6627637130801688
0,139,34,ポケモンマスコットピカチュウパン屋さん,18988,0.6676511954992967
0,193,35,ポケモンマスコットピカチュウパン屋さん,19181,0.6744374120956399
0,201,36,ポケモンマスコットピカチュウパン屋さん,19382,0.6815049226441632
0,229,37,ポケモンマスコットピカチュウパン屋さん,19611,0.6895569620253165
0,184,38,ポケモンマスコットピカチュウパン屋さん,19795,0.6960267229254571
0,195,39,ポケモンマスコットピカチュウパン屋さん,19990,0.7028832630098453
0,133,40,ポケモンマスコットピカチュウパン屋さん,20123,0.7075597749648382
0,155,41,ポケモンマスコットピカチュウパン屋さん,20278,0.7130098452883263
0,191,42,ポケモンマスコットピカチュウパン屋さん,20469,0.7197257383966245
0,142,43,ポケモンマスコットピカチュウパン屋さん,20611,0.72471870604782
0,169,44,ポケモンマスコットピカチュウパン屋さん,20780,0.7306610407876231
0,195,45,ポケモンマスコットピカチュウパン屋さん,20975,0.7375175808720112
0,248,46,ポケモンマスコットピカチュウパン屋さん,21223,0.7462376933895921
0,202,47,ポケモンマスコットピカチュウパン屋さん,21425,0.7533403656821378
0,166,48,ポケモンマスコットピカチュウパン屋さん,21591,0.7591772151898735
0,129,49,ポケモンマスコットピカチュウパン屋さん,21720,0.7637130801687764
0,128,50,ポケモンマスコットピカチュウパン屋さん,21848,0.7682137834036569
0,123,51,ポケモンマスコットピカチュウパン屋さん,21971,0.7725386779184248
0,101,52,ポケモンマスコットピカチュウパン屋さん,22072,0.7760900140646976
0,71,53,ポケモンマスコットピカチュウパン屋さん,22143,0.7785864978902953
0,94,54,ポケモンマスコットピカチュウパン屋さん,22237,0.7818917018284107
0,87,55,ポケモンマスコットピカチュウパン屋さん,22324,0.7849507735583685
0,99,56,ポケモンマスコットピカチュウパン屋さん,22423,0.7884317862165964
0,141,57,ポケモンマスコットピカチュウパン屋さん,22564,0.7933895921237694
0,160,58,ポケモンマスコットピカチュウパン屋さん,22724,0.7990154711673699
0,102,59,ポケモンマスコットピカチュウパン屋さん,22826,0.8026019690576652
0,626,0,一番くじゼルダの伝説ハイラルライフスタイル,626,0.0024294640431559746
121800,10163,1,一番くじゼルダの伝説ハイラルライフスタイル,10789,0.04187138588116583
135800,54061,2,一番くじゼルダの伝説ハイラルライフスタイル,64850,0.25167850351224436
0,56719,3,一番くじゼルダの伝説ハイラルライフスタイル,121569,0.47180114099429504
0,39312,4,一番くじゼルダの伝説ハイラルライフスタイル,160881,0.6243683781581092
0,24006,5,一番くじゼルダの伝説ハイラルライフスタイル,184887,0.717534055186867
0,14131,6,一番くじゼルダの伝説ハイラルライフスタイル,199018,0.7723755190747856
0,10644,7,一番くじゼルダの伝説ハイラルライフスタイル,209662,0.8136841696743897
0,7715,8,一番くじゼルダの伝説ハイラルライフスタイル,217377,0.8436255675864478
0,7452,9,一番くじゼルダの伝説ハイラルライフスタイル,224829,0.8725462801257422
0,5654,10,一番くじゼルダの伝説ハイラルライフスタイル,230483,0.8944890751736717
0,2737,11,一番くじゼルダの伝説ハイラルライフスタイル,233220,0.9051111887297706
0,2130,12,一番くじゼルダの伝説ハイラルライフスタイル,235350,0.9133775759692631
0,1966,13,一番くじゼルダの伝説ハイラルライフスタイル,237316,0.9210074902006442
0,1402,14,一番くじゼルダの伝説ハイラルライフスタイル,238718,0.9264485582333993
70,1288,15,一番くじゼルダの伝説ハイラルライフスタイル,240006,0.9314471999068576
0,1508,16,一番くじゼルダの伝説ハイラルライフスタイル,241514,0.9372996468350991
0,1368,17,一番くじゼルダの伝説ハイラルライフスタイル,242882,0.9426087631466604
0,720,18,一番くじゼルダの伝説ハイラルライフスタイル,243602,0.9454030348895874
0,559,19,一番くじゼルダの伝説ハイラルライフスタイル,244161,0.9475724764233322
0,811,20,一番くじゼルダの伝説ハイラルライフスタイル,244972,0.9507199130671014
0,649,21,一番くじゼルダの伝説ハイラルライフスタイル,245621,0.9532386385687119
0,700,22,一番くじゼルダの伝説ハイラルライフスタイル,246321,0.9559552916521131
0,827,23,一番くじゼルダの伝説ハイラルライフスタイル,247148,0.9591648232235029
0,687,24,一番くじゼルダの伝説ハイラルライフスタイル,247835,0.9618310241782124
0,405,25,一番くじゼルダの伝説ハイラルライフスタイル,248240,0.9634028020336088
0,352,26,一番くじゼルダの伝説ハイラルライフスタイル,248592,0.9647688904412621
0,304,27,一番くじゼルダの伝説ハイラルライフスタイル,248896,0.9659486940660534
0,256,28,一番くじゼルダの伝説ハイラルライフスタイル,249152,0.9669422129079831
0,291,29,一番くじゼルダの伝説ハイラルライフスタイル,249443,0.9680715644040827
0,447,30,一番くじゼルダの伝説ハイラルライフスタイル,249890,0.9698063414444833
0,355,31,一番くじゼルダの伝説ハイラルライフスタイル,250245,0.9711840726510653
0,158,32,一番くじゼルダの伝説ハイラルライフスタイル,250403,0.9717972600613187
0,190,33,一番くじゼルダの伝説ハイラルライフスタイル,250593,0.9725346373268133
0,142,34,一番くじゼルダの伝説ハイラルライフスタイル,250735,0.9730857298094462
0,145,35,一番くじゼルダの伝説ハイラルライフスタイル,250880,0.9736484650910079
0,177,36,一番くじゼルダの伝説ハイラルライフスタイル,251057,0.9743353902278108
0,181,37,一番くじゼルダの伝説ハイラルライフスタイル,251238,0.9750378390965188
0,151,38,一番くじゼルダの伝説ハイラルライフスタイル,251389,0.9756238599759383
0,120,39,一番くじゼルダの伝説ハイラルライフスタイル,251509,0.9760895719330928
0,117,40,一番くじゼルダの伝説ハイラルライフスタイル,251626,0.9765436410913183
0,97,41,一番くじゼルダの伝説ハイラルライフスタイル,251723,0.9769200915900182
0,81,42,一番くじゼルダの伝説ハイラルライフスタイル,251804,0.9772344471610975
0,57,43,一番くじゼルダの伝説ハイラルライフスタイル,251861,0.9774556603407459
0,118,44,一番くじゼルダの伝説ハイラルライフスタイル,251979,0.9779136104319478
0,185,45,一番くじゼルダの伝説ハイラルライフスタイル,252164,0.978631583032561
0,66,46,一番くじゼルダの伝説ハイラルライフスタイル,252230,0.978887724608996
0,42,47,一番くじゼルダの伝説ハイラルライフスタイル,252272,0.979050723794
0,73,48,一番くじゼルダの伝説ハイラルライフスタイル,252345,0.9793340319012691
0,40,49,一番くじゼルダの伝説ハイラルライフスタイル,252385,0.9794892692203205
0,40,50,一番くじゼルダの伝説ハイラルライフスタイル,252425,0.9796445065393721
0,51,51,一番くじゼルダの伝説ハイラルライフスタイル,252476,0.9798424341211627
0,48,52,一番くじゼルダの伝説ハイラルライフスタイル,252524,0.9800287189040245
0,66,53,一番くじゼルダの伝説ハイラルライフスタイル,252590,0.9802848604804595
0,24,54,一番くじゼルダの伝説ハイラルライフスタイル,252614,0.9803780028718904
0,41,55,一番くじゼルダの伝説ハイラルライフスタイル,252655,0.9805371211239182
0,19,56,一番くじゼルダの伝説ハイラルライフスタイル,252674,0.9806108588504676
0,57,57,一番くじゼルダの伝説ハイラルライフスタイル,252731,0.980832072030116
0,36,58,一番くじゼルダの伝説ハイラルライフスタイル,252767,0.9809717856172624
0,26,59,一番くじゼルダの伝説ハイラルライフスタイル,252793,0.9810726898746459
0,1584,0,一番くじ夏目友人帳ニャンコ先生栗づくし,1584,0.0039102421684070205
190120,29919,1,一番くじ夏目友人帳ニャンコ先生栗づくし,31503,0.07776790342886766
214830,43136,2,一番くじ夏目友人帳ニャンコ先生栗づくし,74639,0.18425288207558815
70,38038,3,一番くじ夏目友人帳ニャンコ先生栗づくし,112677,0.2781530030363623
0,43978,4,一番くじ夏目友人帳ニャンコ先生栗づくし,156655,0.38671653212866275
0,33874,5,一番くじ夏目友人帳ニャンコ先生栗づくし,190529,0.47033745587400333
0,23550,6,一番くじ夏目友人帳ニャンコ先生栗づくし,214079,0.5284726850823274
70,18604,7,一番くじ夏目友人帳ニャンコ先生栗づくし,232683,0.5743982818632897
0,17449,8,一番くじ夏目友人帳ニャンコ先生栗づくし,250132,0.6174726603964551
0,16072,9,一番くじ夏目友人帳ニャンコ先生栗づくし,266204,0.6571477943173122
0,14487,10,一番くじ夏目友人帳ニャンコ先生栗づくし,280691,0.6929102174825348
0,14118,11,一番くじ夏目友人帳ニャンコ先生栗づくし,294809,0.7277617319607989
0,10930,12,一番くじ夏目友人帳ニャンコ先生栗づくし,305739,0.7547433903576983
0,8774,13,一番くじ夏目友人帳ニャンコ先生栗づくし,314513,0.7764027746920438
0,6245,14,一番くじ夏目友人帳ニャンコ先生栗づくし,320758,0.7918191019279667
0,5158,15,一番くじ夏目友人帳ニャンコ先生栗づくし,325916,0.8045520748475647
0,4589,16,一番くじ夏目友人帳ニャンコ先生栗づくし,330505,0.8158804216346984
0,4673,17,一番くじ夏目友人帳ニャンコ先生栗づくし,335178,0.8274161297489446
0,5083,18,一番くじ夏目友人帳ニャンコ先生栗づくし,340261,0.8399639586264781
0,4106,19,一番くじ夏目友人帳ニャンコ先生栗づくし,344367,0.850099977782715
0,3368,20,一番くじ夏目友人帳ニャンコ先生栗づくし,347735,0.858414179565035
0,2687,21,一番くじ夏目友人帳ニャンコ先生栗づくし,350422,0.8650472734454072
0,3010,22,一番くじ夏目友人帳ニャンコ先生栗づくし,353432,0.8724777210002715
0,2320,23,一番くじ夏目友人帳ニャンコ先生栗づくし,355752,0.8782048433681404
0,2537,24,一番くじ夏目友人帳ニャンコ先生栗づくし,358289,0.8844676491643833
0,4174,25,一番くじ夏目友人帳ニャンコ先生栗づくし,362463,0.8947715322520922
0,2158,26,一番くじ夏目友人帳ニャンコ先生栗づくし,364621,0.9000987434891012
0,1413,27,一番くじ夏目友人帳ニャンコ先生栗づくし,366034,0.9035868572416006
0,1494,28,一番くじ夏目友人帳ニャンコ先生栗づくし,367528,0.90727492655953
0,1351,29,一番くじ夏目友人帳ニャンコ先生栗づくし,368879,0.9106099879039226
0,1332,30,一番くじ夏目友人帳ニャンコ先生栗づくし,370211,0.9138981460909922
0,1216,31,一番くじ夏目友人帳ニャンコ先生栗づくし,371427,0.9168999481596682
0,1345,32,一番くじ夏目友人帳ニャンコ先生栗づくし,372772,0.9202201979806957
0,1041,33,一番くじ夏目友人帳ニャンコ先生栗づくし,373813,0.922789997284554
0,1226,34,一番くじ夏目友人帳ニャンコ先生栗づくし,375039,0.9258164852255054
0,821,35,一番くじ夏目友人帳ニャンコ先生栗づくし,375860,0.9278431953393074
0,812,36,一番くじ夏目友人帳ニャンコ先生栗づくし,376672,0.9298476881680614
0,835,37,一番くじ夏目友人帳ニャンコ先生栗づくし,377507,0.9319089585030487
0,843,38,一番くじ夏目友人帳ニャンコ先生栗づくし,378350,0.9339899775358562
0,848,39,一番くじ夏目友人帳ニャンコ先生栗づくし,379198,0.9360833395048014
0,815,40,一番くじ夏目友人帳ニャンコ先生栗づくし,380013,0.9380952380952381
0,528,41,一番くじ夏目友人帳ニャンコ先生栗づくし,380541,0.9393986521513737
0,630,42,一番くじ夏目友人帳ニャンコ先生栗づくし,381171,0.9409538621047174
0,579,43,一番くじ夏目友人帳ニャンコ先生栗づくし,381750,0.9423831741094572
0,463,44,一番くじ夏目友人帳ニャンコ先生栗づくし,382213,0.9435261299958034
0,516,45,一番くじ夏目友人帳ニャンコ先生栗づくし,382729,0.9447999210052087
0,480,46,一番くじ夏目友人帳ニャンコ先生栗づくし,383209,0.945984842874423
0,475,47,一番くじ夏目友人帳ニャンコ先生栗づくし,383684,0.9471574218074996
0,322,48,一番くじ夏目友人帳ニャンコ先生栗づくし,384006,0.9479523068947642
0,441,49,一番くじ夏目友人帳ニャンコ先生栗づくし,384447,0.9490409538621047
0,323,50,一番くじ夏目友人帳ニャンコ先生栗づくし,384770,0.9498383075365968
0,346,51,一番くじ夏目友人帳ニャンコ先生栗づくし,385116,0.9506924387173221
0,341,52,一番くじ夏目友人帳ニャンコ先生栗づくし,385457,0.9515342269619097
0,448,53,一番くじ夏目友人帳ニャンコ先生栗づくし,385905,0.952640154039843
0,295,54,一番くじ夏目友人帳ニャンコ先生栗づくし,386200,0.9533683872719643
0,218,55,一番くじ夏目友人帳ニャンコ先生栗づくし,386418,0.9539065392875657
0,219,56,一番くじ夏目友人帳ニャンコ先生栗づくし,386637,0.9544471598903947
0,206,57,一番くじ夏目友人帳ニャンコ先生栗づくし,386843,0.9549556888592658
0,309,58,一番くじ夏目友人帳ニャンコ先生栗づくし,387152,0.9557184823125725
0,327,59,一番くじ夏目友人帳ニャンコ先生栗づくし,387479,0.9565257103359748
0,7460,0,一番くじシン・エヴァンゲリオン劇場版,7460,0.007195771278648044
495440,146750,1,一番くじシン・エヴァンゲリオン劇場版,154210,0.14874797438073925
540960,189547,2,一番くじシン・エヴァンゲリオン劇場版,343757,0.3315813334362219
0,128299,3,一番くじシン・エヴァンゲリオン劇場版,472056,0.45533605988116366
0,117358,4,一番くじシン・エヴァンゲリオン劇場版,589414,0.5685373099776218
320,82598,5,一番くじシン・エヴァンゲリオン劇場版,672012,0.6482097384057411
0,52007,6,一番くじシン・エヴァンゲリオン劇場版,724019,0.6983746816884019
0,40180,7,一番くじシン・エヴァンゲリオン劇場版,764199,0.7371315302106644
0,39171,8,一番くじシン・エヴァンゲリオン劇場版,803370,0.7749151169071687
0,35527,9,一番くじシン・エヴァンゲリオン劇場版,838897,0.8091837718959797
0,26796,10,一番くじシン・エヴァンゲリオン劇場版,865693,0.8350306736630912
0,21839,11,一番くじシン・エヴァンゲリオン劇場版,887532,0.8560961493942434
0,23772,12,一番くじシン・エヴァンゲリオン劇場版,911304,0.8790261594258816
0,10347,13,一番くじシン・エヴァンゲリオン劇場版,921651,0.8890066748977544
0,11329,14,一番くじシン・エヴァンゲリオン劇場版,932980,0.8999344085191758
0,7750,15,一番くじシン・エヴァンゲリオン劇場版,940730,0.9074099081719268
0,7017,16,一番くじシン・エヴァンゲリオン劇場版,947747,0.9141783702446177
0,6638,17,一番くじシン・エヴァンゲリオン劇場版,954385,0.9205812562697739
0,7502,18,一番くじシン・エヴァンゲリオン劇場版,961887,0.9278175399336368
0,5906,19,一番くじシン・エヴァンゲリオン劇場版,967793,0.9335143529593333
0,4037,20,一番くじシン・エヴァンゲリオン劇場版,971830,0.9374083648429663
0,3859,21,一番くじシン・エヴァンゲリオン劇場版,975689,0.9411306813797361
0,3520,22,一番くじシン・エヴァンゲリオン劇場版,979209,0.9445260050929856
0,3090,23,一番くじシン・エヴァンゲリオン劇場版,982299,0.9475065591480825
0,3349,24,一番くじシン・エヴァンゲリオン劇場版,985648,0.9507369395786712
0,2924,25,一番くじシン・エヴァンゲリオン劇場版,988572,0.9535573732541092
0,2699,26,一番くじシン・エヴァンゲリオン劇場版,991271,0.9561607762944672
0,1989,27,一番くじシン・エヴァンゲリオン劇場版,993260,0.9580793271085732
0,1695,28,一番くじシン・エヴァンゲリオン劇場版,994955,0.9597142912261749
0,1526,29,一番くじシン・エヴァンゲリオン劇場版,996481,0.9611862412223166
0,1575,30,一番くじシン・エヴァンゲリオン劇場版,998056,0.9627054556678756
0,1438,31,一番くじシン・エヴァンゲリオン劇場版,999494,0.964092522571186
0,1888,32,一番くじシン・エヴァンゲリオン劇場版,1001382,0.9659136507446562
0,1504,33,一番くじシン・エヴァンゲリオン劇場版,1002886,0.9673643799675901
0,1009,34,一番くじシン・エヴァンゲリオン劇場版,1003895,0.9683376417933482
0,1071,35,一番くじシン・エヴァンゲリオン劇場版,1004966,0.9693707076163284
0,951,36,一番くじシン・エヴァンゲリオン劇場版,1005917,0.970288023767266
0,743,37,一番くじシン・エヴァンゲリオン劇場版,1006660,0.9710047071533298
0,870,38,一番くじシン・エヴァンゲリオン劇場版,1007530,0.9718438922756385
0,971,39,一番くじシン・エヴァンゲリオン劇場版,1008501,0.9727805000385832
0,817,40,一番くじシン・エヴァンゲリオン劇場版,1009318,0.9735685623890732
0,567,41,一番くじシン・エヴァンゲリオン劇場版,1009885,0.9741154795894745
0,688,42,一番くじシン・エヴァンゲリオン劇場版,1010573,0.9747791110425187
0,730,43,一番くじシン・エヴァンゲリオン劇場版,1011303,0.9754832548807778
0,641,44,一番くじシン・エヴァンゲリオン劇場版,1011944,0.9761015510456054
0,561,45,一番くじシン・エヴァンゲリオン劇場版,1012505,0.9766426807624045
0,924,46,一番くじシン・エヴァンゲリオン劇場版,1013429,0.9775339532371325
0,637,47,一番くじシン・エヴァンゲリオン劇場版,1014066,0.9781483910795586
0,436,48,一番くじシン・エヴァンゲリオン劇場版,1014502,0.9785689482213134
0,400,49,一番くじシン・エヴァンゲリオン劇場版,1014902,0.9789547804614553
0,282,50,一番くじシン・エヴァンゲリオン劇場版,1015184,0.9792267921907555
0,300,51,一番くじシン・エヴァンゲリオン劇場版,1015484,0.9795161663708619
0,365,52,一番くじシン・エヴァンゲリオン劇場版,1015849,0.9798682382899915
0,432,53,一番くじシン・エヴァンゲリオン劇場版,1016281,0.9802849371093448
0,386,54,一番くじシン・エヴァンゲリオン劇場版,1016667,0.9806572652210819
0,293,55,一番くじシン・エヴァンゲリオン劇場版,1016960,0.9809398873369859
0,371,56,一番くじシン・エヴァンゲリオン劇場版,1017331,0.9812977467397176
0,270,57,一番くじシン・エヴァンゲリオン劇場版,1017601,0.9815581835018135
0,183,58,一番くじシン・エヴァンゲリオン劇場版,1017784,0.9817347017516783
0,268,59,一番くじシン・エヴァンゲリオン劇場版,1018052,0.9819932093525735
0,4742,0,一番くじ機動戦士ガンダムガンプラ２．０,4742,0.004922763890042355
457440,64504,1,一番くじ機動戦士ガンダムガンプラ２．０,69246,0.07188564072751433
504400,100728,2,一番くじ機動戦士ガンダムガンプラ２．０,169974,0.17645336766049333
0,90566,3,一番くじ機動戦士ガンダムガンプラ２．０,260540,0.2704717216178058
160,95495,4,一番くじ機動戦士ガンダムガンプラ２．０,356035,0.3696069678598123
0,73160,5,一番くじ機動戦士ガンダムガンプラ２．０,429195,0.44555580931816297
0,48224,6,一番くじ機動戦士ガンダムガンプラ２．０,477419,0.49561809650361266
0,44164,7,一番くじ機動戦士ガンダムガンプラ２．０,521583,0.5414656174736318
1280,39059,8,一番くじ機動戦士ガンダムガンプラ２．０,560642,0.5820135370816377
0,33772,9,一番くじ機動戦士ガンダムガンプラ２．０,594414,0.6170729175317665
0,33276,10,一番くじ機動戦士ガンダムガンプラ２．０,627690,0.6516173905821776
0,34440,11,一番くじ機動戦士ガンダムガンプラ２．０,662130,0.6873702350303131
0,28754,12,一番くじ機動戦士ガンダムガンプラ２．０,690884,0.7172203305373308
0,21318,13,一番くじ機動戦士ガンダムガンプラ２．０,712202,0.739350967527614
0,14803,14,一番くじ機動戦士ガンダムガンプラ２．０,727005,0.7547182542978158
0,12530,15,一番くじ機動戦士ガンダムガンプラ２．０,739535,0.7677258948592309
0,11883,16,一番くじ機動戦士ガンダムガンプラ２．０,751418,0.7800618719375467
0,11063,17,一番くじ機動戦士ガンダムガンプラ２．０,762481,0.7915465908147163
0,13571,18,一番くじ機動戦士ガンダムガンプラ２．０,776052,0.805634914043684
0,11149,19,一番くじ機動戦士ガンダムガンプラ２．０,787201,0.8172089112199984
0,8929,20,一番くじ機動戦士ガンダムガンプラ２．０,796130,0.8264782825346731
0,6779,21,一番くじ機動戦士ガンダムガンプラ２．０,802909,0.8335156963707333
0,7717,22,一番くじ機動戦士ガンダムガンプラ２．０,810626,0.841526866539324
0,6986,23,一番くじ機動戦士ガンダムガンプラ２．０,817612,0.8487791711651856
0,6736,24,一番くじ機動戦士ガンダムガンプラ２．０,824348,0.8557719458516735
0,7626,25,一番くじ機動戦士ガンダムガンプラ２．０,831974,0.8636886471223321
0,10652,26,一番くじ機動戦士ガンダムガンプラ２．０,842626,0.8747466987791712
0,10538,27,一番くじ機動戦士ガンダムガンプラ２．０,853164,0.8856864047836558
0,3729,28,一番くじ機動戦士ガンダムガンプラ２．０,856893,0.8895575533593555
0,4020,29,一番くじ機動戦士ガンダムガンプラ２．０,860913,0.8937307947844864
0,3741,30,一番くじ機動戦士ガンダムガンプラ２．０,864654,0.897614400797276
0,3830,31,一番くじ機動戦士ガンダムガンプラ２．０,868484,0.9015903994684827
0,4411,32,一番くじ機動戦士ガンダムガンプラ２．０,872895,0.9061695457187942
0,3116,33,一番くじ機動戦士ガンダムガンプラ２．０,876011,0.9094043268831492
0,2132,34,一番くじ機動戦士ガンダムガンプラ２．０,878143,0.9116175982061291
0,2362,35,一番くじ機動戦士ガンダムガンプラ２．０,880505,0.9140696370733328
0,1830,36,一番くじ機動戦士ガンダムガンプラ２．０,882335,0.9159693962295491
0,1811,37,一番くじ機動戦士ガンダムガンプラ２．０,884146,0.9178494311103729
0,1814,38,一番くじ機動戦士ガンダムガンプラ２．０,885960,0.9197325803504692
0,1599,39,一番くじ機動戦士ガンダムガンプラ２．０,887559,0.9213925338427041
0,1901,40,一番くじ機動戦士ガンダムガンプラ２．０,889460,0.9233659995017025
0,1627,41,一番くじ機動戦士ガンダムガンプラ２．０,891087,0.9250550203471473
0,1331,42,一番くじ機動戦士ガンダムガンプラ２．０,892418,0.9264367577443734
0,1139,43,一番くじ機動戦士ガンダムガンプラ２．０,893557,0.9276191761481605
0,1233,44,一番くじ機動戦士ガンダムガンプラ２．０,894790,0.9288991778091521
0,1218,45,一番くじ機動戦士ガンダムガンプラ２．０,896008,0.9301636076737813
0,1585,46,一番くじ機動戦士ガンダムガンプラ２．０,897593,0.9318090274894112
0,1515,47,一番くじ機動戦士ガンダムガンプラ２．０,899108,0.9333817789220165
0,1229,48,一番くじ機動戦士ガンダムガンプラ２．０,900337,0.9346576281039781
0,1455,49,一番くじ機動戦士ガンダムガンプラ２．０,901792,0.9361680923511336
0,1026,50,一番くじ機動戦士ガンダムガンプラ２．０,902818,0.9372332032223237
0,978,51,一番くじ機動戦士ガンダムガンプラ２．０,903796,0.9382484843451541
0,993,52,一番くじ機動戦士ガンダムガンプラ２．０,904789,0.9392793372643469
0,1380,53,一番くじ機動戦士ガンダムガンプラ２．０,906169,0.9407119425296903
0,1221,54,一番くじ機動戦士ガンダムガンプラ２．０,907390,0.9419794867535919
0,797,55,一番くじ機動戦士ガンダムガンプラ２．０,908187,0.9428068682003156
0,820,56,一番くじ機動戦士ガンダムガンプラ２．０,909007,0.9436581264014616
0,718,57,一番くじ機動戦士ガンダムガンプラ２．０,909725,0.9444034963873432
0,716,58,一番くじ機動戦士ガンダムガンプラ２．０,910441,0.9451467901337098
0,855,59,一番くじ機動戦士ガンダムガンプラ２．０,911296,0.9460343825263683
0,13,0,＃一番くじスパイファミリー,13,0.002771855010660981
4130,616,1,＃一番くじスパイファミリー,629,0.13411513859275054
560,390,2,＃一番くじスパイファミリー,1019,0.21727078891257995
0,503,3,＃一番くじスパイファミリー,1522,0.32452025586353944
0,161,4,＃一番くじスパイファミリー,1683,0.3588486140724947
0,134,5,＃一番くじスパイファミリー,1817,0.38742004264392327
0,159,6,＃一番くじスパイファミリー,1976,0.4213219616204691
0,251,7,＃一番くじスパイファミリー,2227,0.4748400852878465
0,114,8,＃一番くじスパイファミリー,2341,0.49914712153518126
0,68,9,＃一番くじスパイファミリー,2409,0.5136460554371002
0,198,10,＃一番くじスパイファミリー,2607,0.555863539445629
0,156,11,＃一番くじスパイファミリー,2763,0.5891257995735608
0,94,12,＃一番くじスパイファミリー,2857,0.6091684434968017
0,111,13,＃一番くじスパイファミリー,2968,0.6328358208955224
0,56,14,＃一番くじスパイファミリー,3024,0.6447761194029851
0,62,15,＃一番くじスパイファミリー,3086,0.6579957356076759
0,114,16,＃一番くじスパイファミリー,3200,0.6823027718550106
0,61,17,＃一番くじスパイファミリー,3261,0.6953091684434968
0,28,18,＃一番くじスパイファミリー,3289,0.7012793176972282
0,51,19,＃一番くじスパイファミリー,3340,0.7121535181236673
0,15,20,＃一番くじスパイファミリー,3355,0.7153518123667377
0,24,21,＃一番くじスパイファミリー,3379,0.7204690831556503
0,60,22,＃一番くじスパイファミリー,3439,0.7332622601279317
0,68,23,＃一番くじスパイファミリー,3507,0.7477611940298508
0,14,24,＃一番くじスパイファミリー,3521,0.7507462686567165
0,16,25,＃一番くじスパイファミリー,3537,0.7541577825159915
0,98,26,＃一番くじスパイファミリー,3635,0.7750533049040512
0,121,27,＃一番くじスパイファミリー,3756,0.8008528784648188
0,17,28,＃一番くじスパイファミリー,3773,0.8044776119402985
0,21,29,＃一番くじスパイファミリー,3794,0.808955223880597
0,9,30,＃一番くじスパイファミリー,3803,0.8108742004264392
0,16,31,＃一番くじスパイファミリー,3819,0.8142857142857143
0,9,32,＃一番くじスパイファミリー,3828,0.8162046908315566
0,132,33,＃一番くじスパイファミリー,3960,0.8443496801705757
0,29,34,＃一番くじスパイファミリー,3989,0.8505330490405117
0,33,35,＃一番くじスパイファミリー,4022,0.8575692963752666
0,33,36,＃一番くじスパイファミリー,4055,0.8646055437100213
0,35,37,＃一番くじスパイファミリー,4090,0.8720682302771855
0,23,38,＃一番くじスパイファミリー,4113,0.8769722814498934
0,49,39,＃一番くじスパイファミリー,4162,0.8874200426439233
0,52,40,＃一番くじスパイファミリー,4214,0.8985074626865671
0,22,41,＃一番くじスパイファミリー,4236,0.9031982942430704
0,4,42,＃一番くじスパイファミリー,4240,0.9040511727078892
0,28,43,＃一番くじスパイファミリー,4268,0.9100213219616204
0,21,44,＃一番くじスパイファミリー,4289,0.9144989339019189
0,38,45,＃一番くじスパイファミリー,4327,0.9226012793176972
0,15,46,＃一番くじスパイファミリー,4342,0.9257995735607676
0,19,47,＃一番くじスパイファミリー,4361,0.9298507462686567
0,32,48,＃一番くじスパイファミリー,4393,0.9366737739872069
0,21,49,＃一番くじスパイファミリー,4414,0.9411513859275054
0,85,50,＃一番くじスパイファミリー,4499,0.959275053304904
0,15,51,＃一番くじスパイファミリー,4514,0.9624733475479744
0,30,52,＃一番くじスパイファミリー,4544,0.9688699360341151
0,4,53,＃一番くじスパイファミリー,4548,0.9697228144989339
0,4,54,＃一番くじスパイファミリー,4552,0.9705756929637527
0,17,55,＃一番くじスパイファミリー,4569,0.9742004264392324
0,14,56,＃一番くじスパイファミリー,4583,0.977185501066098
0,7,57,＃一番くじスパイファミリー,4590,0.9786780383795309
0,28,58,＃一番くじスパイファミリー,4618,0.9846481876332622
0,4,59,＃一番くじスパイファミリー,4622,0.985501066098081
0,30377,0,一番くじワンピースレジェンズオーバータイム,30377,0.024429316466486793
620344,300357,1,一番くじワンピースレジェンズオーバータイム,330734,0.2659777315807039
623121,250471,2,一番くじワンピースレジェンズオーバータイム,581205,0.46740760696923517
0,153290,3,一番くじワンピースレジェンズオーバータイム,734495,0.5906840964562734
0,138432,4,一番くじワンピースレジェンズオーバータイム,872927,0.7020117172578239
0,91952,5,一番くじワンピースレジェンズオーバータイム,964879,0.7759599184536758
0,44476,6,一番くじワンピースレジェンズオーバータイム,1009355,0.8117277124808499
0,32484,7,一番くじワンピースレジェンズオーバータイム,1041839,0.8378514875770529
0,23879,8,一番くじワンピースレジェンズオーバータイム,1065718,0.8570550839790424
0,20260,9,一番くじワンピースレジェンズオーバータイム,1085978,0.873348264727998
0,17396,10,一番くじワンピースレジェンズオーバータイム,1103374,0.8873382041311979
0,18121,11,一番くじワンピースレジェンズオーバータイム,1121495,0.9019111917102612
0,14977,12,一番くじワンピースレジェンズオーバータイム,1136472,0.9139557607170287
0,8758,13,一番くじワンピースレジェンズオーバータイム,1145230,0.9209989826814586
0,15736,14,一番くじワンピースレジェンズオーバータイム,1160966,0.9336539428130265
0,5063,15,一番くじワンピースレジェンズオーバータイム,1166029,0.9377256295915044
0,4448,16,一番くじワンピースレジェンズオーバータイム,1170477,0.941302730675974
0,5139,17,一番くじワンピースレジェンズオーバータイム,1175616,0.9454355369873699
0,5552,18,一番くじワンピースレジェンズオーバータイム,1181168,0.9499004797079129
0,4180,19,一番くじワンピースレジェンズオーバータイム,1185348,0.9532620540184082
0,2781,20,一番くじワンピースレジェンズオーバータイム,1188129,0.9554985464005823
0,1871,21,一番くじワンピースレジェンズオーバータイム,1190000,0.9570032127965001
0,1940,22,一番くじワンピースレジェンズオーバータイム,1191940,0.9585633692946726
0,2165,23,一番くじワンピースレジェンズオーバータイム,1194105,0.9603044717784578
0,1719,24,一番くじワンピースレジェンズオーバータイム,1195824,0.9616868991085394
0,1982,25,一番くじワンピースレジェンズオーバータイム,1197806,0.9632808321906929
0,1925,26,一番くじワンピースレジェンズオーバータイム,1199731,0.9648289256231579
0,1614,27,一番くじワンピースレジェンズオーバータイム,1201345,0.9661269114932869
0,1582,28,一番くじワンピースレジェンズオーバータイム,1202927,0.9673991628232399
0,1163,29,一番くじワンピースレジェンズオーバータイム,1204090,0.9683344525177628
0,722,30,一番くじワンピースレジェンズオーバータイム,1204812,0.9689150880804848
0,870,31,一番くじワンピースレジェンズオーバータイム,1205682,0.9696147458915209
0,947,32,一番くじワンピースレジェンズオーバータイム,1206629,0.9703763274398556
0,888,33,一番くじワンピースレジェンズオーバータイム,1207517,0.9710904609297407
0,595,34,一番くじワンピースレジェンズオーバータイム,1208112,0.9715689625361389
0,726,35,一番くじワンピースレジェンズオーバータイム,1208838,0.9721528149163828
0,679,36,一番くじワンピースレジェンズオーバータイム,1209517,0.9726988696907432
0,467,37,一番くじワンピースレジェンズオーバータイム,1209984,0.9730744331364373
0,714,38,一番くじワンピースレジェンズオーバータイム,1210698,0.9736486350641151
0,751,39,一番くじワンピースレジェンズオーバータイム,1211449,0.9742525925538716
0,902,40,一番くじワンピースレジェンズオーバータイム,1212351,0.9749779849050838
0,491,41,一番くじワンピースレジェンズオーバータイム,1212842,0.97537284925591
0,580,42,一番くじワンピースレジェンズオーバータイム,1213422,0.9758392877966007
0,389,43,一番くじワンピースレジェンズオーバータイム,1213811,0.9761521233006156
0,348,44,一番くじワンピースレジェンズオーバータイム,1214159,0.97643198642503
0,390,45,一番くじワンピースレジェンズオーバータイム,1214549,0.9767456261334255
0,568,46,一番くじワンピースレジェンズオーバータイム,1215117,0.9772024142215503
0,641,47,一番くじワンピースレジェンズオーバータイム,1215758,0.9777179092294516
0,273,48,一番くじワンピースレジェンズオーバータイム,1216031,0.9779374570253284
0,251,49,一番くじワンピースレジェンズオーバータイム,1216282,0.9781393123248342
0,303,50,一番くじワンピースレジェンズオーバータイム,1216585,0.9783829862521262
0,144,51,一番くじワンピースレジェンズオーバータイム,1216729,0.9784987916829183
0,228,52,一番くじワンピースレジェンズオーバータイム,1216957,0.9786821502816726
0,332,53,一番くじワンピースレジェンズオーバータイム,1217289,0.978949146135999
0,319,54,一番くじワンピースレジェンズオーバータイム,1217608,0.9792056873333789
0,150,55,一番くじワンピースレジェンズオーバータイム,1217758,0.9793263179904541
0,145,56,一番くじワンピースレジェンズオーバータイム,1217903,0.9794429276256268
0,150,57,一番くじワンピースレジェンズオーバータイム,1218053,0.9795635582827019
0,131,58,一番くじワンピースレジェンズオーバータイム,1218184,0.9796689090565476
0,122,59,一番くじワンピースレジェンズオーバータイム,1218306,0.9797670219909688
240,4721,0,一番くじパズル＆ドラゴンズ２,4721,0.006339295305618219
373080,84812,1,一番くじパズル＆ドラゴンズ２,89533,0.12022370823933827
371340,164824,2,一番くじパズル＆ドラゴンズ２,254357,0.3415471586636588
0,121555,3,一番くじパズル＆ドラゴンズ２,375912,0.5047695778279084
0,80331,4,一番くじパズル＆ドラゴンズ２,456243,0.6126369642281663
0,42147,5,一番くじパズル＆ドラゴンズ２,498390,0.669231388978408
60,34934,6,一番くじパズル＆ドラゴンズ２,533324,0.7161402943388119
0,26918,7,一番くじパズル＆ドラゴンズ２,560242,0.7522854227092062
0,22754,8,一番くじパズル＆ドラゴンズ２,582996,0.7828391878826941
0,28612,9,一番くじパズル＆ドラゴンズ２,611608,0.8212589966698893
0,22285,10,一番くじパズル＆ドラゴンズ２,633893,0.8511829949511226
0,10711,11,一番くじパズル＆ドラゴンズ２,644604,0.8655655816951338
0,8652,12,一番くじパズル＆ドラゴンズ２,653256,0.8771833709313568
0,7813,13,一番くじパズル＆ドラゴンズ２,661069,0.8876745622515845
0,8381,14,一番くじパズル＆ドラゴンズ２,669450,0.8989284563325813
0,8562,15,一番くじパズル＆ドラゴンズ２,678012,0.9104253947792459
0,10030,16,一番くじパズル＆ドラゴンズ２,688042,0.9238935438822645
0,7578,17,一番くじパズル＆ドラゴンズ２,695620,0.9340691803630895
0,3388,18,一番くじパズル＆ドラゴンズ２,699008,0.9386185411966914
0,3115,19,一番くじパズル＆ドラゴンズ２,702123,0.9428013213019658
0,2587,20,一番くじパズル＆ドラゴンズ２,704710,0.9462751101084972
0,2121,21,一番くじパズル＆ドラゴンズ２,706831,0.9491231603824256
0,2099,22,一番くじパズル＆ドラゴンズ２,708930,0.9519416693522398
0,2965,23,一番くじパズル＆ドラゴンズ２,711895,0.9559230314749168
0,2260,24,一番くじパズル＆ドラゴンズ２,714155,0.9589577290793856
0,1064,25,一番くじパズル＆ドラゴンズ２,715219,0.960386453969277
0,935,26,一番くじパズル＆ドラゴンズ２,716154,0.9616419593941347
0,1093,27,一番くじパズル＆ドラゴンズ２,717247,0.963109625093995
0,802,28,一番くじパズル＆ドラゴンズ２,718049,0.9641865399076163
0,896,29,一番くじパズル＆ドラゴンズ２,718945,0.9653896766569986
0,802,30,一番くじパズル＆ドラゴンズ２,719747,0.9664665914706199
0,932,31,一番くじパズル＆ドラゴンズ２,720679,0.9677180685358255
0,640,32,一番くじパズル＆ドラゴンズ２,721319,0.9685774519282415
0,845,33,一番くじパズル＆ドラゴンズ２,722164,0.9697121065635407
0,493,34,一番くじパズル＆ドラゴンズ２,722657,0.9703741003330111
0,517,35,一番くじパズル＆ドラゴンズ２,723174,0.9710683209796971
0,435,36,一番くじパズル＆ドラゴンズ２,723609,0.9716524331292298
0,554,37,一番くじパズル＆ドラゴンズ２,724163,0.9723963368782899
0,747,38,一番くじパズル＆ドラゴンズ２,724910,0.9733993984316253
0,308,39,一番くじパズル＆ドラゴンズ２,725218,0.9738129766892255
0,289,40,一番くじパズル＆ドラゴンズ２,725507,0.9742010420023633
0,419,41,一番くじパズル＆ドラゴンズ２,725926,0.9747636695670856
0,455,42,一番くじパズル＆ドラゴンズ２,726381,0.9753746374476313
0,418,43,一番くじパズル＆ドラゴンズ２,726799,0.9759359222258029
0,570,44,一番くじパズル＆ドラゴンズ２,727369,0.9767013105596735
0,505,45,一番くじパズル＆ドラゴンズ２,727874,0.9773794177677516
0,228,46,一番くじパズル＆ドラゴンズ２,728102,0.9776855731012998
0,327,47,一番くじパズル＆ドラゴンズ２,728429,0.9781246643033623
0,276,48,一番くじパズル＆ドラゴンズ２,728705,0.9784952733913417
0,192,49,一番くじパズル＆ドラゴンズ２,728897,0.9787530884090665
0,244,50,一番くじパズル＆ドラゴンズ２,729141,0.9790807283274251
0,212,51,一番くじパズル＆ドラゴンズ２,729353,0.9793653990761628
0,194,52,一番くじパズル＆ドラゴンズ２,729547,0.979625899666989
0,172,53,一番くじパズル＆ドラゴンズ２,729719,0.9798568589537007
0,121,54,一番くじパズル＆ドラゴンズ２,729840,0.9800193361263294
0,90,55,一番くじパズル＆ドラゴンズ２,729930,0.9801401869158879
0,155,56,一番くじパズル＆ドラゴンズ２,730085,0.9803483188312386
0,153,57,一番くじパズル＆ドラゴンズ２,730238,0.980553765173488
0,227,58,一番くじパズル＆ドラゴンズ２,730465,0.9808585777204856
0,112,59,一番くじパズル＆ドラゴンズ２,730577,0.9810089698141583
0,15209,0,一番くじ銀魂笑顔を護る者たち,15209,0.011392005896368625
663539,181315,1,一番くじ銀魂笑顔を護る者たち,196524,0.14720248318613635
671280,228899,2,一番くじ銀魂笑顔を護る者たち,425423,0.31865483098499764
0,144937,3,一番くじ銀魂笑顔を護る者たち,570360,0.4272170743015852
0,91211,4,一番くじ銀魂笑顔を護る者たち,661571,0.49553690136540784
80,57300,5,一番くじ銀魂笑顔を護る者たち,718871,0.5384563528653041
0,56217,6,一番くじ銀魂笑顔を護る者たち,775088,0.5805646042609353
0,44861,7,一番くじ銀魂笑顔を護る者たち,819949,0.6141668645355748
0,42032,8,一番くじ銀魂笑顔を護る者たち,861981,0.6456501173356384
0,46227,9,一番くじ銀魂笑顔を護る者たち,908208,0.6802755533650573
0,35654,10,一番くじ銀魂笑顔を護る者たち,943862,0.7069814892075931
0,29614,11,一番くじ銀魂笑顔を護る者たち,973476,0.7291632804243109
0,23732,12,一番くじ銀魂笑顔を護る者たち,997208,0.7469392738448263
0,20157,13,一番くじ銀魂笑顔を護る者たち,1017365,0.7620374829876433
0,17153,14,一番くじ銀魂笑顔を護る者たち,1034518,0.7748856043066261
0,18270,15,一番くじ銀魂笑顔を護る者たち,1052788,0.7885703927691585
0,21233,16,一番くじ銀魂笑顔を護る者たち,1074021,0.8044745588022701
0,17281,17,一番くじ銀魂笑顔を護る者たち,1091302,0.8174185560338532
0,11583,18,一番くじ銀魂笑顔を護る者たち,1102885,0.8260945770935966
0,9655,19,一番くじ銀魂笑顔を護る者たち,1112540,0.8333264672198007
0,9867,20,一番くじ銀魂笑顔を護る者たち,1122407,0.8407171518262488
0,9167,21,一番くじ銀魂笑顔を護る者たち,1131574,0.8475835150356651
0,7975,22,一番くじ銀魂笑顔を護る者たち,1139549,0.8535570338089927
0,8866,23,一番くじ銀魂笑顔を護る者たち,1148415,0.8601979388176852
0,6989,24,一番くじ銀魂笑顔を護る者たち,1155404,0.8654329134517651
0,4896,25,一番くじ銀魂笑顔を護る者たち,1160300,0.8691001671087195
0,4642,26,一番くじ銀魂笑顔を護る者たち,1164942,0.8725771670016081
0,4148,27,一番くじ銀魂笑顔を護る者たち,1169090,0.8756841457943058
0,3766,28,一番くじ銀魂笑顔を護る者たち,1172856,0.8785049949103373
0,3949,29,一番くじ銀魂笑顔を護る者たち,1176805,0.8814629166201644
160,4013,30,一番くじ銀魂笑顔を護る者たち,1180818,0.8844687762862915
0,3969,31,一番くじ銀魂笑顔を護る者たち,1184787,0.8874416786074623
0,3057,32,一番くじ銀魂笑顔を護る者たち,1187844,0.8897314650513573
0,2030,33,一番くじ銀魂笑顔を護る者たち,1189874,0.8912519971027497
0,1969,34,一番くじ銀魂笑顔を護る者たち,1191843,0.8927268382895438
0,1847,35,一番くじ銀魂笑顔を護る者たち,1193690,0.8941102977471408
0,2206,36,一番くじ銀魂笑顔を護る者たち,1195896,0.8957626591783584
0,2435,37,一番くじ銀魂笑顔を護る者たち,1198331,0.8975865486094622
0,2240,38,一番くじ銀魂笑顔を護る者たち,1200571,0.8992643770799642
0,1873,39,一番くじ銀魂笑顔を護る者たち,1202444,0.9006673113323082
0,1975,40,一番くじ銀魂笑顔を護る者たち,1204419,0.9021466467025053
0,2105,41,一番くじ銀魂笑顔を護る者たち,1206524,0.9037233560464369
0,2044,42,一番くじ銀魂笑顔を護る者たち,1208568,0.9052543745257701
0,1808,43,一番くじ銀魂笑顔を護る者たち,1210376,0.9066086217912467
0,2363,44,一番くじ銀魂笑顔を護る者たち,1212739,0.9083785810215129
0,2047,45,一番くじ銀魂笑顔を護る者たち,1214786,0.9099118465925476
0,1599,46,一番くじ銀魂笑顔を護る者たち,1216385,0.9111095464694818
0,1660,47,一番くじ銀魂笑顔を護る者たち,1218045,0.9123529372110146
0,1560,48,一番くじ銀魂笑顔を護る者たち,1219605,0.9135214248958285
0,1487,49,一番くじ銀魂笑顔を護る者たち,1221092,0.9146352333492378
0,1515,50,一番くじ銀魂笑顔を護る者たち,1222607,0.9157700146585283
0,1512,51,一番くじ銀魂笑顔を護る者たち,1224119,0.9169025488761171
0,1364,52,一番くじ銀魂笑顔を護る者たち,1225483,0.9179242265697621
0,1163,53,一番くじ銀魂笑顔を護る者たち,1226646,0.9187953491194022
0,977,54,一番くじ銀魂笑顔を護る者たち,1227623,0.9195271519835453
0,1018,55,一番くじ銀魂笑顔を護る者たち,1228641,0.9202896651009431
0,928,56,一番くじ銀魂笑顔を護る者たち,1229569,0.9209847654672939
0,1104,57,一番くじ銀魂笑顔を護る者たち,1230673,0.92181169521347
0,1104,58,一番くじ銀魂笑顔を護る者たち,1231777,0.922638624959646
0,1107,59,一番くじ銀魂笑顔を護る者たち,1232884,0.9234678017975235
0,35795,0,一番くじ黒子のバスケシャイニーカラー,35795,0.04412598619329389
402780,215299,1,一番くじ黒子のバスケシャイニーカラー,251094,0.3095340236686391
408240,212899,2,一番くじ黒子のバスケシャイニーカラー,463993,0.5719834812623275
180,84270,3,一番くじ黒子のバスケシャイニーカラー,548263,0.6758666173570019
0,52697,4,一番くじ黒子のバスケシャイニーカラー,600960,0.7408284023668639
0,34104,5,一番くじ黒子のバスケシャイニーカラー,635064,0.7828698224852071
0,23076,6,一番くじ黒子のバスケシャイニーカラー,658140,0.8113165680473373
0,18070,7,一番くじ黒子のバスケシャイニーカラー,676210,0.8335922090729783
0,15790,8,一番くじ黒子のバスケシャイニーカラー,692000,0.8530571992110454
0,18626,9,一番くじ黒子のバスケシャイニーカラー,710626,0.8760182445759369
0,12914,10,一番くじ黒子のバスケシャイニーカラー,723540,0.8919378698224852
0,7762,11,一番くじ黒子のバスケシャイニーカラー,731302,0.9015064102564102
0,7947,12,一番くじ黒子のバスケシャイニーカラー,739249,0.9113030078895463
0,5462,13,一番くじ黒子のバスケシャイニーカラー,744711,0.9180362426035503
0,5241,14,一番くじ黒子のバスケシャイニーカラー,749952,0.9244970414201183
0,4905,15,一番くじ黒子のバスケシャイニーカラー,754857,0.9305436390532544
0,5756,16,一番くじ黒子のバスケシャイニーカラー,760613,0.9376392998027614
0,4790,17,一番くじ黒子のバスケシャイニーカラー,765403,0.9435441321499014
0,2786,18,一番くじ黒子のバスケシャイニーカラー,768189,0.946978550295858
0,2630,19,一番くじ黒子のバスケシャイニーカラー,770819,0.950220660749507
0,1984,20,一番くじ黒子のバスケシャイニーカラー,772803,0.9526664201183432
0,1772,21,一番くじ黒子のバスケシャイニーカラー,774575,0.9548508382642998
0,1633,22,一番くじ黒子のバスケシャイニーカラー,776208,0.9568639053254437
0,1961,23,一番くじ黒子のバスケシャイニーカラー,778169,0.9592813116370809
0,1410,24,一番くじ黒子のバスケシャイニーカラー,779579,0.9610194773175542
0,1117,25,一番くじ黒子のバスケシャイニーカラー,780696,0.9623964497041421
0,766,26,一番くじ黒子のバスケシャイニーカラー,781462,0.9633407297830375
0,954,27,一番くじ黒子のバスケシャイニーカラー,782416,0.9645167652859961
0,696,28,一番くじ黒子のバスケシャイニーカラー,783112,0.9653747534516766
0,911,29,一番くじ黒子のバスケシャイニーカラー,784023,0.9664977810650888
0,942,30,一番くじ黒子のバスケシャイニーカラー,784965,0.9676590236686391
0,867,31,一番くじ黒子のバスケシャイニーカラー,785832,0.9687278106508875
0,770,32,一番くじ黒子のバスケシャイニーカラー,786602,0.9696770216962525
0,370,33,一番くじ黒子のバスケシャイニーカラー,786972,0.9701331360946746
0,370,34,一番くじ黒子のバスケシャイニーカラー,787342,0.9705892504930966
0,440,35,一番くじ黒子のバスケシャイニーカラー,787782,0.9711316568047337
0,406,36,一番くじ黒子のバスケシャイニーカラー,788188,0.9716321499013807
0,600,37,一番くじ黒子のバスケシャイニーカラー,788788,0.9723717948717949
0,544,38,一番くじ黒子のバスケシャイニーカラー,789332,0.9730424063116371
0,316,39,一番くじ黒子のバスケシャイニーカラー,789648,0.9734319526627219
0,298,40,一番くじ黒子のバスケシャイニーカラー,789946,0.9737993096646943
0,253,41,一番くじ黒子のバスケシャイニーカラー,790199,0.9741111932938856
0,452,42,一番くじ黒子のバスケシャイニーカラー,790651,0.974668392504931
0,302,43,一番くじ黒子のバスケシャイニーカラー,790953,0.9750406804733728
0,359,44,一番くじ黒子のバスケシャイニーカラー,791312,0.975483234714004
0,345,45,一番くじ黒子のバスケシャイニーカラー,791657,0.9759085305719921
0,330,46,一番くじ黒子のバスケシャイニーカラー,791987,0.9763153353057199
0,306,47,一番くじ黒子のバスケシャイニーカラー,792293,0.9766925542406312
0,472,48,一番くじ黒子のバスケシャイニーカラー,792765,0.9772744082840237
0,247,49,一番くじ黒子のバスケシャイニーカラー,793012,0.9775788954635108
0,174,50,一番くじ黒子のバスケシャイニーカラー,793186,0.9777933925049309
0,264,51,一番くじ黒子のバスケシャイニーカラー,793450,0.9781188362919132
0,285,52,一番くじ黒子のバスケシャイニーカラー,793735,0.97847016765286
0,243,53,一番くじ黒子のバスケシャイニーカラー,793978,0.9787697238658777
0,197,54,一番くじ黒子のバスケシャイニーカラー,794175,0.979012573964497
0,150,55,一番くじ黒子のバスケシャイニーカラー,794325,0.9791974852071006
0,150,56,一番くじ黒子のバスケシャイニーカラー,794475,0.9793823964497042
0,153,57,一番くじ黒子のバスケシャイニーカラー,794628,0.9795710059171597
0,207,58,一番くじ黒子のバスケシャイニーカラー,794835,0.9798261834319527
0,145,59,一番くじ黒子のバスケシャイニーカラー,794980,0.9800049309664695
6400,36512,0,一番くじドラゴンボールアルティメット,36512,0.028517870532366908
660320,130879,1,一番くじドラゴンボールアルティメット,167391,0.13074153336665834
613600,178586,2,一番くじドラゴンボールアルティメット,345977,0.2702269745063734
0,109596,3,一番くじドラゴンボールアルティメット,455573,0.3558274493876531
0,89697,4,一番くじドラゴンボールアルティメット,545270,0.42588571607098225
0,85082,5,一番くじドラゴンボールアルティメット,630352,0.49233941514621343
0,65835,6,一番くじドラゴンボールアルティメット,696187,0.5437601537115722
0,67631,7,一番くじドラゴンボールアルティメット,763818,0.5965836665833542
0,75196,8,一番くじドラゴンボールアルティメット,839014,0.6553158585353661
0,72821,9,一番くじドラゴンボールアルティメット,911835,0.7121930454886278
0,42276,10,一番くじドラゴンボールアルティメット,954111,0.7452129155211197
0,29425,11,一番くじドラゴンボールアルティメット,983536,0.7681954511372157
0,26225,12,一番くじドラゴンボールアルティメット,1009761,0.7886786115971007
0,19877,13,一番くじドラゴンボールアルティメット,1029638,0.8042036365908523
0,21078,14,一番くじドラゴンボールアルティメット,1050716,0.8206667083229193
0,26542,15,一番くじドラゴンボールアルティメット,1077258,0.8413974631342165
0,24668,16,一番くじドラゴンボールアルティメット,1101926,0.8606645213696575
0,30626,17,一番くじドラゴンボールアルティメット,1132552,0.884585103724069
0,10669,18,一番くじドラゴンボールアルティメット,1143221,0.8929181767058235
0,9575,19,一番くじドラゴンボールアルティメット,1152796,0.9003967758060485
0,9055,20,一番くじドラゴンボールアルティメット,1161851,0.9074692264433891
0,9181,21,一番くじドラゴンボールアルティメット,1171032,0.9146400899775057
0,10542,22,一番くじドラゴンボールアルティメット,1181574,0.9228739690077481
0,9989,23,一番くじドラゴンボールアルティメット,1191563,0.9306759247688078
0,6540,24,一番くじドラゴンボールアルティメット,1198103,0.9357840227443139
0,5020,25,一番くじドラゴンボールアルティメット,1203123,0.9397049175206198
0,4333,26,一番くじドラゴンボールアルティメット,1207456,0.9430892276930767
0,3832,27,一番くじドラゴンボールアルティメット,1211288,0.9460822294426393
0,3302,28,一番くじドラゴンボールアルティメット,1214590,0.9486612721819545
0,4787,29,一番くじドラゴンボールアルティメット,1219377,0.9524001812046988
0,4697,30,一番くじドラゴンボールアルティメット,1224074,0.9560687953011747
0,2615,31,一番くじドラゴンボールアルティメット,1226689,0.9581112534366408
0,1817,32,一番くじドラゴンボールアルティメット,1228506,0.9595304298925269
0,2309,33,一番くじドラゴンボールアルティメット,1230815,0.9613338852786804
0,1647,34,一番くじドラゴンボールアルティメット,1232462,0.9626202824293927
0,2093,35,一番くじドラゴンボールアルティメット,1234555,0.9642550299925019
0,2323,36,一番くじドラゴンボールアルティメット,1236878,0.9660694201449638
0,2076,37,一番くじドラゴンボールアルティメット,1238954,0.9676908897775556
0,1392,38,一番くじドラゴンボールアルティメット,1240346,0.9687781179705074
0,1174,39,一番くじドラゴンボールアルティメット,1241520,0.9696950762309423
0,1338,40,一番くじドラゴンボールアルティメット,1242858,0.970740127468133
0,1206,41,一番くじドラゴンボールアルティメット,1244064,0.97168207948013
0,1055,42,一番くじドラゴンボールアルティメット,1245119,0.9725060922269433
0,1454,43,一番くじドラゴンボールアルティメット,1246573,0.9736417458135466
0,1049,44,一番くじドラゴンボールアルティメット,1247622,0.974461072231942
0,504,45,一番くじドラゴンボールアルティメット,1248126,0.9748547238190453
0,706,46,一番くじドラゴンボールアルティメット,1248832,0.9754061484628843
0,772,47,一番くじドラゴンボールアルティメット,1249604,0.9760091227193202
0,921,48,一番くじドラゴンボールアルティメット,1250525,0.9767284741314671
0,886,49,一番くじドラゴンボールアルティメット,1251411,0.977420488627843
0,1039,50,一番くじドラゴンボールアルティメット,1252450,0.9782320044988753
0,726,51,一番くじドラゴンボールアルティメット,1253176,0.9787990502374406
0,296,52,一番くじドラゴンボールアルティメット,1253472,0.9790302424393902
0,342,53,一番くじドラゴンボールアルティメット,1253814,0.9792973631592102
0,462,54,一番くじドラゴンボールアルティメット,1254276,0.9796582104473881
0,265,55,一番くじドラゴンボールアルティメット,1254541,0.9798651899525118
0,545,56,一番くじドラゴンボールアルティメット,1255086,0.980290864783804
0,632,57,一番くじドラゴンボールアルティメット,1255718,0.9807844913771557
0,381,58,一番くじドラゴンボールアルティメット,1256099,0.981082073231692
0,172,59,一番くじドラゴンボールアルティメット,1256271,0.9812164146463385
858,2695,0,ポケットモンスターソード・シールドくじ,2695,0.0032850309853386444
421146,46991,1,ポケットモンスターソード・シールドくじ,49686,0.060564025802425196
398112,82532,2,ポケットモンスターソード・シールドくじ,132218,0.16116520475677362
132,72750,3,ポケットモンスターソード・シールドくじ,204968,0.24984275732945874
0,52863,4,ポケットモンスターソード・シールドくじ,257831,0.3142793409947488
0,48982,5,ポケットモンスターソード・シールドくじ,306813,0.37398523625406516
66,42454,6,ポケットモンスターソード・シールドくじ,349267,0.4257339210227356
0,43464,7,ポケットモンスターソード・シールドくじ,392731,0.47871373057626393
0,51337,8,ポケットモンスターソード・シールドくじ,444068,0.5412902187745311
8,43048,9,ポケットモンスターソード・シールドくじ,487116,0.5937629511889496
0,27067,10,ポケットモンスターソード・シールドくじ,514183,0.6267558764877107
0,23685,11,ポケットモンスターソード・シールドくじ,537868,0.6556263621603436
0,21519,12,ポケットモンスターソード・シールドくじ,559387,0.6818566336904002
0,18078,13,ポケットモンスターソード・シールドくじ,577465,0.7038925484039259
0,19183,14,ポケットモンスターソード・シールドくじ,596648,0.7272753867682121
0,22581,15,ポケットモンスターソード・シールドくじ,619229,0.7548001677255153
0,18099,16,ポケットモンスターソード・シールドくじ,637328,0.7768616800830827
0,10945,17,ポケットモンスターソード・シールドくじ,648273,0.7902029283704783
0,9514,18,ポケットモンスターソード・シールドくじ,657787,0.8017998800567536
0,9349,19,ポケットモンスターソード・シールドくじ,667136,0.8131957073969878
0,8864,20,ポケットモンスターソード・シールドくじ,676000,0.824000351053404
0,8349,21,ポケットモンスターソード・シールドくじ,684349,0.8341772429630857
0,10796,22,ポケットモンスターソード・シールドくじ,695145,0.8473368698713292
0,9082,23,ポケットモンスターソード・シールドくじ,704227,0.8584072414516059
0,6303,24,ポケットモンスターソード・シールドくじ,710530,0.8660901914703775
0,5627,25,ポケットモンスターソード・シールドくじ,716157,0.8729491411380956
0,4958,26,ポケットモンスターソード・シールドくじ,721115,0.8789926230027743
0,4491,27,ポケットモンスターソード・シールドくじ,725606,0.884466862021385
0,4686,28,ポケットモンスターソード・シールドくじ,730292,0.8901787934489535
0,5680,29,ポケットモンスターソード・シールドくじ,735972,0.8971023466944908
0,4842,30,ポケットモンスターソード・シールドくじ,740814,0.9030044320492255
0,3087,31,ポケットモンスターソード・シールドくじ,743901,0.9067672857233406
0,2667,32,ポケットモンスターソード・シールドくじ,746568,0.9100181865166238
0,2845,33,ポケットモンスターソード・シールドくじ,749413,0.9134860578165453
66,2711,34,ポケットモンスターソード・シールドくじ,752124,0.9167905917687729
0,2617,35,ポケットモンスターソード・シールドくじ,754741,0.9199805457905283
0,3028,36,ポケットモンスターソード・シールドくじ,757769,0.923671482274241
0,2616,37,ポケットモンスターソード・シールドくじ,760385,0.926860217360566
0,1546,38,ポケットモンスターソード・シールドくじ,761931,0.9287446915362
0,1769,39,ポケットモンスターソード・シールドくじ,763700,0.9309009883128471
0,1889,40,ポケットモンスターソード・シールドくじ,765589,0.9332035573411606
0,1390,41,ポケットモンスターソード・シールドくじ,766979,0.9348978775896283
0,1428,42,ポケットモンスターソード・シールドくじ,768407,0.9366385173844571
0,1884,43,ポケットモンスターソード・シールドくじ,770291,0.9389349917356178
0,1590,44,ポケットモンスターソード・シールドくじ,771881,0.940873099070196
0,1090,45,ポケットモンスターソード・シールドくじ,772971,0.9422017386894982
0,985,46,ポケットモンスターソード・シールドくじ,773956,0.9434023900885923
0,939,47,ポケットモンスターソード・シールドくじ,774895,0.9445469704578809
0,796,48,ポケットモンスターソード・シールドくじ,775691,0.9455172430606006
0,1077,49,ポケットモンスターソード・シールドくじ,776768,0.9468300365193055
0,1319,50,ポケットモンスターソード・シールドくじ,778087,0.948437812352204
0,982,51,ポケットモンスターソード・シールドくじ,779069,0.9496348069450065
0,670,52,ポケットモンスターソード・シールドくじ,779739,0.9504514936834766
0,785,53,ポケットモンスターソード・シールドくじ,780524,0.9514083579964602
0,844,54,ポケットモンスターソード・シールドくじ,781368,0.9524371394998464
0,735,55,ポケットモンスターソード・シールドくじ,782103,0.9533330570413024
0,712,56,ポケットモンスターソード・シールドくじ,782815,0.9542009390678557
0,6151,57,ポケットモンスターソード・シールドくじ,788966,0.9616986109011834
0,815,58,ポケットモンスターソード・シールドくじ,789781,0.9626920432770836
0,763,59,ポケットモンスターソード・シールドくじ,790544,0.963622091010595
0,2427,0,一番くじ機動戦士ガンダム３５ｔｈ,2427,0.0027419732039058713
437250,31472,1,一番くじ機動戦士ガンダム３５ｔｈ,33899,0.03829837232764942
447549,59119,2,一番くじ機動戦士ガンダム３５ｔｈ,93018,0.10508976657639733
132,95862,3,一番くじ機動戦士ガンダム３５ｔｈ,188880,0.21339262412597484
66,77538,4,一番くじ機動戦士ガンダム３５ｔｈ,266418,0.30099341451923955
0,56711,5,一番くじ機動戦士ガンダム３５ｔｈ,323129,0.3650643013617224
0,40914,6,一番くじ機動戦士ガンダム３５ｔｈ,364043,0.4112880721341183
0,35653,7,一番くじ機動戦士ガンダム３５ｔｈ,399696,0.4515680765176601
0,30050,8,一番くじ機動戦士ガンダム３５ｔｈ,429746,0.4855179301548136
0,28762,9,一番くじ機動戦士ガンダム３５ｔｈ,458508,0.5180126286676857
0,31291,10,一番くじ機動戦士ガンダム３５ｔｈ,489799,0.5533645378244301
0,25636,11,一番くじ機動戦士ガンダム３５ｔｈ,515435,0.5823275477359797
0,18629,12,一番くじ機動戦士ガンダム３５ｔｈ,534064,0.6033741974333685
0,16446,13,一番くじ機動戦士ガンダム３５ｔｈ,550510,0.6219545399597121
0,15612,14,一番くじ機動戦士ガンダム３５ｔｈ,566122,0.6395926469475071
0,13283,15,一番くじ機動戦士ガンダム３５ｔｈ,579405,0.6545994990560698
0,11986,16,一番くじ機動戦士ガンダム３５ｔｈ,591391,0.6681410280309423
0,11691,17,一番くじ機動戦士ガンダム３５ｔｈ,603082,0.681349272252971
0,9647,18,一番くじ機動戦士ガンダム３５ｔｈ,612729,0.6922482485603794
0,6212,19,一番くじ機動戦士ガンダム３５ｔｈ,618941,0.6992664346100964
0,6123,20,一番くじ機動戦士ガンダム３５ｔｈ,625064,0.7061840703445487
0,5260,21,一番くじ機動戦士ガンダム３５ｔｈ,630324,0.7121267069545795
0,5209,22,一番くじ機動戦士ガンダム３５ｔｈ,635533,0.7180117248446272
0,5890,23,一番くじ機動戦士ガンダム３５ｔｈ,641423,0.7246661221132739
66,6435,24,一番くじ機動戦士ガンダム３５ｔｈ,647858,0.7319362488405645
0,6307,25,一番くじ機動戦士ガンダム３５ｔｈ,654165,0.7390617638784855
0,5079,26,一番くじ機動戦士ガンダム３５ｔｈ,659244,0.7447999105215172
0,4599,27,一番くじ機動戦士ガンダム３５ｔｈ,663843,0.749995763329413
0,4211,28,一番くじ機動戦士ガンダム３５ｔｈ,668054,0.7547532619539072
0,4317,29,一番くじ機動戦士ガンダム３５ｔｈ,672371,0.7596305171336607
0,4782,30,一番くじ機動戦士ガンダム３５ｔｈ,677153,0.7650331194662021
0,5624,31,一番くじ機動戦士ガンダム３５ｔｈ,682777,0.7713869955678777
0,5290,32,一番くじ機動戦士ガンダム３５ｔｈ,688067,0.7773635255426046
66,3551,33,一番くじ機動戦士ガンダム３５ｔｈ,691618,0.781375370143787
0,3319,34,一番くじ機動戦士ガンダム３５ｔｈ,694937,0.785125106057987
0,3254,35,一番くじ機動戦士ガンダム３５ｔｈ,698191,0.7888014063486791
0,3031,36,一番くじ機動戦士ガンダム３５ｔｈ,701222,0.7922257659617976
0,3324,37,一番くじ機動戦士ガンダム３５ｔｈ,704546,0.7959811507701138
0,4037,38,一番くじ機動戦士ガンダム３５ｔｈ,708583,0.8005420678793712
0,3492,39,一番くじ機動戦士ガンダム３５ｔｈ,712075,0.8044872555299849
0,2292,40,一番くじ機動戦士ガンダム３５ｔｈ,714367,0.8070767085927588
0,2388,41,一番くじ機動戦士ガンダム３５ｔｈ,716755,0.8097746204225599
0,2453,42,一番くじ機動戦士ガンダム３５ｔｈ,719208,0.812545967875869
0,2326,43,一番くじ機動戦士ガンダム３５ｔｈ,721534,0.8151738334186316
0,2420,44,一番くじ機動戦士ガンダム３５ｔｈ,723954,0.8179078981707751
0,3038,45,一番くじ機動戦士ガンダム３５ｔｈ,726992,0.8213401662356561
0,2609,46,一番くじ機動戦士ガンダム３５ｔｈ,729601,0.8242877591853843
0,2140,47,一番くじ機動戦士ガンダム３５ｔｈ,731741,0.8267054858670319
0,1716,48,一番くじ機動戦士ガンダム３５ｔｈ,733457,0.8286441863276426
0,1580,49,一番くじ機動戦士ガンダム３５ｔｈ,735037,0.8304292368682983
0,1621,50,一番くじ機動戦士ガンダム３５ｔｈ,736658,0.8322606083407051
0,1706,51,一番くじ機動戦士ガンダム３５ｔｈ,738364,0.8341880110130839
0,1816,52,一番くじ機動戦士ガンダム３５ｔｈ,740180,0.8362396893560148
0,1616,53,一番くじ機動戦士ガンダム３５ｔｈ,741796,0.8380654119343056
0,1434,54,一番くじ機動戦士ガンダム３５ｔｈ,743230,0.8396855147667741
0,1512,55,一番くじ機動戦士ガンダム３５ｔｈ,744742,0.8413937403474522
0,1263,56,一番くじ機動戦士ガンダム３５ｔｈ,746005,0.8428206510011536
0,1635,57,一番くじ機動戦士ガンダム３５ｔｈ,747640,0.8446678393770851
0,1486,58,一番くじ機動戦士ガンダム３５ｔｈ,749126,0.84634669070836
0,1551,59,一番くじ機動戦士ガンダム３５ｔｈ,750677,0.8480989776631429
0,6485,0,一番くじトイストーリーハロウィンパーティー,6485,0.007152768126779919
451308,88100,1,一番くじトイストーリーハロウィンパーティー,94585,0.10432452941734444
455268,186447,2,一番くじトイストーリーハロウィンパーティー,281032,0.3099701977186144
0,160032,3,一番くじトイストーリーハロウィンパーティー,441064,0.48648088220047164
0,120574,4,一番くじトイストーリーハロウィンパーティー,561638,0.6194705297129407
66,75937,5,一番くじトイストーリーハロウィンパーティー,637575,0.7032268524952517
0,59129,6,一番くじトイストーリーハロウィンパーティー,696704,0.768444435620675
0,44369,7,一番くじトイストーリーハロウィンパーティー,741073,0.8173821640735814
0,33459,8,一番くじトイストーリーハロウィンパーティー,774532,0.8542864769115042
0,29690,9,一番くじトイストーリーハロウィンパーティー,804222,0.8870336913577795
0,20640,10,一番くじトイストーリーハロウィンパーティー,824862,0.9097990165908926
0,12161,11,一番くじトイストーリーハロウィンパーティー,837023,0.9232122491567786
0,9455,12,一番くじトイストーリーハロウィンパーティー,846478,0.9336408416993698
0,6738,13,一番くじトイストーリーハロウィンパーティー,853216,0.9410726615356447
0,5493,14,一番くじトイストーリーハロウィンパーティー,858709,0.9471312822481199
0,5098,15,一番くじトイストーリーハロウィンパーティー,863807,0.9527542293430041
0,5440,16,一番くじトイストーリーハロウィンパーティー,869247,0.9587543925827394
0,4360,17,一番くじトイストーリーハロウィンパーティー,873607,0.9635633469439977
0,2577,18,一番くじトイストーリーハロウィンパーティー,876184,0.9664057036845856
0,2064,19,一番くじトイストーリーハロウィンパーティー,878248,0.9686822362078968
0,1945,20,一番くじトイストーリーハロウィンパーティー,880193,0.9708275151603389
0,1784,21,一番くじトイストーリーハロウィンパーティー,881977,0.9727952157521933
0,1645,22,一番くじトイストーリーハロウィンパーティー,883622,0.9746096033495029
0,2002,23,一番くじトイストーリーハロウィンパーティー,885624,0.9768177516594202
0,1499,24,一番くじトイストーリーハロウィンパーティー,887123,0.9784711054638987
0,1029,25,一番くじトイストーリーハロウィンパーティー,888152,0.979606062812003
0,988,26,一番くじトイストーリーハロウィンパーティー,889140,0.9806957983415725
0,1084,27,一番くじトイストーリーハロウィンパーティー,890224,0.9818914191047845
0,682,28,一番くじトイストーリーハロウィンパーティー,890906,0.9826436454521189
0,610,29,一番くじトイストーリーハロウィンパーティー,891516,0.9833164578742216
0,638,30,一番くじトイストーリーハロウィンパーティー,892154,0.9840201534894699
0,435,31,一番くじトイストーリーハロウィンパーティー,892589,0.984499945954412
0,312,32,一番くじトイストーリーハロウィンパーティー,892901,0.9848440729637498
0,256,33,一番くじトイストーリーハロウィンパーティー,893157,0.9851264335867961
0,278,34,一番くじトイストーリーハロウィンパーティー,893435,0.9854330595758856
0,254,35,一番くじトイストーリーハロウィンパーティー,893689,0.9857132142565643
0,281,36,一番くじトイストーリーハロウィンパーティー,893970,0.9860231491592051
0,332,37,一番くじトイストーリーハロウィンパーティー,894302,0.9863893355922183
0,269,38,一番くじトイストーリーハロウィンパーティー,894571,0.9866860348406538
0,204,39,一番くじトイストーリーハロウィンパーティー,894775,0.9869110409621438
0,140,40,一番くじトイストーリーハロウィンパーティー,894915,0.9870654569278723
0,173,41,一番くじトイストーリーハロウィンパーティー,895088,0.9872562709426653
0,171,42,一番くじトイストーリーハロウィンパーティー,895259,0.9874448790150908
0,180,43,一番くじトイストーリーハロウィンパーティー,895439,0.9876434138281703
0,214,44,一番くじトイストーリーハロウィンパーティー,895653,0.9878794496614981
0,111,45,一番くじトイストーリーハロウィンパーティー,895764,0.9880018794628972
0,82,46,一番くじトイストーリーハロウィンパーティー,895846,0.9880923230999666
0,97,47,一番くじトイストーリーハロウィンパーティー,895943,0.9881993113047929
0,110,48,一番くじトイストーリーハロウィンパーティー,896053,0.988320638135008
0,87,49,一番くじトイストーリーハロウィンパーティー,896140,0.9884165966279965
0,130,50,一番くじトイストーリーハロウィンパーティー,896270,0.9885599828818872
0,95,51,一番くじトイストーリーハロウィンパーティー,896365,0.9886647651443459
0,88,52,一番くじトイストーリーハロウィンパーティー,896453,0.9887618266085181
0,66,53,一番くじトイストーリーハロウィンパーティー,896519,0.9888346227066471
0,75,54,一番くじトイストーリーハロウィンパーティー,896594,0.9889173455454303
0,63,55,一番くじトイストーリーハロウィンパーティー,896657,0.9889868327300081
0,82,56,一番くじトイストーリーハロウィンパーティー,896739,0.9890772763670777
0,58,57,一番くじトイストーリーハロウィンパーティー,896797,0.9891412486957366
0,56,58,一番くじトイストーリーハロウィンパーティー,896853,0.989203015082028
0,101,59,一番くじトイストーリーハロウィンパーティー,896954,0.9893144151715892
0,702,0,一番くじガンダムユニコーンエピソード７,702,0.002148326325260278
164736,9651,1,一番くじガンダムユニコーンエピソード７,10353,0.03168322285672316
161898,20457,2,一番くじガンダムユニコーンエピソード７,30810,0.09428765538642331
0,19950,3,一番くじガンダムユニコーンエピソード７,50760,0.15534051890343548
0,23595,4,一番くじガンダムユニコーンエピソード７,74355,0.2275481537246837
0,20227,5,一番くじガンダムユニコーンエピソード７,94582,0.2894487186549396
0,13656,6,一番くじガンダムユニコーンエピソード７,108238,0.33124009229846435
0,12680,7,一番くじガンダムユニコーンエピソード７,120918,0.37004461908521696
0,12018,8,一番くじガンダムユニコーンエピソード７,132936,0.40682323130313436
0,12008,9,一番くじガンダムユニコーンエピソード７,144944,0.44357124058194547
0,11841,10,一番くじガンダムユニコーンエピソード７,156785,0.4798081807776819
0,14682,11,一番くじガンダムユニコーンエピソード７,171467,0.5247394159735101
0,12831,12,一番くじガンダムユニコーンエピソード７,184298,0.5640060471407674
0,8605,13,一番くじガンダムユニコーンエピソード７,192903,0.5903398762417142
0,8225,14,一番くじガンダムユニコーンエピソード７,201128,0.6155107936566228
0,7746,15,一番くじガンダムユニコーンエピソード７,208874,0.639215830288341
0,6971,16,一番くじガンダムユニコーンエピソード７,215845,0.6605491391393229
0,7636,17,一番くじガンダムユニコーンエピソード７,223481,0.6839175434408721
0,7629,18,一番くじガンダムユニコーンエピソード７,231110,0.7072645256850468
0,5965,19,一番くじガンダムユニコーンエピソード７,237075,0.725519178861938
0,3912,20,一番くじガンダムユニコーンエピソード７,240987,0.7374910486403115
0,3499,21,一番くじガンダムユニコーンエピソード７,244486,0.7481990170335959
66,3138,22,一番くじガンダムユニコーンエピソード７,247624,0.757802219325144
0,2797,23,一番くじガンダムユニコーンエピソード７,250421,0.7663618613931682
0,3178,24,一番くじガンダムユニコーンエピソード７,253599,0.7760874754411413
0,3794,25,一番くじガンダムユニコーンエピソード７,257393,0.7876982305380609
0,3274,26,一番くじガンダムユニコーンエピソード７,260667,0.7977176328014542
0,1888,27,一番くじガンダムユニコーンエピソード７,262555,0.8034954677047184
0,1663,28,一番くじガンダムユニコーンエピソード７,264218,0.8085847364780914
0,1705,29,一番くじガンダムユニコーンエピソード７,265923,0.8138025375957106
0,1585,30,一番くじガンダムユニコーンエピソード７,267508,0.8186531034440547
0,1453,31,一番くじガンダムユニコーンエピソード７,268961,0.823099710496196
0,2200,32,一番くじガンダムユニコーンエピソード７,271161,0.8298323570995758
0,1965,33,一番くじガンダムユニコーンエピソード７,273126,0.8358458346339582
0,1309,34,一番くじガンダムユニコーンエピソード７,274435,0.8398517593629692
0,1353,35,一番くじガンダムユニコーンエピソード７,275788,0.8439923370240477
0,1286,36,一番くじガンダムユニコーンエピソード７,277074,0.8479278749931143
0,1054,37,一番くじガンダムユニコーンエピソード７,278128,0.8511534247749154
0,1493,38,一番くじガンダムユニコーンエピソード７,279621,0.8557224435834817
0,1951,39,一番くじガンダムユニコーンエピソード７,281572,0.8616930770031154
0,1464,40,一番くじガンダムユニコーンエピソード７,283036,0.8661733472882736
0,989,41,一番くじガンダムユニコーンエピソード７,284025,0.8691999779658839
0,787,42,一番くじガンダムユニコーンエピソード７,284812,0.8716084292735474
0,807,43,一番くじガンダムユニコーンエピソード７,285619,0.8740780864594235
0,751,44,一番くじガンダムユニコーンエピソード７,286370,0.8763763671863046
0,921,45,一番くじガンダムユニコーンエピソード７,287291,0.8791948978779922
0,991,46,一番くじガンダムユニコーンエピソード７,288282,0.8822276491434238
0,970,47,一番くじガンダムユニコーンエピソード７,289252,0.885196134236732
0,753,48,一番くじガンダムユニコーンエピソード７,290005,0.8875005355514344
0,601,49,一番くじガンダムユニコーンエピソード７,290606,0.8893397721917213
0,811,50,一番くじガンダムユニコーンエピソード７,291417,0.8918216705532399
0,700,51,一番くじガンダムユニコーンエピソード７,292117,0.893963876290679
0,689,52,一番くじガンダムユニコーンエピソード７,292806,0.8960724187951011
0,984,53,一番くじガンダムユニコーンエピソード７,293790,0.8990837480031583
66,683,54,一番くじガンダムユニコーンエピソード７,294473,0.9011739287441166
0,602,55,一番くじガンダムユニコーンエピソード７,295075,0.9030162256783142
0,494,56,一番くじガンダムユニコーンエピソード７,295569,0.904528010870164
0,508,57,一番くじガンダムユニコーンエピソード７,296077,0.9060826401767625
0,436,58,一番くじガンダムユニコーンエピソード７,296513,0.907416928321796
0,563,59,一番くじガンダムユニコーンエピソード７,297076,0.9091398737934792
0,4665,0,一番くじワンピース麦わらの一味航海の軌跡,4665,0.0038075416258570027
611920,41109,1,一番くじワンピース麦わらの一味航海の軌跡,45774,0.03736043095004897
613200,76249,2,一番くじワンピース麦わらの一味航海の軌跡,122023,0.09959435194253999
80,72293,3,一番くじワンピース麦わらの一味航海の軌跡,194316,0.15859941234084232
0,80535,4,一番くじワンピース麦わらの一味航海の軌跡,274851,0.22433153770812927
0,74514,5,一番くじワンピース麦わらの一味航海の軌跡,349365,0.28514936336924585
0,58881,6,一番くじワンピース麦わらの一味航海の軌跡,408246,0.33320763956905
0,42324,7,一番くじワンピース麦わらの一味航海の軌跡,450570,0.3677522037218413
0,39359,8,一番くじワンピース麦わらの一味航海の軌跡,489929,0.3998767548155403
0,37222,9,一番くじワンピース麦わらの一味航海の軌跡,527151,0.4302571008814887
0,43104,10,一番くじワンピース麦わらの一味航海の軌跡,570255,0.4654382957884427
0,45599,11,一番くじワンピース麦わらの一味航海の軌跡,615854,0.5026558929154423
0,40053,12,一番くじワンピース麦わらの一味航海の軌跡,655907,0.5353468821416911
0,28784,13,一番くじワンピース麦わらの一味航海の軌跡,684691,0.5588401893568397
0,26023,14,一番くじワンピース麦わらの一味航海の軌跡,710714,0.5800799869409076
0,24809,15,一番くじワンピース麦わらの一味航海の軌跡,735523,0.6003289258896507
0,23194,16,一番くじワンピース麦わらの一味航海の軌跡,758717,0.6192597126999674
0,22106,17,一番くじワンピース麦わらの一味航海の軌跡,780823,0.6373024812275547
0,24461,18,一番くじワンピース麦わらの一味航海の軌跡,805284,0.6572673849167483
0,22841,19,一番くじワンピース麦わらの一味航海の軌跡,828125,0.6759100555011427
0,15494,20,一番くじワンピース麦わらの一味航海の軌跡,843619,0.6885561540972902
0,14752,21,一番くじワンピース麦わらの一味航海の軌跡,858371,0.7005966372837088
0,14121,22,一番くじワンピース麦わらの一味航海の軌跡,872492,0.7121221025138753
0,11364,23,一番くじワンピース麦わらの一味航海の軌跡,883856,0.7213973228860594
0,12466,24,一番くじワンピース麦わらの一味航海の軌跡,896322,0.7315719882468168
0,14154,25,一番くじワンピース麦わらの一味航海の軌跡,910476,0.7431243878550441
0,13567,26,一番くじワンピース麦わらの一味航海の軌跡,924043,0.7541976820111003
0,8464,27,一番くじワンピース麦わらの一味航海の軌跡,932507,0.7611059418870388
0,8440,28,一番くじワンピース麦わらの一味航海の軌跡,940947,0.7679946131243879
0,7710,29,一番くじワンピース麦わらの一味航海の軌跡,948657,0.7742874632713026
0,7551,30,一番くじワンピース麦わらの一味航海の軌跡,956208,0.7804505386875612
0,8231,31,一番くじワンピース麦わらの一味航海の軌跡,964439,0.7871686255305256
0,10742,32,一番くじワンピース麦わらの一味航海の軌跡,975181,0.7959361736859288
0,9739,33,一番くじワンピース麦わらの一味航海の軌跡,984920,0.8038850799869409
0,5750,34,一番くじワンピース麦わらの一味航海の軌跡,990670,0.8085781913157035
0,5320,35,一番くじワンピース麦わらの一味航海の軌跡,995990,0.8129203395364022
0,5922,36,一番くじワンピース麦わらの一味航海の軌跡,1001912,0.8177538361083905
0,5389,37,一番くじワンピース麦わらの一味航海の軌跡,1007301,0.8221523016650343
0,6122,38,一番くじワンピース麦わらの一味航海の軌跡,1013423,0.827149036891936
0,7118,39,一番くじワンピース麦わらの一味航海の軌跡,1020541,0.8329587006203069
0,6711,40,一番くじワンピース麦わらの一味航海の軌跡,1027252,0.8384361736859288
0,5035,41,一番くじワンピース麦わらの一味航海の軌跡,1032287,0.8425457068233758
0,4554,42,一番くじワンピース麦わらの一味航海の軌跡,1036841,0.8462626509957558
0,3764,43,一番くじワンピース麦わらの一味航海の軌跡,1040605,0.8493348024812275
0,3916,44,一番くじワンピース麦わらの一味航海の軌跡,1044521,0.8525310153444335
0,5444,45,一番くじワンピース麦わらの一味航海の軌跡,1049965,0.8569743715311786
0,5137,46,一番くじワンピース麦わらの一味航海の軌跡,1055102,0.8611671563826314
0,4975,47,一番くじワンピース麦わらの一味航海の軌跡,1060077,0.8652277179236043
0,3880,48,一番くじワンピース麦わらの一味航海の軌跡,1063957,0.8683945478289259
0,4283,49,一番くじワンピース麦わらの一味航海の軌跡,1068240,0.8718903036238982
0,4146,50,一番くじワンピース麦わらの一味航海の軌跡,1072386,0.8752742409402546
0,3962,51,一番くじワンピース麦わらの一味航海の軌跡,1076348,0.8785079986940908
0,2325,52,一番くじワンピース麦わらの一味航海の軌跡,1078673,0.88040564805746
0,3254,53,一番くじワンピース麦わらの一味航海の軌跡,1081927,0.8830615409729023
0,3084,54,一番くじワンピース麦わらの一味航海の軌跡,1085011,0.8855786810316683
0,2085,55,一番くじワンピース麦わらの一味航海の軌跡,1087096,0.8872804440091414
0,2117,56,一番くじワンピース麦わらの一味航海の軌跡,1089213,0.8890083251714006
0,2297,57,一番くじワンピース麦わらの一味航海の軌跡,1091510,0.890883121123082
0,2259,58,一番くじワンピース麦わらの一味航海の軌跡,1093769,0.8927269017303298
0,2515,59,一番くじワンピース麦わらの一味航海の軌跡,1096284,0.8947796278158668
0,1702,0,一番くじハリーポッター,1702,0.0020923176782403877
409202,25357,1,一番くじハリーポッター,27059,0.03326440896328241
404100,38095,2,一番くじハリーポッター,65154,0.08009569095656535
150,43008,3,一番くじハリーポッター,108162,0.1329666655192931
0,36645,4,一番くじハリーポッター,144807,0.17801542070091414
0,24570,5,一番くじハリーポッター,169377,0.2082200301923162
0,20656,6,一番くじハリーポッター,190033,0.23361304662106677
0,18886,7,一番くじハリーポッター,208919,0.2568301510107542
0,19111,8,一番くじハリーポッター,228030,0.2803238543884581
0,19959,9,一番くじハリーポッター,247989,0.3048600286187753
0,27636,10,一番くじハリーポッター,275625,0.33883376032021556
0,23989,11,一番くじハリーポッター,299614,0.36832412975811724
0,13543,12,一番くじハリーポッター,313157,0.38497293017903944
0,12951,13,一番くじハリーポッター,326108,0.40089396792926935
0,13435,14,一番くじハリーポッター,339543,0.4174100008359436
0,11007,15,一番くじハリーポッター,350550,0.4309412233297109
0,11467,16,一番くじハリーポッター,362017,0.4450379370878675
0,15548,17,一番くじハリーポッター,377565,0.46415154182422563
0,13871,18,一番くじハリーポッター,391436,0.4812035621032341
0,8026,19,一番くじハリーポッター,399462,0.49107015533799164
0,8083,20,一番くじハリーポッター,407545,0.5010068203163801
0,10576,21,一番くじハリーポッター,418121,0.5140082020819913
0,6457,22,一番くじハリーポッター,424578,0.5219459783736471
0,8494,23,一番くじハリーポッター,433072,0.532387897503479
0,13163,24,一番くじハリーポッター,446235,0.5485695529668622
0,10919,25,一番くじハリーポッター,457154,0.5619925945230941
0,7208,26,一番くじハリーポッター,464362,0.5708535967703073
0,6669,27,一番くじハリーポッター,471031,0.5790519907751164
0,6383,28,一番くじハリーポッター,477414,0.5868987967329357
0,6368,29,一番くじハリーポッター,483782,0.5947271627582206
0,7073,30,一番くじハリーポッター,490855,0.6034222056126237
0,11638,31,一番くじハリーポッター,502493,0.6177291346016729
0,9971,32,一番くじハリーポッター,512464,0.6299867724217286
0,5853,33,一番くじハリーポッター,518317,0.6371820340966646
0,5275,34,一番くじハリーポッター,523592,0.6436667437046071
0,4736,35,一番くじハリーポッター,528328,0.6494888450701455
0,5098,36,一番くじハリーポッター,533426,0.6557559634741816
0,6021,37,一番くじハリーポッター,539447,0.6631577523935033
0,7916,38,一番くじハリーポッター,547363,0.6728891194563417
0,7250,39,一番くじハリーポッター,554613,0.6818017535146511
0,3748,40,一番くじハリーポッター,558361,0.6864092779905883
0,3536,41,一番くじハリーポッター,561897,0.6907561847533721
0,3408,42,一番くじハリーポッター,565305,0.6949457374251954
0,3437,43,一番くじハリーポッター,568742,0.6991709406332519
0,3480,44,一番くじハリーポッター,572222,0.7034490049812404
0,4571,45,一番くじハリーポッター,576793,0.7090682670889001
0,4427,46,一番くじハリーポッター,581220,0.7145105058442293
0,2446,47,一番くじハリーポッター,583666,0.7175174441761776
0,2485,48,一番くじハリーポッター,586151,0.7205723263327154
0,2596,49,一番くじハリーポッター,588747,0.723763663990008
0,2799,50,一番くじハリーポッター,591546,0.7272045554009333
0,3788,51,一番くじハリーポッター,595334,0.7318612530302956
0,3426,52,一番くじハリーポッター,598760,0.7360729336211602
0,3120,53,一番くじハリーポッター,601880,0.7399084395883223
0,2588,54,一番くじハリーポッター,604468,0.74308994261493
0,2266,55,一番くじハリーポッター,606734,0.7458756017564651
0,2453,56,一番くじハリーポッター,609187,0.7488911453902627
0,3026,57,一番くじハリーポッター,612213,0.7526110944468758
0,2978,58,一番くじハリーポッター,615191,0.7562720357193786
0,3155,59,一番くじハリーポッター,618346,0.7601505681957879
0,1138,0,一番くじＶキャラマイドＦｒｅｅ！※,1138,0.019119623655913978
0,10031,1,一番くじＶキャラマイドＦｒｅｅ！※,11169,0.18765120967741936
59520,12003,2,一番くじＶキャラマイドＦｒｅｅ！※,23172,0.3893145161290323
0,6810,3,一番くじＶキャラマイドＦｒｅｅ！※,29982,0.5037298387096775
0,4182,4,一番くじＶキャラマイドＦｒｅｅ！※,34164,0.573991935483871
0,2683,5,一番くじＶキャラマイドＦｒｅｅ！※,36847,0.6190692204301075
0,2531,6,一番くじＶキャラマイドＦｒｅｅ！※,39378,0.6615927419354839
0,2069,7,一番くじＶキャラマイドＦｒｅｅ！※,41447,0.6963541666666667
0,2252,8,一番くじＶキャラマイドＦｒｅｅ！※,43699,0.734190188172043
0,1561,9,一番くじＶキャラマイドＦｒｅｅ！※,45260,0.7604166666666666
0,1183,10,一番くじＶキャラマイドＦｒｅｅ！※,46443,0.7802923387096774
0,908,11,一番くじＶキャラマイドＦｒｅｅ！※,47351,0.7955477150537634
0,928,12,一番くじＶキャラマイドＦｒｅｅ！※,48279,0.8111391129032258
0,639,13,一番くじＶキャラマイドＦｒｅｅ！※,48918,0.821875
0,778,14,一番くじＶキャラマイドＦｒｅｅ！※,49696,0.8349462365591398
0,696,15,一番くじＶキャラマイドＦｒｅｅ！※,50392,0.8466397849462366
0,595,16,一番くじＶキャラマイドＦｒｅｅ！※,50987,0.8566364247311828
0,509,17,一番くじＶキャラマイドＦｒｅｅ！※,51496,0.8651881720430108
0,559,18,一番くじＶキャラマイドＦｒｅｅ！※,52055,0.8745799731182796
0,467,19,一番くじＶキャラマイドＦｒｅｅ！※,52522,0.8824260752688172
0,264,20,一番くじＶキャラマイドＦｒｅｅ！※,52786,0.8868615591397849
0,294,21,一番くじＶキャラマイドＦｒｅｅ！※,53080,0.8918010752688172
0,461,22,一番くじＶキャラマイドＦｒｅｅ！※,53541,0.8995463709677419
0,344,23,一番くじＶキャラマイドＦｒｅｅ！※,53885,0.905325940860215
0,179,24,一番くじＶキャラマイドＦｒｅｅ！※,54064,0.9083333333333333
0,293,25,一番くじＶキャラマイドＦｒｅｅ！※,54357,0.9132560483870967
0,224,26,一番くじＶキャラマイドＦｒｅｅ！※,54581,0.9170194892473118
0,219,27,一番くじＶキャラマイドＦｒｅｅ！※,54800,0.9206989247311828
0,150,28,一番くじＶキャラマイドＦｒｅｅ！※,54950,0.9232190860215054
0,159,29,一番くじＶキャラマイドＦｒｅｅ！※,55109,0.9258904569892473
0,117,30,一番くじＶキャラマイドＦｒｅｅ！※,55226,0.9278561827956989
0,115,31,一番くじＶキャラマイドＦｒｅｅ！※,55341,0.9297883064516129
0,83,32,一番くじＶキャラマイドＦｒｅｅ！※,55424,0.9311827956989247
0,133,33,一番くじＶキャラマイドＦｒｅｅ！※,55557,0.9334173387096775
0,62,34,一番くじＶキャラマイドＦｒｅｅ！※,55619,0.9344590053763441
0,78,35,一番くじＶキャラマイドＦｒｅｅ！※,55697,0.9357694892473118
0,95,36,一番くじＶキャラマイドＦｒｅｅ！※,55792,0.9373655913978495
0,83,37,一番くじＶキャラマイドＦｒｅｅ！※,55875,0.9387600806451613
0,44,38,一番くじＶキャラマイドＦｒｅｅ！※,55919,0.9394993279569892
0,76,39,一番くじＶキャラマイドＦｒｅｅ！※,55995,0.9407762096774194
0,41,40,一番くじＶキャラマイドＦｒｅｅ！※,56036,0.9414650537634408
0,60,41,一番くじＶキャラマイドＦｒｅｅ！※,56096,0.9424731182795699
0,73,42,一番くじＶキャラマイドＦｒｅｅ！※,56169,0.9436995967741936
0,79,43,一番くじＶキャラマイドＦｒｅｅ！※,56248,0.9450268817204301
0,54,44,一番くじＶキャラマイドＦｒｅｅ！※,56302,0.9459341397849462
0,19,45,一番くじＶキャラマイドＦｒｅｅ！※,56321,0.9462533602150538
0,51,46,一番くじＶキャラマイドＦｒｅｅ！※,56372,0.9471102150537635
0,42,47,一番くじＶキャラマイドＦｒｅｅ！※,56414,0.9478158602150538
0,50,48,一番くじＶキャラマイドＦｒｅｅ！※,56464,0.9486559139784946
0,13,49,一番くじＶキャラマイドＦｒｅｅ！※,56477,0.9488743279569892
0,91,50,一番くじＶキャラマイドＦｒｅｅ！※,56568,0.9504032258064516
0,36,51,一番くじＶキャラマイドＦｒｅｅ！※,56604,0.9510080645161291
0,23,52,一番くじＶキャラマイドＦｒｅｅ！※,56627,0.9513944892473118
0,14,53,一番くじＶキャラマイドＦｒｅｅ！※,56641,0.9516297043010753
0,11,54,一番くじＶキャラマイドＦｒｅｅ！※,56652,0.9518145161290322
0,79,55,一番くじＶキャラマイドＦｒｅｅ！※,56731,0.9531418010752688
0,7,56,一番くじＶキャラマイドＦｒｅｅ！※,56738,0.9532594086021505
0,41,57,一番くじＶキャラマイドＦｒｅｅ！※,56779,0.9539482526881721
0,33,58,一番くじＶキャラマイドＦｒｅｅ！※,56812,0.954502688172043
0,64,59,一番くじＶキャラマイドＦｒｅｅ！※,56876,0.9555779569892473
0,17,0,一番くじプレミアム劇場版グレンラガン＊,17,0.00085
8900,900,1,一番くじプレミアム劇場版グレンラガン＊,917,0.04585
11100,2513,2,一番くじプレミアム劇場版グレンラガン＊,3430,0.1715
0,2420,3,一番くじプレミアム劇場版グレンラガン＊,5850,0.2925
0,2004,4,一番くじプレミアム劇場版グレンラガン＊,7854,0.3927
0,1258,5,一番くじプレミアム劇場版グレンラガン＊,9112,0.4556
0,1038,6,一番くじプレミアム劇場版グレンラガン＊,10150,0.5075
0,776,7,一番くじプレミアム劇場版グレンラガン＊,10926,0.5463
0,833,8,一番くじプレミアム劇場版グレンラガン＊,11759,0.58795
0,666,9,一番くじプレミアム劇場版グレンラガン＊,12425,0.62125
0,744,10,一番くじプレミアム劇場版グレンラガン＊,13169,0.65845
0,585,11,一番くじプレミアム劇場版グレンラガン＊,13754,0.6877
0,460,12,一番くじプレミアム劇場版グレンラガン＊,14214,0.7107
0,306,13,一番くじプレミアム劇場版グレンラガン＊,14520,0.726
0,370,14,一番くじプレミアム劇場版グレンラガン＊,14890,0.7445
0,319,15,一番くじプレミアム劇場版グレンラガン＊,15209,0.76045
0,261,16,一番くじプレミアム劇場版グレンラガン＊,15470,0.7735
0,364,17,一番くじプレミアム劇場版グレンラガン＊,15834,0.7917
0,226,18,一番くじプレミアム劇場版グレンラガン＊,16060,0.803
0,217,19,一番くじプレミアム劇場版グレンラガン＊,16277,0.81385
0,202,20,一番くじプレミアム劇場版グレンラガン＊,16479,0.82395
0,170,21,一番くじプレミアム劇場版グレンラガン＊,16649,0.83245
0,100,22,一番くじプレミアム劇場版グレンラガン＊,16749,0.83745
0,80,23,一番くじプレミアム劇場版グレンラガン＊,16829,0.84145
0,112,24,一番くじプレミアム劇場版グレンラガン＊,16941,0.84705
0,128,25,一番くじプレミアム劇場版グレンラガン＊,17069,0.85345
0,64,26,一番くじプレミアム劇場版グレンラガン＊,17133,0.85665
0,90,27,一番くじプレミアム劇場版グレンラガン＊,17223,0.86115
0,85,28,一番くじプレミアム劇場版グレンラガン＊,17308,0.8654
0,114,29,一番くじプレミアム劇場版グレンラガン＊,17422,0.8711
0,65,30,一番くじプレミアム劇場版グレンラガン＊,17487,0.87435
0,59,31,一番くじプレミアム劇場版グレンラガン＊,17546,0.8773
0,78,32,一番くじプレミアム劇場版グレンラガン＊,17624,0.8812
0,39,33,一番くじプレミアム劇場版グレンラガン＊,17663,0.88315
0,22,34,一番くじプレミアム劇場版グレンラガン＊,17685,0.88425
0,21,35,一番くじプレミアム劇場版グレンラガン＊,17706,0.8853
0,86,36,一番くじプレミアム劇場版グレンラガン＊,17792,0.8896
0,37,37,一番くじプレミアム劇場版グレンラガン＊,17829,0.89145
0,10,38,一番くじプレミアム劇場版グレンラガン＊,17839,0.89195
0,49,39,一番くじプレミアム劇場版グレンラガン＊,17888,0.8944
0,13,40,一番くじプレミアム劇場版グレンラガン＊,17901,0.89505
0,1,41,一番くじプレミアム劇場版グレンラガン＊,17902,0.8951
0,4,42,一番くじプレミアム劇場版グレンラガン＊,17906,0.8953
0,13,43,一番くじプレミアム劇場版グレンラガン＊,17919,0.89595
0,6,44,一番くじプレミアム劇場版グレンラガン＊,17925,0.89625
0,17,45,一番くじプレミアム劇場版グレンラガン＊,17942,0.8971
0,6,46,一番くじプレミアム劇場版グレンラガン＊,17948,0.8974
0,2,47,一番くじプレミアム劇場版グレンラガン＊,17950,0.8975
0,1,48,一番くじプレミアム劇場版グレンラガン＊,17951,0.89755
0,5,49,一番くじプレミアム劇場版グレンラガン＊,17956,0.8978
0,3,50,一番くじプレミアム劇場版グレンラガン＊,17959,0.89795
0,7,51,一番くじプレミアム劇場版グレンラガン＊,17966,0.8983
0,1,52,一番くじプレミアム劇場版グレンラガン＊,17967,0.89835
0,5,53,一番くじプレミアム劇場版グレンラガン＊,17972,0.8986
0,3,54,一番くじプレミアム劇場版グレンラガン＊,17975,0.89875
0,6,55,一番くじプレミアム劇場版グレンラガン＊,17981,0.89905
0,3,56,一番くじプレミアム劇場版グレンラガン＊,17984,0.8992
0,8,57,一番くじプレミアム劇場版グレンラガン＊,17992,0.8996
0,1,58,一番くじプレミアム劇場版グレンラガン＊,17993,0.89965
0,3,59,一番くじプレミアム劇場版グレンラガン＊,17996,0.8998
180,5211,0,一番くじラブライブサンシャイン６ｔｈ,5211,0.005798117364310034
457320,83143,1,一番くじラブライブサンシャイン６ｔｈ,88354,0.09830874335180363
441180,96369,2,一番くじラブライブサンシャイン６ｔｈ,184723,0.2055355275163006
0,64168,3,一番くじラブライブサンシャイン６ｔｈ,248891,0.2769332621225271
0,54660,4,一番くじラブライブサンシャイン６ｔｈ,303551,0.33775174132674635
0,42231,5,一番くじラブライブサンシャイン６ｔｈ,345782,0.3847408594254178
0,36026,6,一番くじラブライブサンシャイン６ｔｈ,381808,0.42482586732536665
0,34134,7,一番くじラブライブサンシャイン６ｔｈ,415942,0.46280570576584995
0,26406,8,一番くじラブライブサンシャイン６ｔｈ,442348,0.4921868393528718
0,22625,9,一番くじラブライブサンシャイン６ｔｈ,464973,0.5173609720275052
0,19454,10,一番くじラブライブサンシャイン６ｔｈ,484427,0.5390068317867236
0,17998,11,一番くじラブライブサンシャイン６ｔｈ,502425,0.5590326457039856
60,14861,12,一番くじラブライブサンシャイン６ｔｈ,517286,0.5755680174466475
0,13514,13,一番くじラブライブサンシャイン６ｔｈ,530800,0.5906046242517302
0,13026,14,一番くじラブライブサンシャイン６ｔｈ,543826,0.605098248659234
0,14741,15,一番くじラブライブサンシャイン６ｔｈ,558567,0.6215001001401963
0,13618,16,一番くじラブライブサンシャイン６ｔｈ,572185,0.6366524245054187
0,10508,17,一番くじラブライブサンシャイン６ｔｈ,582693,0.6483443487549235
0,9865,18,一番くじラブライブサンシャイン６ｔｈ,592558,0.6593208269354874
0,8691,19,一番くじラブライブサンシャイン６ｔｈ,601249,0.6689910318890891
0,7263,20,一番くじラブライブサンシャイン６ｔｈ,608512,0.6770723457284643
0,7659,21,一番くじラブライブサンシャイン６ｔｈ,616171,0.6855942764314484
0,9306,22,一番くじラブライブサンシャイン６ｔｈ,625477,0.6959487727262612
0,8165,23,一番くじラブライブサンシャイン６ｔｈ,633642,0.7050337138660792
0,5866,24,一番くじラブライブサンシャイン６ｔｈ,639508,0.7115606293255001
0,5213,25,一番くじラブライブサンシャイン６ｔｈ,644721,0.7173609720275052
0,5216,26,一番くじラブライブサンシャイン６ｔｈ,649937,0.7231646527360527
0,5053,27,一番くじラブライブサンシャイン６ｔｈ,654990,0.7287869684224582
0,7268,28,一番くじラブライブサンシャイン６ｔｈ,662258,0.7368738456060707
0,8162,29,一番くじラブライブサンシャイン６ｔｈ,670420,0.7459554487393462
0,6435,30,一番くじラブライブサンシャイン６ｔｈ,676855,0.7531154727729933
0,4479,31,一番くじラブライブサンシャイン６ｔｈ,681334,0.7580991165409351
0,4028,32,一番くじラブライブサンシャイン６ｔｈ,685362,0.7625809466586555
0,4434,33,一番くじラブライブサンシャイン６ｔｈ,689796,0.7675145203284598
0,4131,34,一番くじラブライブサンシャイン６ｔｈ,693927,0.7721109553374724
0,4130,35,一番くじラブライブサンシャイン６ｔｈ,698057,0.7767062776776376
0,5116,36,一番くじラブライブサンシャイン６ｔｈ,703173,0.7823986915014354
0,4472,37,一番くじラブライブサンシャイン６ｔｈ,707645,0.7873745465874447
0,3619,38,一番くじラブライブサンシャイン６ｔｈ,711264,0.7914012951465385
0,3202,39,一番くじラブライブサンシャイン６ｔｈ,714466,0.7949640607962258
0,2874,40,一番くじラブライブサンシャイン６ｔｈ,717340,0.798161871063934
0,2527,41,一番くじラブライブサンシャイン６ｔｈ,719867,0.8009735852415604
0,2911,42,一番くじラブライブサンシャイン６ｔｈ,722778,0.8042125642566259
0,3454,43,一番くじラブライブサンシャイン６ｔｈ,726232,0.8080557224558826
0,3553,44,一番くじラブライブサンシャイン６ｔｈ,729785,0.8120090348710417
0,2525,45,一番くじラブライブサンシャイン６ｔｈ,732310,0.8148185237109732
0,1851,46,一番くじラブライブサンシャイン６ｔｈ,734161,0.8168780737476912
0,2032,47,一番くじラブライブサンシャイン６ｔｈ,736193,0.8191390168458064
0,1705,48,一番くじラブライブサンシャイン６ｔｈ,737898,0.8210361172307897
0,2320,49,一番くじラブライブサンシャイン６ｔｈ,740218,0.8236175089569843
0,2981,50,一番くじラブライブサンシャイン６ｔｈ,743199,0.8269343747913745
0,2671,51,一番くじラブライブサンシャイン６ｔｈ,745870,0.8299063132830407
0,2004,52,一番くじラブライブサンシャイン６ｔｈ,747874,0.8321361016534259
0,1945,53,一番くじラブライブサンシャイン６ｔｈ,749819,0.8343002425618088
0,1801,54,一番くじラブライブサンシャイン６ｔｈ,751620,0.836304159156152
0,1855,55,一番くじラブライブサンシャイン６ｔｈ,753475,0.83836815986826
0,1750,56,一番くじラブライブサンシャイン６ｔｈ,755225,0.8403153303513808
0,2401,57,一番くじラブライブサンシャイン６ｔｈ,757626,0.8429868482542225
0,2302,58,一番くじラブライブサンシャイン６ｔｈ,759928,0.845548211941162
0,2065,59,一番くじラブライブサンシャイン６ｔｈ,761993,0.8478458731112446
630,2570,0,一番くじモンスターストライクｖｏｌ．５,2570,0.007844932844932845
187390,18074,1,一番くじモンスターストライクｖｏｌ．５,20644,0.06301587301587301
139440,41008,2,一番くじモンスターストライクｖｏｌ．５,61652,0.1881929181929182
70,39517,3,一番くじモンスターストライクｖｏｌ．５,101169,0.30881868131868134
70,30060,4,一番くじモンスターストライクｖｏｌ．５,131229,0.40057692307692305
0,24029,5,一番くじモンスターストライクｖｏｌ．５,155258,0.47392551892551893
0,18296,6,一番くじモンスターストライクｖｏｌ．５,173554,0.5297741147741147
0,15600,7,一番くじモンスターストライクｖｏｌ．５,189154,0.5773931623931624
0,18682,8,一番くじモンスターストライクｖｏｌ．５,207836,0.6344200244200244
0,17097,9,一番くじモンスターストライクｖｏｌ．５,224933,0.6866086691086691
0,10450,10,一番くじモンスターストライクｖｏｌ．５,235383,0.718507326007326
0,10505,11,一番くじモンスターストライクｖｏｌ．５,245888,0.7505738705738706
0,6039,12,一番くじモンスターストライクｖｏｌ．５,251927,0.7690079365079365
0,4967,13,一番くじモンスターストライクｖｏｌ．５,256894,0.7841697191697191
0,5735,14,一番くじモンスターストライクｖｏｌ．５,262629,0.8016758241758242
0,8513,15,一番くじモンスターストライクｖｏｌ．５,271142,0.8276617826617827
0,6933,16,一番くじモンスターストライクｖｏｌ．５,278075,0.8488247863247863
0,3934,17,一番くじモンスターストライクｖｏｌ．５,282009,0.8608333333333333
0,2859,18,一番くじモンスターストライクｖｏｌ．５,284868,0.8695604395604396
0,2866,19,一番くじモンスターストライクｖｏｌ．５,287734,0.8783089133089134
0,2837,20,一番くじモンスターストライクｖｏｌ．５,290571,0.8869688644688645
0,2476,21,一番くじモンスターストライクｖｏｌ．５,293047,0.894526862026862
0,3541,22,一番くじモンスターストライクｖｏｌ．５,296588,0.9053357753357754
0,2784,23,一番くじモンスターストライクｖｏｌ．５,299372,0.9138339438339438
0,2073,24,一番くじモンスターストライクｖｏｌ．５,301445,0.9201617826617826
0,1337,25,一番くじモンスターストライクｖｏｌ．５,302782,0.9242429792429793
0,1234,26,一番くじモンスターストライクｖｏｌ．５,304016,0.928009768009768
0,1157,27,一番くじモンスターストライクｖｏｌ．５,305173,0.9315415140415141
0,1258,28,一番くじモンスターストライクｖｏｌ．５,306431,0.9353815628815629
0,1633,29,一番くじモンスターストライクｖｏｌ．５,308064,0.9403663003663003
0,1428,30,一番くじモンスターストライクｖｏｌ．５,309492,0.9447252747252747
0,904,31,一番くじモンスターストライクｖｏｌ．５,310396,0.9474847374847375
0,755,32,一番くじモンスターストライクｖｏｌ．５,311151,0.9497893772893773
0,758,33,一番くじモンスターストライクｖｏｌ．５,311909,0.9521031746031746
0,850,34,一番くじモンスターストライクｖｏｌ．５,312759,0.9546978021978022
0,650,35,一番くじモンスターストライクｖｏｌ．５,313409,0.9566819291819292
0,3198,36,一番くじモンスターストライクｖｏｌ．５,316607,0.9664438339438339
0,844,37,一番くじモンスターストライクｖｏｌ．５,317451,0.9690201465201466
0,453,38,一番くじモンスターストライクｖｏｌ．５,317904,0.9704029304029304
0,467,39,一番くじモンスターストライクｖｏｌ．５,318371,0.9718284493284494
0,376,40,一番くじモンスターストライクｖｏｌ．５,318747,0.9729761904761904
0,448,41,一番くじモンスターストライクｖｏｌ．５,319195,0.9743437118437118
0,373,42,一番くじモンスターストライクｖｏｌ．５,319568,0.9754822954822955
0,602,43,一番くじモンスターストライクｖｏｌ．５,320170,0.9773199023199023
0,551,44,一番くじモンスターストライクｖｏｌ．５,320721,0.9790018315018315
0,469,45,一番くじモンスターストライクｖｏｌ．５,321190,0.9804334554334554
0,527,46,一番くじモンスターストライクｖｏｌ．５,321717,0.9820421245421246
0,420,47,一番くじモンスターストライクｖｏｌ．５,322137,0.9833241758241759
0,294,48,一番くじモンスターストライクｖｏｌ．５,322431,0.9842216117216117
0,402,49,一番くじモンスターストライクｖｏｌ．５,322833,0.9854487179487179
0,488,50,一番くじモンスターストライクｖｏｌ．５,323321,0.9869383394383394
0,550,51,一番くじモンスターストライクｖｏｌ．５,323871,0.9886172161172161
0,338,52,一番くじモンスターストライクｖｏｌ．５,324209,0.9896489621489621
0,260,53,一番くじモンスターストライクｖｏｌ．５,324469,0.9904426129426129
0,264,54,一番くじモンスターストライクｖｏｌ．５,324733,0.9912484737484738
0,293,55,一番くじモンスターストライクｖｏｌ．５,325026,0.9921428571428571
0,260,56,一番くじモンスターストライクｖｏｌ．５,325286,0.9929365079365079
0,297,57,一番くじモンスターストライクｖｏｌ．５,325583,0.9938431013431014
0,332,58,一番くじモンスターストライクｖｏｌ．５,325915,0.9948565323565324
0,186,59,一番くじモンスターストライクｖｏｌ．５,326101,0.9954242979242979
0,1893,0,一番くじ進撃の巨人自由への進撃※,1893,0.006949339207048458
145200,11316,1,一番くじ進撃の巨人自由への進撃※,13209,0.04849118942731277
126900,16300,2,一番くじ進撃の巨人自由への進撃※,29509,0.10832966226138033
0,12396,3,一番くじ進撃の巨人自由への進撃※,41905,0.15383627019089574
0,13004,4,一番くじ進撃の巨人自由への進撃※,54909,0.20157488986784142
0,11302,5,一番くじ進撃の巨人自由への進撃※,66211,0.24306534508076358
0,8162,6,一番くじ進撃の巨人自由への進撃※,74373,0.2730286343612335
0,6449,7,一番くじ進撃の巨人自由への進撃※,80822,0.2967033773861968
0,6029,8,一番くじ進撃の巨人自由への進撃※,86851,0.3188362701908957
0,5047,9,一番くじ進撃の巨人自由への進撃※,91898,0.33736417033773863
0,5013,10,一番くじ進撃の巨人自由への進撃※,96911,0.35576725403817916
0,5135,11,一番くじ進撃の巨人自由への進撃※,102046,0.37461820851688693
0,5472,12,一番くじ進撃の巨人自由への進撃※,107518,0.3947063142437592
0,4205,13,一番くじ進撃の巨人自由への進撃※,111723,0.4101431718061674
0,4556,14,一番くじ進撃の巨人自由への進撃※,116279,0.42686857562408226
100,3942,15,一番くじ進撃の巨人自由への進撃※,120221,0.44133994126284876
0,4309,16,一番くじ進撃の巨人自由への進撃※,124530,0.45715859030837
0,4100,17,一番くじ進撃の巨人自由への進撃※,128630,0.4722099853157122
100,3873,18,一番くじ進撃の巨人自由への進撃※,132503,0.486428046989721
0,3583,19,一番くじ進撃の巨人自由への進撃※,136086,0.49958149779735683
0,3595,20,一番くじ進撃の巨人自由への進撃※,139681,0.5127790014684288
0,3296,21,一番くじ進撃の巨人自由への進撃※,142977,0.5248788546255506
0,3539,22,一番くじ進撃の巨人自由への進撃※,146516,0.537870778267254
0,4315,23,一番くじ進撃の巨人自由への進撃※,150831,0.5537114537444934
100,3638,24,一番くじ進撃の巨人自由への進撃※,154469,0.5670668135095448
0,3658,25,一番くじ進撃の巨人自由への進撃※,158127,0.5804955947136564
0,3251,26,一番くじ進撃の巨人自由への進撃※,161378,0.5924302496328928
0,2864,27,一番くじ進撃の巨人自由への進撃※,164242,0.6029441997063143
0,2620,28,一番くじ進撃の巨人自由への進撃※,166862,0.6125624082232012
0,2583,29,一番くじ進撃の巨人自由への進撃※,169445,0.6220447870778267
0,2003,30,一番くじ進撃の巨人自由への進撃※,171448,0.6293979441997063
0,2566,31,一番くじ進撃の巨人自由への進撃※,174014,0.6388179148311307
0,3009,32,一番くじ進撃の巨人自由への進撃※,177023,0.6498641703377386
0,2550,33,一番くじ進撃の巨人自由への進撃※,179573,0.6592254038179148
0,2229,34,一番くじ進撃の巨人自由への進撃※,181802,0.6674082232011748
0,1644,35,一番くじ進撃の巨人自由への進撃※,183446,0.6734434654919237
0,1614,36,一番くじ進撃の巨人自由への進撃※,185060,0.6793685756240823
0,1400,37,一番くじ進撃の巨人自由への進撃※,186460,0.6845080763582966
0,1658,38,一番くじ進撃の巨人自由への進撃※,188118,0.6905947136563877
0,2368,39,一番くじ進撃の巨人自由への進撃※,190486,0.699287812041116
0,2056,40,一番くじ進撃の巨人自由への進撃※,192542,0.7068355359765052
0,1361,41,一番くじ進撃の巨人自由への進撃※,193903,0.7118318649045521
0,1275,42,一番くじ進撃の巨人自由への進撃※,195178,0.7165124816446402
0,1226,43,一番くじ進撃の巨人自由への進撃※,196404,0.7210132158590309
0,1115,44,一番くじ進撃の巨人自由への進撃※,197519,0.7251064610866373
0,1469,45,一番くじ進撃の巨人自由への進撃※,198988,0.7304992657856094
0,1900,46,一番くじ進撃の巨人自由への進撃※,200888,0.737474302496329
0,1795,47,一番くじ進撃の巨人自由への進撃※,202683,0.7440638766519824
0,1178,48,一番くじ進撃の巨人自由への進撃※,203861,0.7483883994126285
0,954,49,一番くじ進撃の巨人自由への進撃※,204815,0.7518906020558003
0,1045,50,一番くじ進撃の巨人自由への進撃※,205860,0.755726872246696
0,1063,51,一番くじ進撃の巨人自由への進撃※,206923,0.7596292217327459
0,967,52,一番くじ進撃の巨人自由への進撃※,207890,0.763179148311307
0,1436,53,一番くじ進撃の巨人自由への進撃※,209326,0.7684508076358296
0,1251,54,一番くじ進撃の巨人自由への進撃※,210577,0.7730433186490455
0,894,55,一番くじ進撃の巨人自由への進撃※,211471,0.7763252569750367
0,825,56,一番くじ進撃の巨人自由への進撃※,212296,0.7793538913362702
0,739,57,一番くじ進撃の巨人自由への進撃※,213035,0.7820668135095448
0,579,58,一番くじ進撃の巨人自由への進撃※,213614,0.7841923641703378
0,670,59,一番くじ進撃の巨人自由への進撃※,214284,0.7866519823788546
6480,38659,0,一番くじドラゴンボールＶＳオムニバスＺ,38659,0.03145053693459161
618400,324826,1,一番くじドラゴンボールＶＳオムニバスＺ,363485,0.2957085909534657
604320,313891,2,一番くじドラゴンボールＶＳオムニバスＺ,677376,0.5510706150341685
0,135517,3,一番くじドラゴンボールＶＳオムニバスＺ,812893,0.6613187438984706
0,90964,4,一番くじドラゴンボールＶＳオムニバスＺ,903857,0.7353213472177026
0,68201,5,一番くじドラゴンボールＶＳオムニバスＺ,972058,0.7908054018874064
0,49178,6,一番くじドラゴンボールＶＳオムニバスＺ,1021236,0.8308135372600065
0,42473,7,一番くじドラゴンボールＶＳオムニバスＺ,1063709,0.865366905304263
0,49537,8,一番くじドラゴンボールＶＳオムニバスＺ,1113246,0.9056671005532053
0,33401,9,一番くじドラゴンボールＶＳオムニバスＺ,1146647,0.9328400585746828
0,15333,10,一番くじドラゴンボールＶＳオムニバスＺ,1161980,0.9453140253823625
0,11385,11,一番くじドラゴンボールＶＳオムニバスＺ,1173365,0.9545761470875366
0,9078,12,一番くじドラゴンボールＶＳオムニバスＺ,1182443,0.9619614383338757
0,5910,13,一番くじドラゴンボールＶＳオムニバスＺ,1188353,0.9667694435405142
0,5686,14,一番くじドラゴンボールＶＳオムニバスＺ,1194039,0.9713952164009112
0,5659,15,一番くじドラゴンボールＶＳオムニバスＺ,1199698,0.975999023755288
0,4536,16,一番くじドラゴンボールＶＳオムニバスＺ,1204234,0.9796892287666775
0,2409,17,一番くじドラゴンボールＶＳオムニバスＺ,1206643,0.9816490400260331
0,1646,18,一番くじドラゴンボールＶＳオムニバスＺ,1208289,0.9829881223560039
0,1733,19,一番くじドラゴンボールＶＳオムニバスＺ,1210022,0.9843979824275951
0,1155,20,一番くじドラゴンボールＶＳオムニバスＺ,1211177,0.9853376179629026
0,1075,21,一番くじドラゴンボールＶＳオムニバスＺ,1212252,0.9862121705174097
0,1192,22,一番くじドラゴンボールＶＳオムニバスＺ,1213444,0.9871819069313374
0,1320,23,一番くじドラゴンボールＶＳオムニバスＺ,1214764,0.9882557761145461
0,774,24,一番くじドラゴンボールＶＳオムニバスＺ,1215538,0.9888854539537911
0,612,25,一番くじドラゴンボールＶＳオムニバスＺ,1216150,0.9893833387569151
0,310,26,一番くじドラゴンボールＶＳオムニバスＺ,1216460,0.9896355353075171
0,532,27,一番くじドラゴンボールＶＳオムニバスＺ,1216992,0.9900683371298405
0,362,28,一番くじドラゴンボールＶＳオムニバスＺ,1217354,0.990362837617963
0,516,29,一番くじドラゴンボールＶＳオムニバスＺ,1217870,0.9907826228441262
0,183,30,一番くじドラゴンボールＶＳオムニバスＺ,1218053,0.9909315001627075
0,218,31,一番くじドラゴンボールＶＳオムニバスＺ,1218271,0.9911088512853888
0,228,32,一番くじドラゴンボールＶＳオムニバスＺ,1218499,0.9912943377806703
0,363,33,一番くじドラゴンボールＶＳオムニバスＺ,1218862,0.9915896518060527
0,251,34,一番くじドラゴンボールＶＳオムニバスＺ,1219113,0.9917938496583143
0,117,35,一番くじドラゴンボールＶＳオムニバスＺ,1219230,0.9918890335177352
0,461,36,一番くじドラゴンボールＶＳオムニバスＺ,1219691,0.9922640741945982
0,274,37,一番くじドラゴンボールＶＳオムニバスＺ,1219965,0.9924869834038399
0,111,38,一番くじドラゴンボールＶＳオムニバスＺ,1220076,0.9925772860397006
0,178,39,一番くじドラゴンボールＶＳオムニバスＺ,1220254,0.9927220956719818
0,70,40,一番くじドラゴンボールＶＳオムニバスＺ,1220324,0.9927790432801822
0,21,41,一番くじドラゴンボールＶＳオムニバスＺ,1220345,0.9927961275626423
0,37,42,一番くじドラゴンボールＶＳオムニバスＺ,1220382,0.9928262284412626
0,91,43,一番くじドラゴンボールＶＳオムニバスＺ,1220473,0.9929002603319232
0,96,44,一番くじドラゴンボールＶＳオムニバスＺ,1220569,0.9929783599088838
0,104,45,一番くじドラゴンボールＶＳオムニバスＺ,1220673,0.9930629677839246
0,8,46,一番くじドラゴンボールＶＳオムニバスＺ,1220681,0.9930694760820046
0,23,47,一番くじドラゴンボールＶＳオムニバスＺ,1220704,0.9930881874389847
0,46,48,一番くじドラゴンボールＶＳオムニバスＺ,1220750,0.993125610152945
0,72,49,一番くじドラゴンボールＶＳオムニバスＺ,1220822,0.9931841848356655
0,14,50,一番くじドラゴンボールＶＳオムニバスＺ,1220836,0.9931955743573055
0,24,51,一番くじドラゴンボールＶＳオムニバスＺ,1220860,0.9932150992515457
0,64,52,一番くじドラゴンボールＶＳオムニバスＺ,1220924,0.9932671656361861
0,32,53,一番くじドラゴンボールＶＳオムニバスＺ,1220956,0.9932931988285063
0,19,54,一番くじドラゴンボールＶＳオムニバスＺ,1220975,0.9933086560364465
0,52,55,一番くじドラゴンボールＶＳオムニバスＺ,1221027,0.9933509599739668
0,73,56,一番くじドラゴンボールＶＳオムニバスＺ,1221100,0.9934103481939472
0,18,57,一番くじドラゴンボールＶＳオムニバスＺ,1221118,0.9934249918646274
0,26,58,一番くじドラゴンボールＶＳオムニバスＺ,1221144,0.9934461438333876
0,5,59,一番くじドラゴンボールＶＳオムニバスＺ,1221149,0.9934502115196876
0,0,0,一番くじワンピースベストオブオムニバス,0,0.0
0,30476,1,一番くじワンピースベストオブオムニバス,30476,0.0206164087022405
742080,366599,2,一番くじワンピースベストオブオムニバス,397075,0.2686133510120143
735920,358636,3,一番くじワンピースベストオブオムニバス,755711,0.5112234819785691
160,177873,4,一番くじワンピースベストオブオムニバス,933584,0.6315510336616517
80,113415,5,一番くじワンピースベストオブオムニバス,1046999,0.708274028574521
0,78910,6,一番くじワンピースベストオブオムニバス,1125909,0.7616550763069596
0,51096,7,一番くじワンピースベストオブオムニバス,1177005,0.7962205054659596
0,33480,8,一番くじワンピースベストオブオムニバス,1210485,0.8188690605043836
0,27708,9,一番くじワンピースベストオブオムニバス,1238193,0.8376129721831367
0,22114,10,一番くじワンピースベストオブオムニバス,1260307,0.8525726539668795
0,22213,11,一番くじワンピースベストオブオムニバス,1282520,0.8675993072843381
0,22083,12,一番くじワンピースベストオブオムニバス,1304603,0.8825380181837861
0,19243,13,一番くじワンピースベストオブオムニバス,1323846,0.8955555254897716
0,11937,14,一番くじワンピースベストオブオムニバス,1335783,0.903630668903561
0,10379,15,一番くじワンピースベストオブオムニバス,1346162,0.9106518562615001
0,8954,16,一番くじワンピースベストオブオムニバス,1355116,0.9167090594220154
0,7386,17,一番くじワンピースベストオブオムニバス,1362502,0.921705541725295
0,7742,18,一番くじワンピースベストオブオムニバス,1370244,0.9269428509578959
0,10186,19,一番くじワンピースベストオブオムニバス,1380430,0.9338334776490962
0,8441,20,一番くじワンピースベストオブオムニバス,1388871,0.9395436464985388
0,6796,21,一番くじワンピースベストオブオムニバス,1395667,0.944141005520078
0,5725,22,一番くじワンピースベストオブオムニバス,1401392,0.9480138543132374
0,5212,23,一番くじワンピースベストオブオムニバス,1406604,0.9515396687953241
0,4615,24,一番くじワンピースベストオブオムニバス,1411219,0.9546616246347007
0,4471,25,一番くじワンピースベストオブオムニバス,1415690,0.957686167334127
0,3599,26,一番くじワンピースベストオブオムニバス,1419289,0.9601208193527438
0,3447,27,一番くじワンピースベストオブオムニバス,1422736,0.962452646390302
0,2591,28,一番くじワンピースベストオブオムニバス,1425327,0.9642054064292672
0,2080,29,一番くじワンピースベストオブオムニバス,1427407,0.9656124851174369
0,1936,30,一番くじワンピースベストオブオムニバス,1429343,0.9669221506656565
0,1766,31,一番くじワンピースベストオブオムニバス,1431109,0.9681168145903236
0,2119,32,一番くじワンピースベストオブオムニバス,1433228,0.9695502760038965
0,1983,33,一番くじワンピースベストオブオムニバス,1435211,0.9708917361186276
0,1715,34,一番くじワンピースベストオブオムニバス,1436926,0.9720518995562291
0,1499,35,一番くじワンピースベストオブオムニバス,1438425,0.9730659432839052
0,1537,36,一番くじワンピースベストオブオムニバス,1439962,0.9741056932568459
0,1423,37,一番くじワンピースベストオブオムニバス,1441385,0.9750683244939928
0,1415,38,一番くじワンピースベストオブオムニバス,1442800,0.9760255438900314
0,1212,39,一番くじワンピースベストオブオムニバス,1444012,0.9768454378179456
0,1307,40,一番くじワンピースベストオブオムニバス,1445319,0.9777295973590215
0,1441,41,一番くじワンピースベストオブオムニバス,1446760,0.9787044052386622
0,957,42,一番くじワンピースベストオブオムニバス,1447717,0.979351796731248
0,947,43,一番くじワンピースベストオブオムニバス,1448664,0.9799924234224483
0,946,44,一番くじワンピースベストオブオムニバス,1449610,0.9806323736335101
0,650,45,一番くじワンピースベストオブオムニバス,1450260,0.9810720857235632
0,846,46,一番くじワンピースベストオブオムニバス,1451106,0.9816443879207707
0,1990,47,一番くじワンピースベストオブオムニバス,1453096,0.9829905833964715
0,1203,48,一番くじワンピースベストオブオムニバス,1454299,0.9838043890031388
0,824,49,一番くじワンピースベストオブオムニバス,1455123,0.9843618086372984
0,739,50,一番くじワンピースベストオブオムニバス,1455862,0.9848617274596818
0,615,51,一番くじワンピースベストオブオムニバス,1456477,0.9852777627448858
0,616,52,一番くじワンピースベストオブオムニバス,1457093,0.9856944745102284
0,682,53,一番くじワンピースベストオブオムニバス,1457775,0.9861558339647148
0,616,54,一番くじワンピースベストオブオムニバス,1458391,0.9865725457300574
0,586,55,一番くじワンピースベストオブオムニバス,1458977,0.9869689630912436
0,328,56,一番くじワンピースベストオブオムニバス,1459305,0.9871908485766858
0,229,57,一番くじワンピースベストオブオムニバス,1459534,0.9873457625284122
0,245,58,一番くじワンピースベストオブオムニバス,1459779,0.9875115001623552
0,320,59,一番くじワンピースベストオブオムニバス,1460099,0.9877279738066891
0,4315,0,一番くじ物語シリーズ～くじ、ぱないの！～,4315,0.012401135788844438
177210,47703,1,一番くじ物語シリーズ～くじ、ぱないの！～,52018,0.14949763185726767
170676,58521,2,一番くじ物語シリーズ～くじ、ぱないの！～,110539,0.31768462316641377
0,48104,3,一番くじ物語シリーズ～くじ、ぱないの！～,158643,0.4559335770451097
0,34637,4,一番くじ物語シリーズ～くじ、ぱないの！～,193280,0.5554789166321792
0,24182,5,一番くじ物語シリーズ～くじ、ぱないの！～,217462,0.6249770083229871
0,19343,6,一番くじ物語シリーズ～くじ、ぱないの！～,236805,0.6805680093806042
0,15953,7,一番くじ物語シリーズ～くじ、ぱないの！～,252758,0.726416287303996
0,11642,8,一番くじ物語シリーズ～くじ、ぱないの！～,264400,0.7598749252770497
0,10339,9,一番くじ物語シリーズ～くじ、ぱないの！～,274739,0.789588793856624
0,9148,10,一番くじ物語シリーズ～くじ、ぱないの！～,283887,0.8158797765208994
0,5443,11,一番くじ物語シリーズ～くじ、ぱないの！～,289330,0.8315227387685658
0,4705,12,一番くじ物語シリーズ～くじ、ぱないの！～,294035,0.8450447188117901
0,3931,13,一番くじ物語シリーズ～くじ、ぱないの！～,297966,0.8563422541040143
66,3336,14,一番くじ物語シリーズ～くじ、ぱないの！～,301302,0.8659297834184025
0,3102,15,一番くじ物語シリーズ～くじ、ぱないの！～,304404,0.8748448061801628
0,2498,16,一番くじ物語シリーズ～くじ、ぱないの！～,306902,0.8820239573274474
0,2493,17,一番くじ物語シリーズ～くじ、ぱないの！～,309395,0.8891887386765991
0,2432,18,一番くじ物語シリーズ～くじ、ぱないの！～,311827,0.8961782084885271
0,2080,19,一番くじ物語シリーズ～くじ、ぱないの！～,313907,0.9021560445118867
0,1494,20,一番くじ物語シリーズ～くじ、ぱないの！～,315401,0.9064497401940498
0,1923,21,一番くじ物語シリーズ～くじ、ぱないの！～,317324,0.9119763645560307
0,1993,22,一番くじ物語シリーズ～くじ、ぱないの！～,319317,0.9177041660918748
0,1519,23,一番くじ物語シリーズ～くじ、ぱないの！～,320836,0.9220697107647032
0,1539,24,一番くじ物語シリーズ～くじ、ぱないの！～,322375,0.9264927346300639
0,1443,25,一番くじ物語シリーズ～くじ、ぱないの！～,323818,0.9306398583712696
0,1033,26,一番くじ物語シリーズ～くじ、ぱないの！～,324851,0.9336086586655631
0,895,27,一番くじ物語シリーズ～くじ、ぱないの！～,325746,0.9361808525313836
0,776,28,一番くじ物語シリーズ～くじ、ぱないの！～,326522,0.938411045201637
0,640,29,一番くじ物語シリーズ～くじ、ぱないの！～,327162,0.9402503793626708
0,808,30,一番くじ物語シリーズ～くじ、ぱないの！～,327970,0.9425725387409758
0,694,31,一番くじ物語シリーズ～くじ、ぱないの！～,328664,0.9445670667218466
0,644,32,一番くじ物語シリーズ～くじ、ぱないの！～,329308,0.9464178967213869
0,421,33,一番くじ物語シリーズ～くじ、ぱないの！～,329729,0.9476278337241918
0,338,34,一番くじ物語シリーズ～くじ、ぱないの！～,330067,0.9485992320779878
0,457,35,一番くじ物語シリーズ～くじ、ぱないの！～,330524,0.9499126316273508
0,366,36,一番くじ物語シリーズ～くじ、ぱないの！～,330890,0.9509645008506921
0,429,37,一番くじ物語シリーズ～くじ、ぱないの！～,331319,0.95219742953051
0,443,38,一番くじ物語シリーズ～くじ、ぱないの！～,331762,0.9534705936451005
0,509,39,一番くじ物語シリーズ～くじ、ぱないの！～,332271,0.9549334390950476
0,404,40,一番くじ物語シリーズ～くじ、ぱないの！～,332675,0.9560945187842002
0,310,41,一番くじ物語シリーズ～くじ、ぱないの！～,332985,0.9569854462684508
0,295,42,一番くじ物語シリーズ～くじ、ぱないの！～,333280,0.9578332643583023
0,305,43,一番くじ物語シリーズ～くじ、ぱないの！～,333585,0.9587098220444199
0,274,44,一番くじ物語シリーズ～くじ、ぱないの！～,333859,0.9594972869821125
0,343,45,一番くじ物語シリーズ～くじ、ぱないの！～,334202,0.9604830551340415
0,260,46,一番くじ物語シリーズ～くじ、ぱないの！～,334462,0.9612302846369615
0,215,47,一番くじ物語シリーズ～くじ、ぱないの！～,334677,0.9618481859566836
0,174,48,一番くじ物語シリーズ～くじ、ぱないの！～,334851,0.9623482549317147
0,142,49,一番くじ物語シリーズ～くじ、ぱないの！～,334993,0.9627563571986941
0,123,50,一番くじ物語シリーズ～くじ、ぱないの！～,335116,0.9631098542327677
0,188,51,一番くじ物語シリーズ～くじ、ぱないの！～,335304,0.9636501586425714
0,299,52,一番くじ物語シリーズ～くじ、ぱないの！～,335603,0.9645094725709293
0,269,53,一番くじ物語シリーズ～くじ、ぱないの！～,335872,0.9652825677104888
0,196,54,一番くじ物語シリーズ～くじ、ぱないの！～,336068,0.9658458637973054
0,93,55,一番くじ物語シリーズ～くじ、ぱないの！～,336161,0.9661131420425806
0,134,56,一番くじ物語シリーズ～くじ、ぱないの！～,336295,0.9664982526325471
0,127,57,一番くじ物語シリーズ～くじ、ぱないの！～,336422,0.9668632455051271
0,110,58,一番くじ物語シリーズ～くじ、ぱないの！～,336532,0.9671793810640548
0,154,59,一番くじ物語シリーズ～くじ、ぱないの！～,336686,0.9676219708465535
0,2913,0,一番くじディズニーツムツム,2913,0.0036339820359281437
403000,42144,1,一番くじディズニーツムツム,45057,0.05620883233532934
398550,83756,2,一番くじディズニーツムツム,128813,0.1606948602794411
50,105693,3,一番くじディズニーツムツム,234506,0.29254740518962075
0,85890,4,一番くじディズニーツムツム,320396,0.39969560878243515
0,51122,5,一番くじディズニーツムツム,371518,0.46347055888223554
0,43456,6,一番くじディズニーツムツム,414974,0.5176821357285429
0,36397,7,一番くじディズニーツムツム,451371,0.5630875748502994
0,31832,8,一番くじディズニーツムツム,483203,0.6027981536926148
0,33941,9,一番くじディズニーツムツム,517144,0.6451397205588822
0,37980,10,一番くじディズニーツムツム,555124,0.6925199600798403
0,29393,11,一番くじディズニーツムツム,584517,0.729187874251497
0,16343,12,一番くじディズニーツムツム,600860,0.7495758483033932
0,13992,13,一番くじディズニーツムツム,614852,0.7670309381237524
0,14043,14,一番くじディズニーツムツム,628895,0.7845496506986028
0,11567,15,一番くじディズニーツムツム,640462,0.7989795409181637
0,11907,16,一番くじディズニーツムツム,652369,0.8138335828343314
0,12476,17,一番くじディズニーツムツム,664845,0.8293974550898203
0,9910,18,一番くじディズニーツムツム,674755,0.8417602295409181
0,7777,19,一番くじディズニーツムツム,682532,0.8514620758483034
0,5373,20,一番くじディズニーツムツム,687905,0.8581649201596806
0,4849,21,一番くじディズニーツムツム,692754,0.8642140718562874
0,4763,22,一番くじディズニーツムツム,697517,0.8701559381237525
0,5220,23,一番くじディズニーツムツム,702737,0.8766679141716567
0,5689,24,一番くじディズニーツムツム,708426,0.8837649700598802
0,4695,25,一番くじディズニーツムツム,713121,0.889622005988024
0,3382,26,一番くじディズニーツムツム,716503,0.8938410678642714
0,3016,27,一番くじディズニーツムツム,719519,0.8976035429141717
0,2955,28,一番くじディズニーツムツム,722474,0.9012899201596807
0,2608,29,一番くじディズニーツムツム,725082,0.9045434131736527
0,3026,30,一番くじディズニーツムツム,728108,0.908318363273453
0,3182,31,一番くじディズニーツムツム,731290,0.9122879241516966
0,2841,32,一番くじディズニーツムツム,734131,0.9158320858283433
0,2132,33,一番くじディズニーツムツム,736263,0.9184917664670659
0,2041,34,一番くじディズニーツムツム,738304,0.9210379241516966
0,1959,35,一番くじディズニーツムツム,740263,0.9234817864271457
0,1893,36,一番くじディズニーツムツム,742156,0.9258433133732535
0,1876,37,一番くじディズニーツムツム,744032,0.928183632734531
0,1834,38,一番くじディズニーツムツム,745866,0.9304715568862275
0,1693,39,一番くじディズニーツムツム,747559,0.9325835828343313
0,1562,40,一番くじディズニーツムツム,749121,0.9345321856287425
0,1405,41,一番くじディズニーツムツム,750526,0.9362849301397206
0,1373,42,一番くじディズニーツムツム,751899,0.937997754491018
0,1429,43,一番くじディズニーツムツム,753328,0.9397804391217565
0,1432,44,一番くじディズニーツムツム,754760,0.9415668662674651
0,1367,45,一番くじディズニーツムツム,756127,0.9432722055888224
0,1115,46,一番くじディズニーツムツム,757242,0.9446631736526946
0,834,47,一番くじディズニーツムツム,758076,0.9457035928143712
0,809,48,一番くじディズニーツムツム,758885,0.9467128243512974
0,731,49,一番くじディズニーツムツム,759616,0.947624750499002
0,741,50,一番くじディズニーツムツム,760357,0.9485491516966068
0,790,51,一番くじディズニーツムツム,761147,0.9495346806387226
0,945,52,一番くじディズニーツムツム,762092,0.9507135728542914
0,816,53,一番くじディズニーツムツム,762908,0.9517315369261478
0,687,54,一番くじディズニーツムツム,763595,0.9525885728542914
0,594,55,一番くじディズニーツムツム,764189,0.9533295908183633
0,679,56,一番くじディズニーツムツム,764868,0.9541766467065869
0,603,57,一番くじディズニーツムツム,765471,0.9549288922155689
0,580,58,一番くじディズニーツムツム,766051,0.9556524451097804
0,672,59,一番くじディズニーツムツム,766723,0.9564907684630739
120,1825,0,一番くじどうぶつの森nan,1825,0.0035368217054263565
269520,50349,1,一番くじどうぶつの森nan,52174,0.1011124031007752
246300,84104,2,一番くじどうぶつの森nan,136278,0.2641046511627907
0,56217,3,一番くじどうぶつの森nan,192495,0.37305232558139534
0,45802,4,一番くじどうぶつの森nan,238297,0.4618158914728682
0,41344,5,一番くじどうぶつの森nan,279641,0.5419399224806202
0,28609,6,一番くじどうぶつの森nan,308250,0.5973837209302325
0,28292,7,一番くじどうぶつの森nan,336542,0.6522131782945736
0,28640,8,一番くじどうぶつの森nan,365182,0.7077170542635659
60,23977,9,一番くじどうぶつの森nan,389159,0.7541841085271318
0,14784,10,一番くじどうぶつの森nan,403943,0.7828352713178295
0,11844,11,一番くじどうぶつの森nan,415787,0.8057887596899225
0,10288,12,一番くじどうぶつの森nan,426075,0.8257267441860465
0,8427,13,一番くじどうぶつの森nan,434502,0.8420581395348837
0,7601,14,一番くじどうぶつの森nan,442103,0.8567887596899225
0,8074,15,一番くじどうぶつの森nan,450177,0.8724360465116279
0,6395,16,一番くじどうぶつの森nan,456572,0.884829457364341
0,4324,17,一番くじどうぶつの森nan,460896,0.8932093023255814
0,3656,18,一番くじどうぶつの森nan,464552,0.9002945736434108
0,3203,19,一番くじどうぶつの森nan,467755,0.9065019379844961
0,2510,20,一番くじどうぶつの森nan,470265,0.9113662790697674
0,2417,21,一番くじどうぶつの森nan,472682,0.9160503875968993
0,2797,22,一番くじどうぶつの森nan,475479,0.9214709302325581
0,2432,23,一番くじどうぶつの森nan,477911,0.9261841085271317
0,1454,24,一番くじどうぶつの森nan,479365,0.9290019379844962
0,1405,25,一番くじどうぶつの森nan,480770,0.9317248062015504
0,1097,26,一番くじどうぶつの森nan,481867,0.9338507751937984
0,1029,27,一番くじどうぶつの森nan,482896,0.93584496124031
0,1217,28,一番くじどうぶつの森nan,484113,0.938203488372093
0,1419,29,一番くじどうぶつの森nan,485532,0.940953488372093
0,1291,30,一番くじどうぶつの森nan,486823,0.9434554263565892
0,804,31,一番くじどうぶつの森nan,487627,0.9450135658914729
0,774,32,一番くじどうぶつの森nan,488401,0.9465135658914728
0,723,33,一番くじどうぶつの森nan,489124,0.9479147286821705
0,594,34,一番くじどうぶつの森nan,489718,0.9490658914728682
0,820,35,一番くじどうぶつの森nan,490538,0.9506550387596899
0,909,36,一番くじどうぶつの森nan,491447,0.9524166666666667
0,862,37,一番くじどうぶつの森nan,492309,0.9540872093023256
0,481,38,一番くじどうぶつの森nan,492790,0.9550193798449612
0,398,39,一番くじどうぶつの森nan,493188,0.9557906976744186
0,533,40,一番くじどうぶつの森nan,493721,0.9568236434108527
0,598,41,一番くじどうぶつの森nan,494319,0.9579825581395349
0,560,42,一番くじどうぶつの森nan,494879,0.9590678294573644
0,730,43,一番くじどうぶつの森nan,495609,0.9604825581395349
0,663,44,一番くじどうぶつの森nan,496272,0.9617674418604651
0,546,45,一番くじどうぶつの森nan,496818,0.9628255813953488
0,323,46,一番くじどうぶつの森nan,497141,0.9634515503875969
0,380,47,一番くじどうぶつの森nan,497521,0.9641879844961241
0,497,48,一番くじどうぶつの森nan,498018,0.9651511627906977
0,411,49,一番くじどうぶつの森nan,498429,0.9659476744186046
0,469,50,一番くじどうぶつの森nan,498898,0.9668565891472868
0,357,51,一番くじどうぶつの森nan,499255,0.967548449612403
0,226,52,一番くじどうぶつの森nan,499481,0.9679864341085271
0,193,53,一番くじどうぶつの森nan,499674,0.968360465116279
0,212,54,一番くじどうぶつの森nan,499886,0.9687713178294574
0,198,55,一番くじどうぶつの森nan,500084,0.9691550387596899
0,236,56,一番くじどうぶつの森nan,500320,0.9696124031007752
0,303,57,一番くじどうぶつの森nan,500623,0.9701996124031008
0,276,58,一番くじどうぶつの森nan,500899,0.970734496124031
0,215,59,一番くじどうぶつの森nan,501114,0.9711511627906977
60,3543,0,一番くじラブライブサンシャイン５ｔｈ,3543,0.005926324892404502
293821,76296,1,一番くじラブライブサンシャイン５ｔｈ,79839,0.13354554137304067
303840,89230,2,一番くじラブライブサンシャイン５ｔｈ,169069,0.2827992727163242
0,58050,3,一番くじラブライブサンシャイン５ｔｈ,227119,0.3798986687095733
60,51864,4,一番くじラブライブサンシャイン５ｔｈ,278983,0.4666508319101567
0,37448,5,一番くじラブライブサンシャイン５ｔｈ,316431,0.5292895602676966
60,25593,6,一番くじラブライブサンシャイン５ｔｈ,342024,0.5720986014676143
0,18778,7,一番くじラブライブサンシャイン５ｔｈ,360802,0.6035082906659128
0,15899,8,一番くじラブライブサンシャイン５ｔｈ,376701,0.6301023181748994
0,13002,9,一番くじラブライブサンシャイン５ｔｈ,389703,0.6518505756547309
0,11566,10,一番くじラブライブサンシャイン５ｔｈ,401269,0.6711968566893204
0,14003,11,一番くじラブライブサンシャイン５ｔｈ,415272,0.6946194724015248
0,12431,12,一番くじラブライブサンシャイン５ｔｈ,427703,0.7154126264341187
0,8144,13,一番くじラブライブサンシャイン５ｔｈ,435847,0.7290349775274697
0,7948,14,一番くじラブライブサンシャイン５ｔｈ,443795,0.7423294822536427
0,6979,15,一番くじラブライブサンシャイン５ｔｈ,450774,0.7540031546849413
0,5958,16,一番くじラブライブサンシャイン５ｔｈ,456732,0.7639690151729306
0,6083,17,一番くじラブライブサンシャイン５ｔｈ,462815,0.7741439613542731
0,7207,18,一番くじラブライブサンシャイン５ｔｈ,470022,0.7861990060902481
0,6113,19,一番くじラブライブサンシャイン５ｔｈ,476135,0.7964241328379954
0,4963,20,一番くじラブライブサンシャイン５ｔｈ,481098,0.8047256712068928
0,4074,21,一番くじラブライブサンシャイン５ｔｈ,485172,0.8115401921246619
0,3767,22,一番くじラブライブサンシャイン５ｔｈ,488939,0.8178411985795554
0,3039,23,一番くじラブライブサンシャイン５ｔｈ,491978,0.8229244899563596
0,3422,24,一番くじラブライブサンシャイン５ｔｈ,495400,0.8286484198975982
0,4227,25,一番くじラブライブサンシャイン５ｔｈ,499627,0.8357188617040316
0,3594,26,一番くじラブライブサンシャイン５ｔｈ,503221,0.8417304935593243
0,2596,27,一番くじラブライブサンシャイン５ｔｈ,505817,0.8460727852388846
0,2145,28,一番くじラブライブサンシャイン５ｔｈ,507962,0.8496606957368263
0,2833,29,一番くじラブライブサンシャイン５ｔｈ,510795,0.8543994138909844
0,2754,30,一番くじラブライブサンシャイン５ｔｈ,513549,0.8590059898869432
0,2512,31,一番くじラブライブサンシャイン５ｔｈ,516061,0.8632077759805701
0,2490,32,一番くじラブライブサンシャイン５ｔｈ,518551,0.8673727629921668
0,2309,33,一番くじラブライブサンシャイン５ｔｈ,520860,0.8712349939197881
0,1710,34,一番くじラブライブサンシャイン５ｔｈ,522570,0.8740952862048605
0,2744,35,一番くじラブライブサンシャイン５ｔｈ,525314,0.878685135345351
0,1750,36,一番くじラブライブサンシャイン５ｔｈ,527064,0.8816123350522965
0,1534,37,一番くじラブライブサンシャイン５ｔｈ,528598,0.8841782346811276
0,1604,38,一番くじラブライブサンシャイン５ｔｈ,530202,0.8868612222982365
0,2018,39,一番くじラブライブサンシャイン５ｔｈ,532220,0.8902367017317313
0,1958,40,一番くじラブライブサンシャイン５ｔｈ,534178,0.8935118200324167
0,1362,41,一番くじラブライブサンシャイン５ｔｈ,535540,0.8957900177471937
0,1112,42,一番くじラブライブサンシャイン５ｔｈ,536652,0.8976500440752642
0,991,43,一番くじラブライブサンシャイン５ｔｈ,537643,0.8993076754521687
0,1177,44,一番くじラブライブサンシャイン５ｔｈ,538820,0.9012764263407829
0,1315,45,一番くじラブライブサンシャイン５ｔｈ,540135,0.9034760078348592
0,1147,46,一番くじラブライブサンシャイン５ｔｈ,541282,0.9053945781570685
0,1405,47,一番くじラブライブサンシャイン５ｔｈ,542687,0.907744701350359
0,1370,48,一番くじラブライブサンシャイン５ｔｈ,544057,0.9100362805495107
0,1331,49,一番くじラブライブサンシャイン５ｔｈ,545388,0.912262625012336
0,1376,50,一番くじラブライブサンシャイン５ｔｈ,546764,0.9145642403247686
0,997,51,一番くじラブライブサンシャイン５ｔｈ,547761,0.9162319078149541
0,870,52,一番くじラブライブサンシャイン５ｔｈ,548631,0.9176871442406928
0,1020,53,一番くじラブライブサンシャイン５ｔｈ,549651,0.9193932834984553
0,925,54,一番くじラブライブサンシャイン５ｔｈ,550576,0.9209405176292693
0,756,55,一番くじラブライブサンシャイン５ｔｈ,551332,0.9222050679026698
0,747,56,一番くじラブライブサンシャイン５ｔｈ,552079,0.9234545640061488
0,668,57,一番くじラブライブサンシャイン５ｔｈ,552747,0.9245719179514286
0,667,58,一番くじラブライブサンシャイン５ｔｈ,553414,0.9256875992111615
0,979,59,一番くじラブライブサンシャイン５ｔｈ,554393,0.9273251583615042
0,477,0,一番くじタイガーアンドバニーサイドタイガー,477,0.00469104963464886
42600,1881,1,一番くじタイガーアンドバニーサイドタイガー,2358,0.02318971706184908
57000,6855,2,一番くじタイガーアンドバニーサイドタイガー,9213,0.09060511589941288
400,3818,3,一番くじタイガーアンドバニーサイドタイガー,13031,0.12815318194781822
0,3067,4,一番くじタイガーアンドバニーサイドタイガー,16098,0.1583155493051936
0,2527,5,一番くじタイガーアンドバニーサイドタイガー,18625,0.1831672944346646
0,2640,6,一番くじタイガーアンドバニーサイドタイガー,21265,0.2091303364377526
0,2006,7,一番くじタイガーアンドバニーサイドタイガー,23271,0.22885831456585665
0,1975,8,一番くじタイガーアンドバニーサイドタイガー,25246,0.2482814236401365
0,1874,9,一番くじタイガーアンドバニーサイドタイガー,27120,0.2667112496680861
0,1352,10,一番くじタイガーアンドバニーサイドタイガー,28472,0.28000747420906147
0,1096,11,一番くじタイガーアンドバニーサイドタイガー,29568,0.29078607043458593
0,965,12,一番くじタイガーアンドバニーサイドタイガー,30533,0.30027634904556316
0,1122,13,一番くじタイガーアンドバニーサイドタイガー,31655,0.3113106418968756
0,747,14,一番くじタイガーアンドバニーサイドタイガー,32402,0.31865700264547664
0,875,15,一番くじタイガーアンドバニーサイドタイガー,33277,0.32726217755180315
0,993,16,一番くじタイガーアンドバニーサイドタイガー,34270,0.33702782175978285
0,815,17,一番くじタイガーアンドバニーサイドタイガー,35085,0.3450429275296756
0,693,18,一番くじタイガーアンドバニーサイドタイガー,35778,0.35185822605548617
0,583,19,一番くじタイガーアンドバニーサイドタイガー,36361,0.35759173116450144
0,897,20,一番くじタイガーアンドバニーサイドタイガー,37258,0.366413264754187
0,740,21,一番くじタイガーアンドバニーサイドタイガー,37998,0.37369078410353745
0,792,22,一番くじタイガーアンドバニーサイドタイガー,38790,0.38147969670446386
0,738,23,一番くじタイガーアンドバニーサイドタイガー,39528,0.38873754708259983
0,817,24,一番くじタイガーアンドバニーサイドタイガー,40345,0.39677232182370703
0,663,25,一番くじタイガーアンドバニーサイドタイガー,41008,0.4032925857813007
0,808,26,一番くじタイガーアンドバニーサイドタイガー,41816,0.4112388501519428
0,753,27,一番くじタイガーアンドバニーサイドタイガー,42569,0.4186442178141872
0,545,28,一番くじタイガーアンドバニーサイドタイガー,43114,0.42400401247012776
0,635,29,一番くじタイガーアンドバニーサイドタイガー,43749,0.430248910830719
0,648,30,一番くじタイガーアンドバニーサイドタイガー,44397,0.43662165750420423
0,553,31,一番くじタイガーアンドバニーサイドタイガー,44950,0.4420601280450026
0,480,32,一番くじタイガーアンドバニーサイドタイガー,45430,0.4467806811364732
0,527,33,一番くじタイガーアンドバニーサイドタイガー,45957,0.45196345505148355
0,580,34,一番くじタイガーアンドバニーサイドタイガー,46537,0.4576674567036771
0,386,35,一番くじタイガーアンドバニーサイドタイガー,46923,0.461463568148068
0,396,36,一番くじタイガーアンドバニーサイドタイガー,47319,0.4653580244485312
0,464,37,一番くじタイガーアンドバニーサイドタイガー,47783,0.4699212257702861
0,463,38,一番くじタイガーアンドバニーサイドタイガー,48246,0.4744745926064337
0,520,39,一番くじタイガーアンドバニーサイドタイガー,48766,0.47958852512219347
0,541,40,一番くじタイガーアンドバニーサイドタイガー,49307,0.4849089818357051
0,439,41,一番くじタイガーアンドバニーサイドタイガー,49746,0.4892263210172792
0,479,42,一番くじタイガーアンドバニーサイドタイガー,50225,0.4939370396231425
0,390,43,一番くじタイガーアンドバニーサイドタイガー,50615,0.49777248900996235
0,492,44,一番くじタイガーアンドバニーサイドタイガー,51107,0.5026110559287197
0,542,45,一番くじタイガーアンドバニーサイドタイガー,51649,0.5079413471278384
0,514,46,一番くじタイガーアンドバニーサイドタイガー,52163,0.5129962727299548
0,425,47,一番くじタイガーアンドバニーサイドタイガー,52588,0.5171759291130278
0,408,48,一番くじタイガーアンドバニーサイドタイガー,52996,0.5211883992407778
0,343,49,一番くじタイガーアンドバニーサイドタイガー,53339,0.5245616278040577
0,718,50,一番くじタイガーアンドバニーサイドタイガー,54057,0.5316227884700491
0,500,51,一番くじタイガーアンドバニーサイドタイガー,54557,0.5365400312736642
0,351,52,一番くじタイガーアンドバニーサイドタイガー,54908,0.539991935721802
0,346,53,一番くじタイガーアンドバニーサイドタイガー,55254,0.5433946677419038
0,337,54,一番くじタイガーアンドバニーサイドタイガー,55591,0.5467088893915404
0,314,55,一番くじタイガーアンドバニーサイドタイガー,55905,0.5497969178722107
0,351,56,一番くじタイガーアンドバニーサイドタイガー,56256,0.5532488223203486
0,330,57,一番くじタイガーアンドバニーサイドタイガー,56586,0.5564942025707346
0,624,58,一番くじタイガーアンドバニーサイドタイガー,57210,0.5626309215896462
0,317,59,一番くじタイガーアンドバニーサイドタイガー,57527,0.5657484535271383
0,178,0,ピカチュウねぶくろゲットでチュウ！,178,0.0037975763782215396
24024,3653,1,ピカチュウねぶくろゲットでチュウ！,3831,0.08173323092677931
22848,4419,2,ピカチュウねぶくろゲットでチュウ！,8250,0.17601126472094214
0,3086,3,ピカチュウねぶくろゲットでチュウ！,11336,0.24185014507595154
0,2326,4,ピカチュウねぶくろゲットでチュウ！,13662,0.29147465437788017
0,2020,5,ピカチュウねぶくろゲットでチュウ！,15682,0.33457074586106844
0,2375,6,ピカチュウねぶくろゲットでチュウ！,18057,0.38524065540194574
0,2058,7,ピカチュウねぶくろゲットでチュウ！,20115,0.42914746543778803
0,1845,8,ピカチュウねぶくろゲットでチュウ！,21960,0.4685099846390169
0,1478,9,ピカチュウねぶくろゲットでチュウ！,23438,0.5000426693975081
0,966,10,ピカチュウねぶくろゲットでチュウ！,24404,0.5206519883939239
0,984,11,ピカチュウねぶくろゲットでチュウ！,25388,0.5416453319679126
0,825,12,ピカチュウねぶくろゲットでチュウ！,26213,0.5592464584400069
0,759,13,ピカチュウねぶくろゲットでチュウ！,26972,0.5754394947943335
0,764,14,ピカチュウねぶくろゲットでチュウ！,27736,0.5917392046424305
0,875,15,ピカチュウねぶくろゲットでチュウ！,28611,0.6104070660522274
0,786,16,ピカチュウねぶくろゲットでチュウ！,29397,0.6271761392729135
0,458,17,ピカチュウねぶくろゲットでチュウ！,29855,0.63694743130227
0,376,18,ピカチュウねぶくろゲットでチュウ！,30231,0.6449692780337941
0,412,19,ピカチュウねぶくろゲットでチュウ！,30643,0.6537591739204642
0,378,20,ピカチュウねぶくろゲットでチュウ！,31021,0.6618236900494965
0,489,21,ピカチュウねぶくろゲットでチュウ！,31510,0.6722563577402287
0,570,22,ピカチュウねぶくろゲットでチュウ！,32080,0.6844171360300393
0,503,23,ピカチュウねぶくろゲットでチュウ！,32583,0.6951484895033282
0,292,24,ピカチュウねぶくろゲットでチュウ！,32875,0.7013782215395119
0,282,25,ピカチュウねぶくろゲットでチュウ！,33157,0.707394606588155
0,284,26,ピカチュウねぶくろゲットでチュウ！,33441,0.7134536610343062
0,221,27,ピカチュウねぶくろゲットでチュウ！,33662,0.718168629458952
0,346,28,ピカチュウねぶくろゲットでチュウ！,34008,0.7255504352278546
0,397,29,ピカチュウねぶくろゲットでチュウ！,34405,0.7340203106332138
0,322,30,ピカチュウねぶくろゲットでチュウ！,34727,0.7408900836320191
0,194,31,ピカチュウねぶくろゲットでチュウ！,34921,0.7450290151903055
0,213,32,ピカチュウねぶくろゲットでチュウ！,35134,0.7495733060249189
0,178,33,ピカチュウねぶくろゲットでチュウ！,35312,0.7533708824031404
0,188,34,ピカチュウねぶくろゲットでチュウ！,35500,0.7573818057689026
0,240,35,ピカチュウねぶくろゲットでチュウ！,35740,0.7625021334698754
0,330,36,ピカチュウねぶくろゲットでチュウ！,36070,0.7695425840587131
0,303,37,ピカチュウねぶくろゲットでチュウ！,36373,0.7760069977811913
0,273,38,ピカチュウねぶくろゲットでチュウ！,36646,0.781831370541048
0,220,39,ピカチュウねぶくろゲットでチュウ！,36866,0.7865250042669397
0,187,40,ピカチュウねぶくろゲットでチュウ！,37053,0.7905145929339478
0,216,41,ピカチュウねぶくろゲットでチュウ！,37269,0.7951228878648233
0,242,42,ピカチュウねぶくろゲットでチュウ！,37511,0.8002858849633043
0,248,43,ピカチュウねぶくろゲットでチュウ！,37759,0.8055768902543096
0,273,44,ピカチュウねぶくろゲットでチュウ！,38032,0.8114012630141663
0,360,45,ピカチュウねぶくろゲットでチュウ！,38392,0.8190817545656255
0,311,46,ピカチュウねぶくろゲットでチュウ！,38703,0.8257168458781362
0,242,47,ピカチュウねぶくろゲットでチュウ！,38945,0.8308798429766172
0,171,48,ピカチュウねぶくろゲットでチュウ！,39116,0.8345280764635603
0,189,49,ピカチュウねぶくろゲットでチュウ！,39305,0.8385603345280764
0,161,50,ピカチュウねぶくろゲットでチュウ！,39466,0.8419952210274791
0,172,51,ピカチュウねぶくろゲットでチュウ！,39638,0.8456647892131763
0,160,52,ピカチュウねぶくろゲットでチュウ！,39798,0.8490783410138248
0,118,53,ピカチュウねぶくろゲットでチュウ！,39916,0.8515958354668032
0,78,54,ピカチュウねぶくろゲットでチュウ！,39994,0.8532599419696194
0,104,55,ピカチュウねぶくろゲットでチュウ！,40098,0.855478750640041
0,125,56,ピカチュウねぶくろゲットでチュウ！,40223,0.8581455879842976
0,167,57,ピカチュウねぶくろゲットでチュウ！,40390,0.8617084826762246
0,159,58,ピカチュウねぶくろゲットでチュウ！,40549,0.8651006997781191
0,107,59,ピカチュウねぶくろゲットでチュウ！,40656,0.8673835125448028
0,934,0,一番くじガンダムマイルーム戦役,934,0.0014403533337856928
329300,16036,1,一番くじガンダムマイルーム戦役,16970,0.026170017210217566
318802,32846,2,一番くじガンダムマイルーム戦役,49816,0.0768229568264112
0,33897,3,一番くじガンダムマイルーム戦役,83713,0.12909667947666134
200,28632,4,一番くじガンダムマイルーム戦役,112345,0.17325106561472553
50,19323,5,一番くじガンダムマイルーム戦役,131668,0.2030497245748336
50,18906,6,一番くじガンダムマイルーム戦役,150574,0.23220531357756627
0,19600,7,一番くじガンダムマイルーム戦役,170174,0.2624311437084009
50,13363,8,一番くじガンダムマイルーム戦役,183537,0.2830386828940307
0,17042,9,一番くじガンダムマイルーム戦役,200579,0.3093197337659534
0,19821,10,一番くじガンダムマイルーム戦役,220400,0.3398863755528551
0,16687,11,一番くじガンダムマイルーム戦役,237087,0.365619968787204
0,11789,12,一番くじガンダムマイルーム戦役,248876,0.3838001887572249
0,10900,13,一番くじガンダムマイルーム戦役,259776,0.4006094514320258
0,10963,14,一番くじガンダムマイルーム戦役,270739,0.4175158685608187
0,10571,15,一番くじガンダムマイルーム戦役,281310,0.4338177690869949
0,11180,16,一番くじガンダムマイルーム戦役,292490,0.45105882933509345
0,13936,17,一番くじガンダムマイルーム戦役,306426,0.47255001141179304
0,12160,18,一番くじガンダムマイルーム戦役,318586,0.4913023631664333
0,8437,19,一番くじガンダムマイルーム戦役,327023,0.5043133493304053
0,7723,20,一番くじガンダムマイルーム戦役,334746,0.5162232516824684
0,7664,21,一番くじガンダムマイルーム戦役,342410,0.5280421681173009
0,7449,22,一番くじガンダムマイルーム戦役,349859,0.5395295257012084
0,8618,23,一番くじガンダムマイルーム戦役,358477,0.5528196381536336
0,10107,24,一番くじガンダムマイルーム戦役,368584,0.568405988415488
0,8328,25,一番くじガンダムマイルーム戦役,376912,0.581248881952712
0,5670,26,一番くじガンダムマイルーム戦役,382582,0.5899927828119892
0,4806,27,一番くじガンダムマイルーム戦役,387388,0.597404279730805
0,4646,28,一番くじガンダムマイルーム戦役,392034,0.6045690351791652
0,4911,29,一番くじガンダムマイルーム戦役,396945,0.6121424561879677
0,4668,30,一番くじガンダムマイルーム戦役,401613,0.6193411385885155
0,5810,31,一番くじガンダムマイルーム戦役,407423,0.6283009382344414
0,5165,32,一番くじガンダムマイルーム戦役,412588,0.6362660613275924
0,3629,33,一番くじガンダムマイルーム戦役,416217,0.6418624663043679
0,3529,34,一番くじガンダムマイルーム戦役,419746,0.6473046578621086
0,3742,35,一番くじガンダムマイルーム戦役,423488,0.6530753240023934
0,3462,36,一番くじガンダムマイルーム戦役,426950,0.6584141925693806
0,4502,37,一番くじガンダムマイルーム戦役,431452,0.6653568806943305
0,4443,38,一番くじガンダムマイルーム戦役,435895,0.6722085829020498
0,3951,39,一番くじガンダムマイルーム戦役,439846,0.6783015550881175
0,3109,40,一番くじガンダムマイルーム戦役,442955,0.6830960502859117
0,2930,41,一番くじガンダムマイルーム戦役,445885,0.6876145034636334
0,3265,42,一番くじガンダムマイルーム戦役,449150,0.692649571595122
0,3401,43,一番くじガンダムマイルーム戦役,452551,0.6978943699764979
0,3662,44,一番くじガンダムマイルーム戦役,456213,0.7035416653815548
0,3974,45,一番くじガンダムマイルーム戦役,460187,0.7096701066540007
0,4664,46,一番くじガンダムマイルーム戦役,464851,0.7168626205177869
0,3869,47,一番くじガンダムマイルーム戦役,468720,0.7228291377002461
0,3550,48,一番くじガンダムマイルーム戦役,472270,0.728303714075984
0,2590,49,一番くじガンダムマイルーム戦役,474860,0.7322978416289871
0,2489,50,一番くじガンダムマイルーム戦役,477349,0.7361362136287651
0,2482,51,一番くじガンダムマイルーム戦役,479831,0.7399637906892106
0,2799,52,一番くじガンダムマイルーム戦役,482630,0.7442802242879967
0,2643,53,一番くじガンダムマイルーム戦役,485273,0.7483560849530883
0,2377,54,一番くじガンダムマイルーム戦役,487650,0.7520217379235472
0,2140,55,一番くじガンダムマイルーム戦役,489790,0.7553219050908934
0,1856,56,一番くじガンダムマイルーム戦役,491646,0.7581841061481805
0,1858,57,一番くじガンダムマイルーム戦役,493504,0.7610493914738485
0,1952,58,一番くじガンダムマイルーム戦役,495456,0.7640596374134092
0,2208,59,一番くじガンダムマイルーム戦役,497664,0.7674646697056992
60,1894,0,一番くじ銀魂トリビュートギャラリー,1894,0.004101688968968796
236401,28900,1,一番くじ銀魂トリビュートギャラリー,30794,0.06668817851659192
225240,53515,2,一番くじ銀魂トリビュートギャラリー,84309,0.18258146530347952
60,36805,3,一番くじ銀魂トリビュートギャラリー,121114,0.2622872005214819
0,25391,4,一番くじ銀魂トリビュートギャラリー,146505,0.3172745208018867
0,19700,5,一番くじ銀魂トリビュートギャラリー,166205,0.35993728357310384
0,17813,6,一番くじ銀魂トリビュートギャラリー,184018,0.39851351673268204
0,14521,7,一番くじ銀魂トリビュートギャラリー,198539,0.42996052070226803
0,16518,8,一番くじ銀魂トリビュートギャラリー,215057,0.4657322727558196
0,14199,9,一番くじ銀魂トリビュートギャラリー,229256,0.49648194628823134
0,12288,10,一番くじ銀魂トリビュートギャラリー,241544,0.5230931152695875
0,9396,11,一番くじ銀魂トリビュートギャラリー,250940,0.5434413040512299
0,9721,12,一番くじ銀魂トリビュートギャラリー,260661,0.5644933201374737
0,8540,13,一番くじ銀魂トリビュートギャラリー,269201,0.5829877360799202
0,7878,14,一番くじ銀魂トリビュートギャラリー,277079,0.6000485099434556
0,7858,15,一番くじ銀魂トリビュートギャラリー,284937,0.6170659713574771
0,7545,16,一番くじ銀魂トリビュートギャラリー,292482,0.6334055929366057
0,6801,17,一番くじ銀魂トリビュートギャラリー,299283,0.6481339913938163
0,6470,18,一番くじ銀魂トリビュートギャラリー,305753,0.6621455688115714
0,4795,19,一番くじ銀魂トリビュートギャラリー,310548,0.6725297285825351
0,4601,20,一番くじ銀魂トリビュートギャラリー,315149,0.6824937575932138
0,3747,21,一番くじ銀魂トリビュートギャラリー,318896,0.6906083450096479
0,4184,22,一番くじ銀魂トリビュートギャラリー,323080,0.6996693094479611
0,4887,23,一番くじ銀魂トリビュートギャラリー,327967,0.710252706486689
0,4544,24,一番くじ銀魂トリビュートギャラリー,332511,0.720093295016253
0,3570,25,一番くじ銀魂トリビュートギャラリー,336081,0.7278245672544887
0,3251,26,一番くじ銀魂トリビュートギャラリー,339332,0.7348650059229774
0,2266,27,一番くじ銀魂トリビュートギャラリー,341598,0.7397723064529053
0,2306,28,一番くじ銀魂トリビュートギャラリー,343904,0.744766231881861
0,2271,29,一番くじ銀魂トリビュートギャラリー,346175,0.7496843605241673
0,3457,30,一番くじ銀魂トリビュートギャラリー,349632,0.7571709174226494
0,3067,31,一番くじ銀魂トリビュートギャラリー,352699,0.7638128815556099
0,1990,32,一番くじ銀魂トリビュートギャラリー,354689,0.7681224702822456
0,1918,33,一番くじ銀魂トリビュートギャラリー,356607,0.7722761341906311
0,1796,34,一番くじ銀魂トリビュートギャラリー,358403,0.7761655921569817
0,1858,35,一番くじ銀魂トリビュートギャラリー,360261,0.7801893187168254
0,1788,36,一番くじ銀魂トリビュートギャラリー,362049,0.7840614517033704
0,2432,37,一番くじ銀魂トリビュートギャラリー,364481,0.7893282455642637
0,2336,38,一番くじ銀魂トリビュートギャラリー,366817,0.7943871396674903
0,1356,39,一番くじ銀魂トリビュートギャラリー,368173,0.7973237237445345
0,1219,40,一番くじ銀魂トリビュートギャラリー,369392,0.7999636175424083
0,1283,41,一番くじ銀魂トリビュートギャラリー,370675,0.8027421111787266
0,1177,42,一番くじ銀魂トリビュートギャラリー,371852,0.8052910488326213
0,1573,43,一番くじ銀魂トリビュートギャラリー,373425,0.8086975729868915
0,1988,44,一番くじ銀魂トリビュートギャラリー,375413,0.8130028304685757
0,1952,45,一番くじ銀魂トリビュートギャラリー,377365,0.8172301255411349
0,1108,46,一番くじ銀魂トリビュートギャラリー,378473,0.8196296352442064
0,1489,47,一番くじ銀魂トリビュートギャラリー,379962,0.8228542471105182
0,1026,48,一番くじ銀魂トリビュートギャラリー,380988,0.8250761757705826
0,1040,49,一番くじ銀魂トリビュートギャラリー,382028,0.8273284231453067
0,1217,50,一番くじ銀魂トリビュートギャラリー,383245,0.8299639856982292
0,1711,51,一番くじ銀魂トリビュートギャラリー,384956,0.8336693657541455
0,1763,52,一番くじ銀魂トリビュートギャラリー,386719,0.8374873581787982
0,1593,53,一番くじ銀魂トリビュートギャラリー,388312,0.8409371947825823
0,1266,54,一番くじ銀魂トリビュートギャラリー,389578,0.8436788728368139
0,964,55,一番くじ銀魂トリビュートギャラリー,390542,0.8457665329033851
0,788,56,一番くじ銀魂トリビュートギャラリー,391330,0.8474730434142338
0,1027,57,一番くじ銀魂トリビュートギャラリー,392357,0.8496971376967739
0,1026,58,一番くじ銀魂トリビュートギャラリー,393383,0.8519190663568382
0,1134,59,一番くじ銀魂トリビュートギャラリー,394517,0.8543748822442779
0,13665,0,一番くじアイドリッシュセブンメルヘン,13665,0.028727295660948535
239940,119073,1,一番くじアイドリッシュセブンメルヘン,132738,0.2790489404641776
235440,112012,2,一番くじアイドリッシュセブンメルヘン,244750,0.5145265724857047
240,46860,3,一番くじアイドリッシュセブンメルヘン,291610,0.6130381769256643
60,21901,4,一番くじアイドリッシュセブンメルヘン,313511,0.6590796333669694
0,12561,5,一番くじアイドリッシュセブンメルヘン,326072,0.6854860410359905
0,9849,6,一番くじアイドリッシュセブンメルヘン,335921,0.7061911368987555
0,7356,7,一番くじアイドリッシュセブンメルヘン,343277,0.7216553144971409
0,5825,8,一番くじアイドリッシュセブンメルヘン,349102,0.73390094180962
0,6034,9,一番くじアイドリッシュセブンメルヘン,355136,0.746585940127817
0,5152,10,一番くじアイドリッシュセブンメルヘン,360288,0.7574167507568113
0,4585,11,一番くじアイドリッシュセブンメルヘン,364873,0.7670555835856038
0,3966,12,一番くじアイドリッシュセブンメルヘン,368839,0.7753931214261689
0,3301,13,一番くじアイドリッシュセブンメルヘン,372140,0.7823326606121762
0,2631,14,一番くじアイドリッシュセブンメルヘン,374771,0.7878636898755466
0,2101,15,一番くじアイドリッシュセブンメルヘン,376872,0.7922805247225025
0,2624,16,一番くじアイドリッシュセブンメルヘン,379496,0.7977968382105617
0,2266,17,一番くじアイドリッシュセブンメルヘン,381762,0.8025605449041372
0,2173,18,一番くじアイドリッシュセブンメルヘン,383935,0.8071287420114363
0,1732,19,一番くじアイドリッシュセブンメルヘン,385667,0.8107698452741339
0,1576,20,一番くじアイドリッシュセブンメルヘン,387243,0.8140829969727548
0,1319,21,一番くじアイドリッシュセブンメルヘン,388562,0.8168558694920955
0,1544,22,一番くじアイドリッシュセブンメルヘン,390106,0.8201017490750084
0,1630,23,一番くじアイドリッシュセブンメルヘン,391736,0.8235284224688867
0,1689,24,一番くじアイドリッシュセブンメルヘン,393425,0.8270791288261016
0,1551,25,一番くじアイドリッシュセブンメルヘン,394976,0.8303397241843256
0,1211,26,一番くじアイドリッシュセブンメルヘン,396187,0.8328855533131517
0,1589,27,一番くじアイドリッシュセブンメルヘン,397776,0.8362260343087791
0,1280,28,一番くじアイドリッシュセブンメルヘン,399056,0.8389169189371005
0,1226,29,一番くじアイドリッシュセブンメルヘン,400282,0.8414942818701648
0,867,30,一番くじアイドリッシュセブンメルヘン,401149,0.8433169357551294
0,1407,31,一番くじアイドリッシュセブンメルヘン,402556,0.8462748065926673
0,1624,32,一番くじアイドリッシュセブンメルヘン,404180,0.8496888664648503
0,1060,33,一番くじアイドリッシュセブンメルヘン,405240,0.8519172552976791
0,673,34,一番くじアイドリッシュセブンメルヘン,405913,0.8533320719811638
0,895,35,一番くじアイドリッシュセブンメルヘン,406808,0.855213588967373
0,1021,36,一番くじアイドリッシュセブンメルヘン,407829,0.8573599899091826
0,837,37,一番くじアイドリッシュセブンメルヘン,408666,0.859119576185671
0,952,38,一番くじアイドリッシュセブンメルヘン,409618,0.8611209216279851
0,882,39,一番くじアイドリッシュセブンメルヘン,410500,0.862975109317188
0,672,40,一番くじアイドリッシュセブンメルヘン,411172,0.8643878237470568
0,558,41,一番くじアイドリッシュセブンメルヘン,411730,0.8655608812647158
0,435,42,一番くじアイドリッシュセブンメルヘン,412165,0.866475361587622
0,497,43,一番くじアイドリッシュセブンメルヘン,412662,0.8675201816347125
0,593,44,一番くじアイドリッシュセブンメルヘン,413255,0.868766818028927
0,867,45,一番くじアイドリッシュセブンメルヘン,414122,0.8705894719138917
0,688,46,一番くじアイドリッシュセブンメルヘン,414810,0.8720358224016145
0,529,47,一番くじアイドリッシュセブンメルヘン,415339,0.8731479145644131
0,905,48,一番くじアイドリッシュセブンメルヘン,416244,0.8750504540867811
0,444,49,一番くじアイドリッシュセブンメルヘン,416688,0.8759838546922301
0,622,50,一番くじアイドリッシュセブンメルヘン,417310,0.8772914564413051
0,584,51,一番くじアイドリッシュセブンメルヘン,417894,0.8785191725529768
0,759,52,一番くじアイドリッシュセブンメルヘン,418653,0.8801147830474269
0,573,53,一番くじアイドリッシュセブンメルヘン,419226,0.881319374369324
0,398,54,一番くじアイドリッシュセブンメルヘン,419624,0.8821560713084426
0,375,55,一番くじアイドリッシュセブンメルヘン,419999,0.8829444164143962
0,427,56,一番くじアイドリッシュセブンメルヘン,420426,0.8838420787083754
0,296,57,一番くじアイドリッシュセブンメルヘン,420722,0.8844643457786747
0,552,58,一番くじアイドリッシュセブンメルヘン,421274,0.8856247897746384
0,526,59,一番くじアイドリッシュセブンメルヘン,421800,0.8867305751765893
0,12993,0,一番くじハイキュー！！激闘全力！休息全力！,12993,0.013739595901702619
471120,99055,1,一番くじハイキュー！！激闘全力！休息全力！,112048,0.11848643435649774
474421,120945,2,一番くじハイキュー！！激闘全力！休息全力！,232993,0.24638110274189165
120,77576,3,一番くじハイキュー！！激闘全力！休息全力！,310569,0.3284147278993212
0,53199,4,一番くじハイキュー！！激闘全力！休息全力！,363768,0.3846706166374631
0,35752,5,一番くじハイキュー！！激闘全力！休息全力！,399520,0.4224769764217833
0,23696,6,一番くじハイキュー！！激闘全力！休息全力！,423216,0.4475345816312611
0,24369,7,一番くじハイキュー！！激闘全力！休息全力！,447585,0.4733038583593909
0,19968,8,一番くじハイキュー！！激闘全力！休息全力！,467553,0.4944192474893223
0,21903,9,一番くじハイキュー！！激闘全力！休息全力！,489456,0.5175808244180525
0,25884,10,一番くじハイキュー！！激闘全力！休息全力！,515340,0.5449521551591955
0,21870,11,一番くじハイキュー！！激闘全力！休息全力！,537210,0.5680788358618998
0,14061,12,一番くじハイキュー！！激闘全力！休息全力！,551271,0.5829478005331721
0,12023,13,一番くじハイキュー！！激闘全力！休息全力！,563294,0.5956616588819884
0,11738,14,一番くじハイキュー！！激闘全力！休息全力！,575032,0.6080741407333072
0,11066,15,一番くじハイキュー！！激闘全力！休息全力！,586098,0.6197760085273687
0,11132,16,一番くじハイキュー！！激闘全力！休息全力！,597230,0.6315476687734822
0,13101,17,一番くじハイキュー！！激闘全力！休息全力！,610331,0.6454014705058155
0,10363,18,一番くじハイキュー！！激闘全力！休息全力！,620694,0.6563599429393832
0,9106,19,一番くじハイキュー！！激闘全力！休息全力！,629800,0.6659891863997776
0,6895,20,一番くじハイキュー！！激闘全力！休息全力！,636695,0.673280382716428
0,6321,21,一番くじハイキュー！！激闘全力！休息全力！,643016,0.6799645961925045
0,5410,22,一番くじハイキュー！！激闘全力！休息全力！,648426,0.6856854623379837
0,5936,23,一番くじハイキュー！！激闘全力！休息全力！,654362,0.6919625531770899
0,8249,24,一番くじハイキュー！！激闘全力！休息全力！,662611,0.7006855522222023
0,7370,25,一番くじハイキュー！！激闘全力！休息全力！,669981,0.7084790427013485
0,5228,26,一番くじハイキュー！！激闘全力！休息全力！,675209,0.7140074508729872
0,3786,27,一番くじハイキュー！！激闘全力！休息全力！,678995,0.718010999713428
0,3606,28,一番くじハイキュー！！激闘全力！休息全力！,682601,0.7218242055028176
0,3659,29,一番くじハイキュー！！激闘全力！休息全力！,686260,0.7256934567461278
0,3547,30,一番くじハイキュー！！激闘全力！休息全力！,689807,0.7294442723132285
0,5637,31,一番くじハイキュー！！激闘全力！休息全力！,695444,0.735405182195311
0,5101,32,一番くじハイキュー！！激闘全力！休息全力！,700545,0.7407992927698192
0,3041,33,一番くじハイキュー！！激闘全力！休息全力！,703586,0.7440150328711874
0,2941,34,一番くじハイキュー！！激闘全力！休息全力！,706527,0.7471250268330829
0,3701,35,一番くじハイキュー！！激闘全力！休息全力！,710228,0.7510386914549717
0,3316,36,一番くじハイキュー！！激闘全力！休息全力！,713544,0.7545452334398902
0,4056,37,一番くじハイキュー！！激闘全力！休息全力！,717600,0.7588342968569075
0,5285,38,一番くじハイキュー！！激闘全力！休息全力！,722885,0.7644229803280457
0,4512,39,一番くじハイキュー！！激闘全力！休息全力！,727397,0.769194246141059
0,3466,40,一番くじハイキュー！！激闘全力！休息全力！,730863,0.7728594073351868
0,2814,41,一番くじハイキュー！！激闘全力！休息全力！,733677,0.7758351036999517
0,2906,42,一番くじハイキュー！！激闘全力！休息全力！,736583,0.7789080865130317
0,2375,43,一番くじハイキュー！！激闘全力！休息全力！,738958,0.7814195573255109
0,2806,44,一番くじハイキュー！！激闘全力！休息全力！,741764,0.784386793999118
0,3963,45,一番くじハイキュー！！激闘全力！休息全力！,745727,0.7885775135064257
0,3449,46,一番くじハイキュー！！激闘全力！休息全力！,749176,0.792224697856843
0,2231,47,一番くじハイキュー！！激闘全力！休息全力！,751407,0.7945838942284814
0,1749,48,一番くじハイキュー！！激闘全力！休息全力！,753156,0.796433394207861
0,2011,49,一番くじハイキュー！！激闘全力！休息全力！,755167,0.7985599490726593
0,2502,50,一番くじハイキュー！！激闘全力！休息全力！,757669,0.801205717482269
0,2578,51,一番くじハイキュー！！激闘全力！休息全力！,760247,0.8039318529578782
0,3497,52,一番くじハイキュー！！激闘全力！休息全力！,763744,0.8076297954552424
0,3254,53,一番くじハイキュー！！激闘全力！休息全力！,766998,0.8110707748336877
0,2142,54,一番くじハイキュー！！激闘全力！休息全力！,769140,0.8133358571411954
0,2089,55,一番くじハイキュー！！激闘全力！休息全力！,771229,0.8155448939947825
0,2037,56,一番くじハイキュー！！激闘全力！休息全力！,773266,0.8176989428558437
0,2150,57,一番くじハイキュー！！激闘全力！休息全力！,775416,0.8199724848545091
0,2004,58,一番くじハイキュー！！激闘全力！休息全力！,777420,0.8220916374895444
0,2700,59,一番くじハイキュー！！激闘全力！休息全力！,780120,0.8249467832553103
132,1741,0,一番くじＦｒｅｅ！nan,1741,0.0050187663232419905
170744,20830,1,一番くじＦｒｅｅ！nan,22571,0.06506523531412692
175824,30647,2,一番くじＦｒｅｅ！nan,53218,0.15341108913859405
132,18297,3,一番くじＦｒｅｅ！nan,71515,0.20615569994638194
0,14607,4,一番くじＦｒｅｅ！nan,86122,0.24826317822529967
0,11017,5,一番くじＦｒｅｅ！nan,97139,0.2800217931495713
0,7627,6,一番くじＦｒｅｅ！nan,104766,0.30200808306764526
0,7555,7,一番くじＦｒｅｅ！nan,112321,0.3237868191802778
0,6335,8,一番くじＦｒｅｅ！nan,118656,0.342048671367376
0,6340,9,一番くじＦｒｅｅ！nan,124996,0.3603249370131854
0,6229,10,一番くじＦｒｅｅ！nan,131225,0.3782812238756061
0,6666,11,一番くじＦｒｅｅ！nan,137891,0.39749724702938616
0,5751,12,一番くじＦｒｅｅ！nan,143642,0.4140756072390155
0,3988,13,一番くじＦｒｅｅ！nan,147630,0.42557178190707357
0,3781,14,一番くじＦｒｅｅ！nan,151411,0.4364712393844877
0,3429,15,一番くじＦｒｅｅ！nan,154840,0.44635598936863286
0,3566,16,一番くじＦｒｅｅ！nan,158406,0.4566356681214651
0,4519,17,一番くじＦｒｅｅ！nan,162925,0.46966255210465324
0,4382,18,一番くじＦｒｅｅ！nan,167307,0.48229450731915435
0,3550,19,一番くじＦｒｅｅ！nan,170857,0.4925280630041107
0,2482,20,一番くじＦｒｅｅ！nan,173339,0.49968290390835346
0,2434,21,一番くじＦｒｅｅ！nan,175773,0.5066993756089686
0,2317,22,一番くじＦｒｅｅ！nan,178090,0.5133785723757416
0,2310,23,一番くじＦｒｅｅ！nan,180400,0.5200375903003188
0,2100,24,一番くじＦｒｅｅ！nan,182500,0.5260912429590254
0,2729,25,一番くじＦｒｅｅ！nan,185229,0.5339581087236017
0,2589,26,一番くじＦｒｅｅ！nan,187818,0.5414213976442643
0,1695,27,一番くじＦｒｅｅ！nan,189513,0.5463075601473631
0,1499,28,一番くじＦｒｅｅ！nan,191012,0.5506287150689828
0,1479,29,一番くじＦｒｅｅ！nan,192491,0.5548922161557576
0,1563,30,一番くじＦｒｅｅ！nan,194054,0.5593978633488806
66,1570,31,一番くじＦｒｅｅ！nan,195624,0.5639236893841993
0,2292,32,一番くじＦｒｅｅ！nan,197916,0.5705308188574163
0,1791,33,一番くじＦｒｅｅ！nan,199707,0.5756937197677704
0,1537,34,一番くじＦｒｅｅ！nan,201244,0.5801244169755951
0,1753,35,一番くじＦｒｅｅ！nan,202997,0.585177775599744
0,1523,36,一番くじＦｒｅｅ！nan,204520,0.5895681151231774
0,1398,37,一番くじＦｒｅｅ！nan,205918,0.5935981181788307
0,1904,38,一番くじＦｒｅｅ！nan,207822,0.599086763256058
0,2562,39,一番くじＦｒｅｅ！nan,210384,0.60647221949968
0,2044,40,一番くじＦｒｅｅ！nan,212428,0.6123644414208211
0,1473,41,一番くじＦｒｅｅ！nan,213901,0.6166106463571425
0,1416,42,一番くじＦｒｅｅ！nan,215317,0.620692537864156
0,1288,43,一番くじＦｒｅｅ！nan,216605,0.6244054448281627
0,1350,44,一番くじＦｒｅｅ！nan,217955,0.6282970786801884
0,1368,45,一番くじＦｒｅｅ！nan,219323,0.6322406009835744
0,1572,46,一番くじＦｒｅｅ！nan,220895,0.6367721924023776
0,1519,47,一番くじＦｒｅｅ！nan,222414,0.641151001158842
0,1219,48,一番くじＦｒｅｅ！nan,223633,0.6446650023926341
0,1100,49,一番くじＦｒｅｅ！nan,224733,0.6478359633090995
0,1374,50,一番くじＦｒｅｅ！nan,226107,0.651796781762939
0,1152,51,一番くじＦｒｅｅ！nan,227259,0.6551176426500008
0,1343,52,一番くじＦｒｅｅ！nan,228602,0.6589890976598308
0,1745,53,一番くじＦｒｅｅ！nan,230347,0.6640193947500418
0,1538,54,一番くじＦｒｅｅ！nan,231885,0.6684529746496088
0,1454,55,一番くじＦｒｅｅ！nan,233339,0.6726444084428276
0,1247,56,一番くじＦｒｅｅ！nan,234586,0.6762391250454024
0,1293,57,一番くじＦｒｅｅ！nan,235879,0.6799664454681204
0,1224,58,一番くじＦｒｅｅ！nan,237103,0.6834948601606236
0,1353,59,一番くじＦｒｅｅ！nan,238456,0.687395142087876
0,1766,0,一番くじディズニープリンセスパワー,1766,0.002367542943555685
380400,19853,1,一番くじディズニープリンセスパワー,21619,0.028982962002678567
365401,46059,2,一番くじディズニープリンセスパワー,67678,0.09073078784482538
120,51332,3,一番くじディズニープリンセスパワー,119010,0.15954772690405553
0,45174,4,一番くじディズニープリンセスパワー,164184,0.22010910002533782
0,30119,5,一番くじディズニープリンセスパワー,194303,0.26048737064648936
0,26993,6,一番くじディズニープリンセスパワー,221296,0.2966748489451296
0,30483,7,一番くじディズニープリンセスパワー,251779,0.33754110690006045
0,26964,8,一番くじディズニープリンセスパワー,278743,0.37368970708694355
0,26204,9,一番くじディズニープリンセスパワー,304947,0.4088194326208808
0,31968,10,一番くじディズニープリンセスパワー,336915,0.45167651802268605
0,26995,11,一番くじディズニープリンセスパワー,363910,0.48786667757041297
0,17247,12,一番くじディズニープリンセスパワー,381157,0.5109884290695663
0,16465,13,一番くじディズニープリンセスパワー,397622,0.5330618121758203
0,15307,14,一番くじディズニープリンセスパワー,412929,0.553582752060875
0,14092,15,一番くじディズニープリンセスパワー,427021,0.57247483312576
0,14683,16,一番くじディズニープリンセスパワー,441704,0.5921592232957645
0,18774,17,一番くじディズニープリンセスパワー,460478,0.6173281084726131
0,17091,18,一番くじディズニープリンセスパワー,477569,0.6402407225430039
0,9522,19,一番くじディズニープリンセスパワー,487091,0.6530061494447803
0,9085,20,一番くじディズニープリンセスパワー,496176,0.6651857234211129
0,8916,21,一番くじディズニープリンセスパワー,505092,0.6771387318496195
0,8831,22,一番くじディズニープリンセスパワー,513923,0.6889777871919412
0,10488,23,一番くじディズニープリンセスパワー,524411,0.7030382574025936
0,13820,24,一番くじディズニープリンセスパワー,538231,0.7215656885916873
0,11841,25,一番くじディズニープリンセスパワー,550072,0.7374400238094919
0,6942,26,一番くじディズニープリンセスパワー,557014,0.746746639389426
0,6165,27,一番くじディズニープリンセスパワー,563179,0.7550115896991773
0,6825,28,一番くじディズニープリンセスパワー,570004,0.7641613522075394
0,5729,29,一番くじディズニープリンセスパワー,575733,0.7718417902163902
0,6181,30,一番くじディズニープリンセスパワー,581914,0.7801281905188351
0,8169,31,一番くじディズニープリンセスパワー,590083,0.7910797524134593
0,7202,32,一番くじディズニープリンセスパワー,597285,0.8007349303746644
0,4185,33,一番くじディズニープリンセスパワー,601470,0.8063454440885831
0,3904,34,一番くじディズニープリンセスパワー,605374,0.8115792423058206
0,3624,35,一番くじディズニープリンセスパワー,608998,0.8164376656509201
0,3657,36,一番くじディズニープリンセスパワー,612655,0.8213403296059503
0,4286,37,一番くじディズニープリンセスパワー,616941,0.8270862463987473
0,6620,38,一番くじディズニープリンセスパワー,623561,0.8359611808757228
0,5980,39,一番くじディズニープリンセスパワー,629541,0.8439781156449544
0,3312,40,一番くじディズニープリンセスパワー,632853,0.8484182641325287
0,2981,41,一番くじディズニープリンセスパワー,635834,0.8524146658962545
0,3098,42,一番くじディズニープリンセスパワー,638932,0.856567920731552
0,3304,43,一番くじディズニープリンセスパワー,642236,0.8609973442227796
0,3270,44,一番くじディズニープリンセスパワー,645506,0.8653811864795333
0,3720,45,一番くじディズニープリンセスパワー,649226,0.8703683097807945
0,2640,46,一番くじディズニープリンセスパワー,651866,0.8739075585752378
0,1662,47,一番くじディズニープリンセスパワー,653528,0.8761356765662852
0,1500,48,一番くじディズニープリンセスパワー,655028,0.8781466133813098
0,1467,49,一番くじディズニープリンセスパワー,656495,0.8801133095864039
0,1463,50,一番くじディズニープリンセスパワー,657958,0.8820746432933246
0,1605,51,一番くじディズニープリンセスパワー,659563,0.884226345685401
0,2042,52,一番くじディズニープリンセスパワー,661605,0.8869639010029212
0,2045,53,一番くじディズニープリンセスパワー,663650,0.8897054781940715
0,1243,54,一番くじディズニープリンセスパワー,664893,0.8913718745014553
0,1073,55,一番くじディズニープリンセスパワー,665966,0.8928103646364696
0,1167,56,一番くじディズニープリンセスパワー,667133,0.8943748734785587
0,939,57,一番くじディズニープリンセスパワー,668072,0.8956337199247641
0,1339,58,一番くじディズニープリンセスパワー,669411,0.8974288161883095
0,1728,59,一番くじディズニープリンセスパワー,671139,0.8997454153992179
0,190,0,ディズニーツムツムクリアスタンプ,190,0.0011355690097240567
84600,2479,1,ディズニーツムツムクリアスタンプ,2669,0.015951756247123722
82717,5761,2,ディズニーツムツムクリアスタンプ,8430,0.05038340395775683
0,8707,3,ディズニーツムツムクリアスタンプ,17137,0.10242234799811137
0,6884,4,ディズニーツムツムクリアスタンプ,24021,0.1435658062241135
0,5181,5,ディズニーツムツムクリアスタンプ,29202,0.17453098011558899
0,4869,6,ディズニーツムツムクリアスタンプ,34071,0.20363143015951757
0,4813,7,ディズニーツムツムクリアスタンプ,38884,0.23239718617952748
0,4616,8,ディズニーツムツムクリアスタンプ,43500,0.25998553643682354
0,5129,9,ディズニーツムツムクリアスタンプ,48629,0.2906399230203745
0,6492,10,ディズニーツムツムクリアスタンプ,55121,0.32944052307894595
0,5238,11,ディズニーツムツムクリアスタンプ,60359,0.3607463676733386
0,3098,12,ディズニーツムツムクリアスタンプ,63457,0.3792621192108393
0,3066,13,ディズニーツムツムクリアスタンプ,66523,0.39758661702038645
0,3156,14,ディズニーツムツムクリアスタンプ,69679,0.4164490159398029
0,2954,15,ディズニーツムツムクリアスタンプ,72633,0.4341041257015127
0,3114,16,ディズニーツムツムクリアスタンプ,75747,0.4527155041029901
0,4083,17,ディズニーツムツムクリアスタンプ,79830,0.47711828445406024
0,3396,18,ディズニーツムツムクリアスタンプ,83226,0.49741508633312814
0,2752,19,ディズニーツムツムクリアスタンプ,85978,0.5138629069371313
0,2115,20,ディズニーツムツムクリアスタンプ,88093,0.5265035830190596
0,1983,21,ディズニーツムツムクリアスタンプ,90076,0.5383553374731797
0,1992,22,ディズニーツムツムクリアスタンプ,92068,0.5502608820382866
0,2246,23,ディズニーツムツムクリアスタンプ,94314,0.5636845030690246
0,2604,24,ディズニーツムツムクリアスタンプ,96918,0.5792477751812428
0,2417,25,ディズニーツムツムクリアスタンプ,99335,0.5936934083207325
0,1816,26,ディズニーツムツムクリアスタンプ,101151,0.604547057382095
0,1755,27,ディズニーツムツムクリアスタンプ,102906,0.6150361290245462
0,1742,28,ディズニーツムツムクリアスタンプ,104648,0.6254475038400162
0,1514,29,ディズニーツムツムクリアスタンプ,106162,0.6344961958438174
0,1745,30,ディズニーツムツムクリアスタンプ,107907,0.6449255006962831
0,1916,31,ディズニーツムツムクリアスタンプ,109823,0.6563768176575004
0,1683,32,ディズニーツムツムクリアスタンプ,111506,0.6664355684120562
0,1260,33,ディズニーツムツムクリアスタンプ,112766,0.6739661839502262
0,1179,34,ディズニーツムツムクリアスタンプ,113945,0.6810126884895139
0,1221,35,ディズニーツムツムクリアスタンプ,115166,0.6883102135467406
0,1061,36,ディズニーツムツムクリアスタンプ,116227,0.6946514699641997
0,1182,37,ディズニーツムツムクリアスタンプ,117409,0.701715904540483
0,1293,38,ディズニーツムツムクリアスタンプ,118702,0.7094437504856052
0,1195,39,ディズニーツムツムクリアスタンプ,119897,0.7165858818888696
0,1058,40,ディズニーツムツムクリアスタンプ,120955,0.722909208269333
0,1040,41,ディズニーツムツムクリアスタンプ,121995,0.7291249544278227
0,1073,42,ディズニーツムツムクリアスタンプ,123068,0.7355379309932643
0,1015,43,ディズニーツムツムクリアスタンプ,124083,0.7416042601767902
0,1148,44,ディズニーツムツムクリアスタンプ,125231,0.7484654876671228
0,1156,45,ディズニーツムツムクリアスタンプ,126387,0.755374528589444
0,1001,46,ディズニーツムツムクリアスタンプ,127388,0.7613571842669902
0,706,47,ディズニーツムツムクリアスタンプ,128094,0.7655767196399649
0,755,48,ディズニーツムツムクリアスタンプ,128849,0.7700891122838683
0,764,49,ディズニーツムツムクリアスタンプ,129613,0.7746552950387587
0,691,50,ディズニーツムツムクリアスタンプ,130304,0.7787851802267552
0,713,51,ディズニーツムツムクリアスタンプ,131017,0.7830465523527197
0,797,52,ディズニーツムツムクリアスタンプ,131814,0.7878099655145622
0,810,53,ディズニーツムツムクリアスタンプ,132624,0.7926510755033858
0,647,54,ディズニーツムツムクリアスタンプ,133271,0.7965179868154462
0,606,55,ディズニーツムツムクリアスタンプ,133877,0.800139854288566
0,681,56,ディズニーツムツムクリアスタンプ,134558,0.804209972686577
0,611,57,ディズニーツムツムクリアスタンプ,135169,0.8078617235546895
0,559,58,ディズニーツムツムクリアスタンプ,135728,0.8112026871148778
0,799,59,ディズニーツムツムクリアスタンプ,136527,0.8159780536347173
66,1240,0,一番くじゼルダの伝説２,1240,0.0030759461014863766
216414,30103,1,一番くじゼルダの伝説２,31343,0.07774949891845766
186582,37773,2,一番くじゼルダの伝説２,69116,0.17144926673413904
0,27410,3,一番くじゼルダの伝説２,96526,0.23944255918715643
0,21184,4,一番くじゼルダの伝説２,117710,0.2919916254886785
0,16837,5,一番くじゼルダの伝説２,134547,0.3337575162231351
66,14193,6,一番くじゼルダの伝説２,148740,0.36896469607668037
0,13758,7,一番くじゼルダの伝説２,162498,0.40309281419301063
0,16391,8,一番くじゼルダの伝説２,178889,0.44375235657161
0,13865,9,一番くじゼルダの伝説２,192754,0.47814589906927824
0,9209,10,一番くじゼルダの伝説２,201963,0.5009897600762041
0,8549,11,一番くじゼルダの伝説２,210512,0.5221964239645969
0,7760,12,一番くじゼルダの伝説２,218272,0.5414458931158341
0,6850,13,一番くじゼルダの伝説２,225122,0.5584380147248517
0,6510,14,一番くじゼルダの伝説２,231632,0.5745867317576552
0,7891,15,一番くじゼルダの伝説２,239523,0.5941611597309043
0,7027,16,一番くじゼルダの伝説２,246550,0.611592347839892
0,4874,17,一番くじゼルダの伝説２,251424,0.6236828005000893
0,4102,18,一番くじゼルダの伝説２,255526,0.6338582286519419
0,3811,19,一番くじゼルダの伝説２,259337,0.643311801710623
0,4433,20,一番くじゼルダの伝説２,263770,0.6543083090234367
0,4426,21,一番くじゼルダの伝説２,268196,0.6652874521243873
0,6305,22,一番くじゼルダの伝説２,274501,0.6809276458097676
0,5382,23,一番くじゼルダの伝説２,279883,0.6942782441308963
0,3282,24,一番くじゼルダの伝説２,283165,0.7024195788930563
0,2883,25,一番くじゼルダの伝説２,286048,0.7095711535790121
0,4020,26,一番くじゼルダの伝説２,290068,0.7195431723918954
0,2554,27,一番くじゼルダの伝説２,292622,0.7258786291202795
0,2875,28,一番くじゼルダの伝説２,295497,0.7330103589926773
0,4063,29,一番くじゼルダの伝説２,299560,0.7430890436784346
0,3175,30,一番くじゼルダの伝説２,302735,0.7509649540592566
0,1946,31,一番くじゼルダの伝説２,304681,0.7557922049572344
0,1668,32,一番くじゼルダの伝説２,306349,0.7599298485840725
0,1868,33,一番くじゼルダの伝説２,308217,0.76456361254986
0,1849,34,一番くじゼルダの伝説２,310066,0.7691502450834474
0,2054,35,一番くじゼルダの伝説２,312120,0.7742454009644579
0,2674,36,一番くじゼルダの伝説２,314794,0.7808785298962116
0,2278,37,一番くじゼルダの伝説２,317072,0.7865293405568454
0,1453,38,一番くじゼルダの伝説２,318525,0.790133654819313
0,1416,39,一番くじゼルダの伝説２,319941,0.7936461868190748
0,1223,40,一番くじゼルダの伝説２,321164,0.7966799626917506
0,1403,41,一番くじゼルダの伝説２,322567,0.8001602468694806
0,1366,42,一番くじゼルダの伝説２,323933,0.8035487487845052
0,1705,43,一番くじゼルダの伝説２,325638,0.8077781746740489
0,1489,44,一番くじゼルダの伝説２,327127,0.8114717905975274
0,937,45,一番くじゼルダの伝説２,328064,0.8137961143855054
0,986,46,一番くじゼルダの伝説２,329050,0.816241987656526
0,980,47,一番くじゼルダの伝説２,330030,0.8186729773173781
0,1225,48,一番くじゼルダの伝説２,331255,0.8217117143934433
0,1300,49,一番くじゼルダの伝説２,332555,0.8249364965966145
0,1462,50,一番くじゼルダの伝説２,334017,0.8285631362743348
0,1155,51,一番くじゼルダの伝説２,335172,0.8314282312317676
0,684,52,一番くじゼルダの伝説２,335856,0.8331249627909746
0,778,53,一番くじゼルダの伝説２,336634,0.8350548709094878
0,734,54,一番くじゼルダの伝説２,337368,0.8368756325534321
0,792,55,一番くじゼルダの伝説２,338160,0.8388402690956719
0,860,56,一番くじゼルダの伝説２,339020,0.8409735865531544
0,1159,57,一番くじゼルダの伝説２,340179,0.8438486039173662
0,892,58,一番くじゼルダの伝説２,341071,0.8460613006290806
0,613,59,一番くじゼルダの伝説２,341684,0.8475819094679605
0,11470,0,一番くじワンピースＡＬＬＳＴＡＲ,11470,0.008266547509225092
704080,124812,1,一番くじワンピースＡＬＬＳＴＡＲ,136282,0.0982198454797048
682160,182507,2,一番くじワンピースＡＬＬＳＴＡＲ,318789,0.22975452606088562
0,152045,3,一番くじワンピースＡＬＬＳＴＡＲ,470834,0.33933492850553504
80,128940,4,一番くじワンピースＡＬＬＳＴＡＲ,599774,0.4322633187269373
0,111588,5,一番くじワンピースＡＬＬＳＴＡＲ,711362,0.5126859432656826
0,94463,6,一番くじワンピースＡＬＬＳＴＡＲ,805825,0.5807664033671587
1120,83038,7,一番くじワンピースＡＬＬＳＴＡＲ,888863,0.6406127479243543
0,70343,8,一番くじワンピースＡＬＬＳＴＡＲ,959206,0.6913096748154982
0,57803,9,一番くじワンピースＡＬＬＳＴＡＲ,1017009,0.7329688941420665
0,40118,10,一番くじワンピースＡＬＬＳＴＡＲ,1057127,0.7618823512453875
0,33956,11,一番くじワンピースＡＬＬＳＴＡＲ,1091083,0.7863547912822878
80,31070,12,一番くじワンピースＡＬＬＳＴＡＲ,1122153,0.808747261300738
0,26789,13,一番くじワンピースＡＬＬＳＴＡＲ,1148942,0.8280543703874539
0,25388,14,一番くじワンピースＡＬＬＳＴＡＲ,1174330,0.846351764298893
0,27207,15,一番くじワンピースＡＬＬＳＴＡＲ,1201537,0.8659601303044281
0,21848,16,一番くじワンピースＡＬＬＳＴＡＲ,1223385,0.8817062096402214
0,14295,17,一番くじワンピースＡＬＬＳＴＡＲ,1237680,0.8920087638376384
0,11838,18,一番くじワンピースＡＬＬＳＴＡＲ,1249518,0.9005405327490775
0,10656,19,一番くじワンピースＡＬＬＳＴＡＲ,1260174,0.9082204220479705
0,9446,20,一番くじワンピースＡＬＬＳＴＡＲ,1269620,0.9150282518450185
0,8892,21,一番くじワンピースＡＬＬＳＴＡＲ,1278512,0.9214368081180812
0,10036,22,一番くじワンピースＡＬＬＳＴＡＲ,1288548,0.9286698570110701
0,8767,23,一番くじワンピースＡＬＬＳＴＡＲ,1297315,0.9349883244926199
0,4983,24,一番くじワンピースＡＬＬＳＴＡＲ,1302298,0.9385796240774907
0,4331,25,一番くじワンピースＡＬＬＳＴＡＲ,1306629,0.9417010205258303
0,3780,26,一番くじワンピースＡＬＬＳＴＡＲ,1310409,0.9444253055811808
0,3548,27,一番くじワンピースＡＬＬＳＴＡＲ,1313957,0.9469823858394834
0,3141,28,一番くじワンピースＡＬＬＳＴＡＲ,1317098,0.94924613699262
0,4067,29,一番くじワンピースＡＬＬＳＴＡＲ,1321165,0.9521772659132841
0,3549,30,一番くじワンピースＡＬＬＳＴＡＲ,1324714,0.9547350668819188
0,1924,31,一番くじワンピースＡＬＬＳＴＡＲ,1326638,0.9561217135608856
0,1844,32,一番くじワンピースＡＬＬＳＴＡＲ,1328482,0.9574507034132841
0,1737,33,一番くじワンピースＡＬＬＳＴＡＲ,1330219,0.9587025772601476
0,1750,34,一番くじワンピースＡＬＬＳＴＡＲ,1331969,0.9599638203413284
0,1905,35,一番くじワンピースＡＬＬＳＴＡＲ,1333874,0.9613367735239853
0,2155,36,一番くじワンピースＡＬＬＳＴＡＲ,1336029,0.9628899042896679
0,2096,37,一番くじワンピースＡＬＬＳＴＡＲ,1338125,0.9644005131457565
0,1886,38,一番くじワンピースＡＬＬＳＴＡＲ,1340011,0.9657597728321033
0,1109,39,一番くじワンピースＡＬＬＳＴＡＲ,1341120,0.9665590405904059
0,843,40,一番くじワンピースＡＬＬＳＴＡＲ,1341963,0.967166599400369
0,966,41,一番くじワンピースＡＬＬＳＴＡＲ,1342929,0.9678628055811808
0,1072,42,一番くじワンピースＡＬＬＳＴＡＲ,1344001,0.9686354070571955
0,1184,43,一番くじワンピースＡＬＬＳＴＡＲ,1345185,0.9694887280904059
0,1238,44,一番くじワンピースＡＬＬＳＴＡＲ,1346423,0.9703809674815498
0,1073,45,一番くじワンピースＡＬＬＳＴＡＲ,1347496,0.9711542896678966
0,592,46,一番くじワンピースＡＬＬＳＴＡＲ,1348088,0.9715809501845019
0,877,47,一番くじワンピースＡＬＬＳＴＡＲ,1348965,0.9722130131457565
0,754,48,一番くじワンピースＡＬＬＳＴＡＲ,1349719,0.9727564287361624
0,736,49,一番くじワンピースＡＬＬＳＴＡＲ,1350455,0.9732868715405905
0,926,50,一番くじワンピースＡＬＬＳＴＡＲ,1351381,0.9739542493081181
0,664,51,一番くじワンピースＡＬＬＳＴＡＲ,1352045,0.9744328009686347
0,679,52,一番くじワンピースＡＬＬＳＴＡＲ,1352724,0.9749221632841328
0,408,53,一番くじワンピースＡＬＬＳＴＡＲ,1353132,0.975216213099631
0,481,54,一番くじワンピースＡＬＬＳＴＡＲ,1353613,0.9755628747693726
0,376,55,一番くじワンピースＡＬＬＳＴＡＲ,1353989,0.9758338618542436
0,480,56,一番くじワンピースＡＬＬＳＴＡＲ,1354469,0.9761798028136531
0,806,57,一番くじワンピースＡＬＬＳＴＡＲ,1355275,0.9767606953413284
0,696,58,一番くじワンピースＡＬＬＳＴＡＲ,1355971,0.9772623097324723
0,394,59,一番くじワンピースＡＬＬＳＴＡＲ,1356365,0.977546269603321
0,1130,0,一番くじるろうに剣心最終章,1130,0.005705168984076015
93984,14499,1,一番くじるろうに剣心最終章,15629,0.07890804075409207
104082,15552,2,一番くじるろうに剣心最終章,31181,0.15742732220572941
0,11822,3,一番くじるろうに剣心最終章,43003,0.2171144971878061
0,10086,4,一番くじるろうに剣心最終章,53089,0.2680369169872669
0,7538,5,一番くじるろうに剣心最終章,60627,0.3060949380509527
0,5529,6,一番くじるろうに剣心最終章,66156,0.33400987549604677
0,4896,7,一番くじるろうに剣心最終章,71052,0.3587289085456363
0,4308,8,一番くじるろうに剣心最終章,75360,0.3804792341946624
0,3874,9,一番くじるろうに剣心最終章,79234,0.40003837104803447
0,3609,10,一番くじるろうに剣心最終章,82843,0.4182595700423091
0,4846,11,一番くじるろうに剣心最終章,87689,0.4427261619864086
0,4169,12,一番くじるろうに剣心最終章,91858,0.4637747013621722
0,2917,13,一番くじるろうに剣心最終章,94775,0.478502115456464
0,2560,14,一番くじるろうに剣心最終章,97335,0.4914271000575566
0,2619,15,一番くじるろうに剣心最終章,99954,0.5046499651631274
0,2870,16,一番くじるろうに剣心最終章,102824,0.5191400846182586
0,2544,17,一番くじるろうに剣心最終章,105368,0.5319842880655943
0,3229,18,一番くじるろうに剣心最終章,108597,0.5482869346581443
0,2993,19,一番くじるろうに剣心最終章,111590,0.563398059232781
0,1965,20,一番くじるろうに剣心最終章,113555,0.5733189946785415
0,2130,21,一番くじるろうに剣心最終章,115685,0.5840729857724193
0,2441,22,一番くじるろうに剣心最終章,118126,0.5963971605424454
0,1949,23,一番くじるろうに剣心最終章,120075,0.6062373148344491
0,1971,24,一番くじるろうに剣心最終章,122046,0.6161885432128684
0,2088,25,一番くじるろうに剣心最終章,124134,0.6267304837781346
0,2360,26,一番くじるろうに剣心最終章,126494,0.6386457039572667
0,1628,27,一番くじるろうに剣心最終章,128122,0.6468651863520241
0,1680,28,一番くじるろうに剣心最終章,129802,0.6553472074964911
0,1290,29,一番くじるろうに剣心最終章,131092,0.6618601880181354
0,1125,30,一番くじるろうに剣心最終章,132217,0.6675401128916624
0,1737,31,一番くじるろうに剣心最終章,133954,0.6763099168963881
0,1718,32,一番くじるろうに剣心最終章,135672,0.6849837932810275
0,1704,33,一番くじるろうに剣心最終章,137376,0.6935869861561298
0,1046,34,一番くじるろうに剣心最終章,138422,0.6988680540829825
0,830,35,一番くじるろうに剣心最終章,139252,0.703058576434118
0,1100,36,一番くじるろうに剣心最終章,140352,0.7086122807548999
0,860,37,一番くじるろうに剣心最終章,141212,0.7129542677693295
0,1027,38,一番くじるろうに剣心最終章,142239,0.7181394080760959
0,1304,39,一番くじるろうに剣心最終章,143543,0.7247230721072774
0,1037,40,一番くじるろうに剣心最終章,144580,0.7299587006351418
0,782,41,一番くじるろうに剣心最終章,145362,0.7339068795250068
0,686,42,一番くじるろうに剣心最終章,146048,0.7373703714923309
0,646,43,一番くじるろうに剣心最終章,146694,0.7406319105752628
0,688,44,一番くじるろうに剣心最終章,147382,0.7441055001868064
0,682,45,一番くじるろうに剣心最終章,148064,0.7475487968656912
0,1017,46,一番くじるろうに剣心最終章,149081,0.7526834489513596
0,834,47,一番くじるろうに剣心最終章,149915,0.7568941665909343
0,525,48,一番くじるろうに剣心最終章,150440,0.7595447981985802
0,583,49,一番くじるろうに剣心最終章,151023,0.7624882614885947
0,523,50,一番くじるろうに剣心最終章,151546,0.7651287954520211
0,514,51,一番くじるろうに剣心最終章,152060,0.7677238900164591
0,600,52,一番くじるろうに剣心最終章,152660,0.7707531832823402
0,745,53,一番くじるろうに剣心最終章,153405,0.7745145557541425
0,637,54,一番くじるろうに剣心最終章,154042,0.7777306554380863
0,354,55,一番くじるろうに剣心最終章,154396,0.7795179384649561
0,467,56,一番くじるろうに剣心最終章,154863,0.7818757383902336
0,557,57,一番くじるろうに剣心最終章,155420,0.7846879323053931
0,342,58,一番くじるろうに剣心最終章,155762,0.7864146294669454
0,391,59,一番くじるろうに剣心最終章,156153,0.7883887189118779
0,2059,0,一番くじワンピースストロングワールド＊,2059,0.010295
101100,19760,1,一番くじワンピースストロングワールド＊,21819,0.109095
98700,38625,2,一番くじワンピースストロングワールド＊,60444,0.30222
0,33387,3,一番くじワンピースストロングワールド＊,93831,0.469155
0,27850,4,一番くじワンピースストロングワールド＊,121681,0.608405
0,22797,5,一番くじワンピースストロングワールド＊,144478,0.72239
0,15478,6,一番くじワンピースストロングワールド＊,159956,0.79978
100,12409,7,一番くじワンピースストロングワールド＊,172365,0.861825
100,9099,8,一番くじワンピースストロングワールド＊,181464,0.90732
0,5399,9,一番くじワンピースストロングワールド＊,186863,0.934315
0,2329,10,一番くじワンピースストロングワールド＊,189192,0.94596
0,1530,11,一番くじワンピースストロングワールド＊,190722,0.95361
0,991,12,一番くじワンピースストロングワールド＊,191713,0.958565
0,884,13,一番くじワンピースストロングワールド＊,192597,0.962985
0,665,14,一番くじワンピースストロングワールド＊,193262,0.96631
0,509,15,一番くじワンピースストロングワールド＊,193771,0.968855
0,332,16,一番くじワンピースストロングワールド＊,194103,0.970515
0,175,17,一番くじワンピースストロングワールド＊,194278,0.97139
0,220,18,一番くじワンピースストロングワールド＊,194498,0.97249
0,469,19,一番くじワンピースストロングワールド＊,194967,0.974835
0,90,20,一番くじワンピースストロングワールド＊,195057,0.975285
0,112,21,一番くじワンピースストロングワールド＊,195169,0.975845
0,161,22,一番くじワンピースストロングワールド＊,195330,0.97665
0,63,23,一番くじワンピースストロングワールド＊,195393,0.976965
0,80,24,一番くじワンピースストロングワールド＊,195473,0.977365
0,20,25,一番くじワンピースストロングワールド＊,195493,0.977465
0,25,26,一番くじワンピースストロングワールド＊,195518,0.97759
0,63,27,一番くじワンピースストロングワールド＊,195581,0.977905
0,29,28,一番くじワンピースストロングワールド＊,195610,0.97805
0,22,29,一番くじワンピースストロングワールド＊,195632,0.97816
0,20,30,一番くじワンピースストロングワールド＊,195652,0.97826
0,18,31,一番くじワンピースストロングワールド＊,195670,0.97835
0,20,32,一番くじワンピースストロングワールド＊,195690,0.97845
0,13,33,一番くじワンピースストロングワールド＊,195703,0.978515
0,8,34,一番くじワンピースストロングワールド＊,195711,0.978555
0,15,35,一番くじワンピースストロングワールド＊,195726,0.97863
0,5,36,一番くじワンピースストロングワールド＊,195731,0.978655
0,7,37,一番くじワンピースストロングワールド＊,195738,0.97869
0,2,38,一番くじワンピースストロングワールド＊,195740,0.9787
0,11,39,一番くじワンピースストロングワールド＊,195751,0.978755
0,3,40,一番くじワンピースストロングワールド＊,195754,0.97877
0,2,41,一番くじワンピースストロングワールド＊,195756,0.97878
0,1,42,一番くじワンピースストロングワールド＊,195757,0.978785
0,0,43,一番くじワンピースストロングワールド＊,195757,0.978785
0,0,44,一番くじワンピースストロングワールド＊,195757,0.978785
0,0,45,一番くじワンピースストロングワールド＊,195757,0.978785
0,0,46,一番くじワンピースストロングワールド＊,195757,0.978785
0,0,47,一番くじワンピースストロングワールド＊,195757,0.978785
0,3,48,一番くじワンピースストロングワールド＊,195760,0.9788
0,5,49,一番くじワンピースストロングワールド＊,195765,0.978825
0,3,50,一番くじワンピースストロングワールド＊,195768,0.97884
0,10,51,一番くじワンピースストロングワールド＊,195778,0.97889
0,4,52,一番くじワンピースストロングワールド＊,195782,0.97891
0,0,53,一番くじワンピースストロングワールド＊,195782,0.97891
0,2,54,一番くじワンピースストロングワールド＊,195784,0.97892
0,1,55,一番くじワンピースストロングワールド＊,195785,0.978925
0,1,56,一番くじワンピースストロングワールド＊,195786,0.97893
0,2,57,一番くじワンピースストロングワールド＊,195788,0.97894
0,0,58,一番くじワンピースストロングワールド＊,195788,0.97894
0,1,59,一番くじワンピースストロングワールド＊,195789,0.978945
0,4,0,一番くじプレミアムけいおん！＊,4,0.0004
10000,278,1,一番くじプレミアムけいおん！＊,282,0.0282
0,485,2,一番くじプレミアムけいおん！＊,767,0.0767
0,552,3,一番くじプレミアムけいおん！＊,1319,0.1319
0,732,4,一番くじプレミアムけいおん！＊,2051,0.2051
0,623,5,一番くじプレミアムけいおん！＊,2674,0.2674
0,421,6,一番くじプレミアムけいおん！＊,3095,0.3095
0,537,7,一番くじプレミアムけいおん！＊,3632,0.3632
0,441,8,一番くじプレミアムけいおん！＊,4073,0.4073
0,413,9,一番くじプレミアムけいおん！＊,4486,0.4486
0,439,10,一番くじプレミアムけいおん！＊,4925,0.4925
0,543,11,一番くじプレミアムけいおん！＊,5468,0.5468
0,450,12,一番くじプレミアムけいおん！＊,5918,0.5918
0,447,13,一番くじプレミアムけいおん！＊,6365,0.6365
0,260,14,一番くじプレミアムけいおん！＊,6625,0.6625
0,180,15,一番くじプレミアムけいおん！＊,6805,0.6805
0,157,16,一番くじプレミアムけいおん！＊,6962,0.6962
0,187,17,一番くじプレミアムけいおん！＊,7149,0.7149
0,180,18,一番くじプレミアムけいおん！＊,7329,0.7329
0,220,19,一番くじプレミアムけいおん！＊,7549,0.7549
0,115,20,一番くじプレミアムけいおん！＊,7664,0.7664
0,137,21,一番くじプレミアムけいおん！＊,7801,0.7801
0,116,22,一番くじプレミアムけいおん！＊,7917,0.7917
0,121,23,一番くじプレミアムけいおん！＊,8038,0.8038
0,163,24,一番くじプレミアムけいおん！＊,8201,0.8201
0,168,25,一番くじプレミアムけいおん！＊,8369,0.8369
0,126,26,一番くじプレミアムけいおん！＊,8495,0.8495
0,112,27,一番くじプレミアムけいおん！＊,8607,0.8607
0,84,28,一番くじプレミアムけいおん！＊,8691,0.8691
0,50,29,一番くじプレミアムけいおん！＊,8741,0.8741
0,43,30,一番くじプレミアムけいおん！＊,8784,0.8784
0,30,31,一番くじプレミアムけいおん！＊,8814,0.8814
0,45,32,一番くじプレミアムけいおん！＊,8859,0.8859
0,20,33,一番くじプレミアムけいおん！＊,8879,0.8879
0,27,34,一番くじプレミアムけいおん！＊,8906,0.8906
0,64,35,一番くじプレミアムけいおん！＊,8970,0.897
0,32,36,一番くじプレミアムけいおん！＊,9002,0.9002
0,42,37,一番くじプレミアムけいおん！＊,9044,0.9044
0,14,38,一番くじプレミアムけいおん！＊,9058,0.9058
0,43,39,一番くじプレミアムけいおん！＊,9101,0.9101
0,12,40,一番くじプレミアムけいおん！＊,9113,0.9113
0,6,41,一番くじプレミアムけいおん！＊,9119,0.9119
0,4,42,一番くじプレミアムけいおん！＊,9123,0.9123
0,9,43,一番くじプレミアムけいおん！＊,9132,0.9132
0,9,44,一番くじプレミアムけいおん！＊,9141,0.9141
0,0,45,一番くじプレミアムけいおん！＊,9141,0.9141
0,0,46,一番くじプレミアムけいおん！＊,9141,0.9141
0,4,47,一番くじプレミアムけいおん！＊,9145,0.9145
0,0,48,一番くじプレミアムけいおん！＊,9145,0.9145
0,0,49,一番くじプレミアムけいおん！＊,9145,0.9145
0,0,50,一番くじプレミアムけいおん！＊,9145,0.9145
0,0,51,一番くじプレミアムけいおん！＊,9145,0.9145
0,0,52,一番くじプレミアムけいおん！＊,9145,0.9145
0,0,53,一番くじプレミアムけいおん！＊,9145,0.9145
0,0,54,一番くじプレミアムけいおん！＊,9145,0.9145
0,0,55,一番くじプレミアムけいおん！＊,9145,0.9145
0,0,56,一番くじプレミアムけいおん！＊,9145,0.9145
0,0,57,一番くじプレミアムけいおん！＊,9145,0.9145
0,0,58,一番くじプレミアムけいおん！＊,9145,0.9145
0,0,59,一番くじプレミアムけいおん！＊,9145,0.9145
660,82,0,一番くじ美少女戦士セーラームーン２０ｔｈ※,82,0.12424242424242424
0,30,1,一番くじ美少女戦士セーラームーン２０ｔｈ※,112,0.1696969696969697
0,27,2,一番くじ美少女戦士セーラームーン２０ｔｈ※,139,0.2106060606060606
0,15,3,一番くじ美少女戦士セーラームーン２０ｔｈ※,154,0.23333333333333334
0,29,4,一番くじ美少女戦士セーラームーン２０ｔｈ※,183,0.2772727272727273
0,16,5,一番くじ美少女戦士セーラームーン２０ｔｈ※,199,0.3015151515151515
0,6,6,一番くじ美少女戦士セーラームーン２０ｔｈ※,205,0.3106060606060606
0,30,7,一番くじ美少女戦士セーラームーン２０ｔｈ※,235,0.3560606060606061
0,34,8,一番くじ美少女戦士セーラームーン２０ｔｈ※,269,0.4075757575757576
0,8,9,一番くじ美少女戦士セーラームーン２０ｔｈ※,277,0.4196969696969697
0,27,10,一番くじ美少女戦士セーラームーン２０ｔｈ※,304,0.46060606060606063
0,37,11,一番くじ美少女戦士セーラームーン２０ｔｈ※,341,0.5166666666666667
0,4,12,一番くじ美少女戦士セーラームーン２０ｔｈ※,345,0.5227272727272727
0,20,13,一番くじ美少女戦士セーラームーン２０ｔｈ※,365,0.553030303030303
0,18,14,一番くじ美少女戦士セーラームーン２０ｔｈ※,383,0.5803030303030303
0,11,15,一番くじ美少女戦士セーラームーン２０ｔｈ※,394,0.5969696969696969
0,5,16,一番くじ美少女戦士セーラームーン２０ｔｈ※,399,0.6045454545454545
0,10,17,一番くじ美少女戦士セーラームーン２０ｔｈ※,409,0.6196969696969697
0,8,18,一番くじ美少女戦士セーラームーン２０ｔｈ※,417,0.6318181818181818
0,5,19,一番くじ美少女戦士セーラームーン２０ｔｈ※,422,0.6393939393939394
0,7,20,一番くじ美少女戦士セーラームーン２０ｔｈ※,429,0.65
0,5,21,一番くじ美少女戦士セーラームーン２０ｔｈ※,434,0.6575757575757576
0,3,22,一番くじ美少女戦士セーラームーン２０ｔｈ※,437,0.6621212121212121
0,11,23,一番くじ美少女戦士セーラームーン２０ｔｈ※,448,0.6787878787878788
0,13,24,一番くじ美少女戦士セーラームーン２０ｔｈ※,461,0.6984848484848485
0,5,25,一番くじ美少女戦士セーラームーン２０ｔｈ※,466,0.706060606060606
0,7,26,一番くじ美少女戦士セーラームーン２０ｔｈ※,473,0.7166666666666667
0,17,27,一番くじ美少女戦士セーラームーン２０ｔｈ※,490,0.7424242424242424
0,1,28,一番くじ美少女戦士セーラームーン２０ｔｈ※,491,0.7439393939393939
0,7,29,一番くじ美少女戦士セーラームーン２０ｔｈ※,498,0.7545454545454545
0,3,30,一番くじ美少女戦士セーラームーン２０ｔｈ※,501,0.759090909090909
0,0,31,一番くじ美少女戦士セーラームーン２０ｔｈ※,501,0.759090909090909
0,9,32,一番くじ美少女戦士セーラームーン２０ｔｈ※,510,0.7727272727272727
0,5,33,一番くじ美少女戦士セーラームーン２０ｔｈ※,515,0.7803030303030303
0,2,34,一番くじ美少女戦士セーラームーン２０ｔｈ※,517,0.7833333333333333
0,1,35,一番くじ美少女戦士セーラームーン２０ｔｈ※,518,0.7848484848484848
0,11,36,一番くじ美少女戦士セーラームーン２０ｔｈ※,529,0.8015151515151515
0,4,37,一番くじ美少女戦士セーラームーン２０ｔｈ※,533,0.8075757575757576
0,26,38,一番くじ美少女戦士セーラームーン２０ｔｈ※,559,0.8469696969696969
0,0,39,一番くじ美少女戦士セーラームーン２０ｔｈ※,559,0.8469696969696969
0,4,40,一番くじ美少女戦士セーラームーン２０ｔｈ※,563,0.853030303030303
0,0,41,一番くじ美少女戦士セーラームーン２０ｔｈ※,563,0.853030303030303
0,0,42,一番くじ美少女戦士セーラームーン２０ｔｈ※,563,0.853030303030303
0,7,43,一番くじ美少女戦士セーラームーン２０ｔｈ※,570,0.8636363636363636
0,1,44,一番くじ美少女戦士セーラームーン２０ｔｈ※,571,0.8651515151515151
0,1,45,一番くじ美少女戦士セーラームーン２０ｔｈ※,572,0.8666666666666667
0,1,46,一番くじ美少女戦士セーラームーン２０ｔｈ※,573,0.8681818181818182
0,1,47,一番くじ美少女戦士セーラームーン２０ｔｈ※,574,0.8696969696969697
0,1,48,一番くじ美少女戦士セーラームーン２０ｔｈ※,575,0.8712121212121212
0,0,49,一番くじ美少女戦士セーラームーン２０ｔｈ※,575,0.8712121212121212
0,7,50,一番くじ美少女戦士セーラームーン２０ｔｈ※,582,0.8818181818181818
0,0,51,一番くじ美少女戦士セーラームーン２０ｔｈ※,582,0.8818181818181818
0,2,52,一番くじ美少女戦士セーラームーン２０ｔｈ※,584,0.8848484848484849
0,2,53,一番くじ美少女戦士セーラームーン２０ｔｈ※,586,0.8878787878787879
0,1,54,一番くじ美少女戦士セーラームーン２０ｔｈ※,587,0.8893939393939394
0,2,55,一番くじ美少女戦士セーラームーン２０ｔｈ※,589,0.8924242424242425
0,0,56,一番くじ美少女戦士セーラームーン２０ｔｈ※,589,0.8924242424242425
0,1,57,一番くじ美少女戦士セーラームーン２０ｔｈ※,590,0.8939393939393939
0,11,58,一番くじ美少女戦士セーラームーン２０ｔｈ※,601,0.9106060606060606
0,0,59,一番くじ美少女戦士セーラームーン２０ｔｈ※,601,0.9106060606060606
0,1269,0,一番くじ黒子のバスケ放課後ｖｅｒ．１※,1269,0.00876865671641791
70860,10761,1,一番くじ黒子のバスケ放課後ｖｅｒ．１※,12030,0.08312603648424544
73800,17918,2,一番くじ黒子のバスケ放課後ｖｅｒ．１※,29948,0.20693753454947486
0,8176,3,一番くじ黒子のバスケ放課後ｖｅｒ．１※,38124,0.26343283582089555
0,5811,4,一番くじ黒子のバスケ放課後ｖｅｒ．１※,43935,0.3035862354892206
0,4316,5,一番くじ黒子のバスケ放課後ｖｅｒ．１※,48251,0.3334093421779989
0,3903,6,一番くじ黒子のバスケ放課後ｖｅｒ．１※,52154,0.3603786622443339
0,3074,7,一番くじ黒子のバスケ放課後ｖｅｒ．１※,55228,0.38161967938087343
0,3103,8,一番くじ黒子のバスケ放課後ｖｅｒ．１※,58331,0.40306108347153125
0,3146,9,一番くじ黒子のバスケ放課後ｖｅｒ．１※,61477,0.4247996130458817
0,2550,10,一番くじ黒子のバスケ放課後ｖｅｒ．１※,64027,0.4424198452183527
0,2287,11,一番くじ黒子のバスケ放課後ｖｅｒ．１※,66314,0.4582227750138198
0,1627,12,一番くじ黒子のバスケ放課後ｖｅｒ．１※,67941,0.46946517412935324
0,1457,13,一番くじ黒子のバスケ放課後ｖｅｒ．１※,69398,0.47953289110005526
0,1301,14,一番くじ黒子のバスケ放課後ｖｅｒ．１※,70699,0.4885226644555003
0,1420,15,一番くじ黒子のバスケ放課後ｖｅｒ．１※,72119,0.49833471531232726
0,1691,16,一番くじ黒子のバスケ放課後ｖｅｒ．１※,73810,0.5100193477059148
0,1558,17,一番くじ黒子のバスケ放課後ｖｅｒ．１※,75368,0.5207849640685461
0,1172,18,一番くじ黒子のバスケ放課後ｖｅｒ．１※,76540,0.5288833609729132
0,1491,19,一番くじ黒子のバスケ放課後ｖｅｒ．１※,78031,0.5391860143725815
0,790,20,一番くじ黒子のバスケ放課後ｖｅｒ．１※,78821,0.5446448313985628
0,1157,21,一番くじ黒子のバスケ放課後ｖｅｒ．１※,79978,0.5526395798783859
0,1141,22,一番くじ黒子のバスケ放課後ｖｅｒ．１※,81119,0.5605237700386954
0,1170,23,一番くじ黒子のバスケ放課後ｖｅｒ．１※,82289,0.5686083471531233
0,1081,24,一番くじ黒子のバスケ放課後ｖｅｒ．１※,83370,0.576077943615257
0,830,25,一番くじ黒子のバスケ放課後ｖｅｒ．１※,84200,0.5818131564400221
0,793,26,一番くじ黒子のバスケ放課後ｖｅｒ．１※,84993,0.5872927031509121
0,758,27,一番くじ黒子のバスケ放課後ｖｅｒ．１※,85751,0.5925304035378662
0,629,28,一番くじ黒子のバスケ放課後ｖｅｒ．１※,86380,0.5968767274737424
60,734,29,一番くじ黒子のバスケ放課後ｖｅｒ．１※,87114,0.6019485903814262
0,944,30,一番くじ黒子のバスケ放課後ｖｅｒ．１※,88058,0.6084715312327252
0,770,31,一番くじ黒子のバスケ放課後ｖｅｒ．１※,88828,0.6137921503593146
0,486,32,一番くじ黒子のバスケ放課後ｖｅｒ．１※,89314,0.6171503593145384
0,578,33,一番くじ黒子のバスケ放課後ｖｅｒ．１※,89892,0.6211442786069652
0,534,34,一番くじ黒子のバスケ放課後ｖｅｒ．１※,90426,0.6248341625207297
0,645,35,一番くじ黒子のバスケ放課後ｖｅｒ．１※,91071,0.6292910447761194
0,570,36,一番くじ黒子のバスケ放課後ｖｅｒ．１※,91641,0.6332296849087894
0,785,37,一番くじ黒子のバスケ放課後ｖｅｒ．１※,92426,0.6386539524599226
0,804,38,一番くじ黒子のバスケ放課後ｖｅｒ．１※,93230,0.6442095080154782
0,527,39,一番くじ黒子のバスケ放課後ｖｅｒ．１※,93757,0.6478510226644555
0,351,40,一番くじ黒子のバスケ放課後ｖｅｒ．１※,94108,0.6502763957987838
0,521,41,一番くじ黒子のバスケ放課後ｖｅｒ．１※,94629,0.6538764510779436
0,443,42,一番くじ黒子のバスケ放課後ｖｅｒ．１※,95072,0.6569375345494749
0,505,43,一番くじ黒子のバスケ放課後ｖｅｒ．１※,95577,0.6604270315091211
0,689,44,一番くじ黒子のバスケ放課後ｖｅｒ．１※,96266,0.665187949143173
0,587,45,一番くじ黒子のバスケ放課後ｖｅｒ．１※,96853,0.6692440574903261
0,410,46,一番くじ黒子のバスケ放課後ｖｅｒ．１※,97263,0.6720771144278607
0,380,47,一番くじ黒子のバスケ放課後ｖｅｒ．１※,97643,0.6747028745163074
0,423,48,一番くじ黒子のバスケ放課後ｖｅｒ．１※,98066,0.6776257600884467
0,293,49,一番くじ黒子のバスケ放課後ｖｅｒ．１※,98359,0.6796503593145384
0,494,50,一番くじ黒子のバスケ放課後ｖｅｒ．１※,98853,0.6830638474295191
0,586,51,一番くじ黒子のバスケ放課後ｖｅｒ．１※,99439,0.6871130458817026
0,629,52,一番くじ黒子のバスケ放課後ｖｅｒ．１※,100068,0.6914593698175787
0,359,53,一番くじ黒子のバスケ放課後ｖｅｒ．１※,100427,0.693940022111664
0,342,54,一番くじ黒子のバスケ放課後ｖｅｒ．１※,100769,0.6963032061912658
0,322,55,一番くじ黒子のバスケ放課後ｖｅｒ．１※,101091,0.698528192371476
0,210,56,一番くじ黒子のバスケ放課後ｖｅｒ．１※,101301,0.6999792703150912
0,282,57,一番くじ黒子のバスケ放課後ｖｅｒ．１※,101583,0.7019278606965174
0,401,58,一番くじ黒子のバスケ放課後ｖｅｒ．１※,101984,0.7046987285793256
0,414,59,一番くじ黒子のバスケ放課後ｖｅｒ．１※,102398,0.7075594250967385
0,713,0,一番くじディズニーツムツム大集合！,713,0.0015615418309242225
221280,10698,1,一番くじディズニーツムツム大集合！,11411,0.024991239597021462
235260,19198,2,一番くじディズニーツムツム大集合！,30609,0.06703679369250985
60,18560,3,一番くじディズニーツムツム大集合！,49169,0.10768506351292159
0,21800,4,一番くじディズニーツムツム大集合！,70969,0.15542925974594832
0,18268,5,一番くじディズニーツムツム大集合！,89237,0.19543802014892686
0,11773,6,一番くじディズニーツムツム大集合！,101010,0.2212220762155059
0,10976,7,一番くじディズニーツムツム大集合！,111986,0.24526062198861148
0,12082,8,一番くじディズニーツムツム大集合！,124068,0.27172141918528253
0,10195,9,一番くじディズニーツムツム大集合！,134263,0.29404949627682875
0,9441,10,一番くじディズニーツムツム大集合！,143704,0.31472623740692074
0,11243,11,一番くじディズニーツムツム大集合！,154947,0.3393495400788436
0,9103,12,一番くじディズニーツムツム大集合！,164050,0.3592860271572492
0,6573,13,一番くじディズニーツムツム大集合！,170623,0.3736815593517302
0,6130,14,一番くじディズニーツムツム大集合！,176753,0.38710687691633816
0,6269,15,一番くじディズニーツムツム大集合！,183022,0.4008366184844503
0,5773,16,一番くじディズニーツムツム大集合！,188795,0.41348007008322385
0,6304,17,一番くじディズニーツムツム大集合！,195099,0.42728646517739816
0,8304,18,一番くじディズニーツムツム大集合！,203403,0.445473061760841
0,8087,19,一番くじディズニーツムツム大集合！,211490,0.4631844064826982
0,4926,20,一番くじディズニーツムツム大集合！,216416,0.4739728427507665
0,4996,21,一番くじディズニーツムツム大集合！,221412,0.4849145860709593
0,4743,22,一番くじディズニーツムツム大集合！,226155,0.4953022339027595
0,4813,23,一番くじディズニーツムツム大集合！,230968,0.5058431887866842
0,5245,24,一番くじディズニーツムツム大集合！,236213,0.5173302671922908
0,6420,25,一番くじディズニーツムツム大集合！,242633,0.5313907139728428
0,5892,26,一番くじディズニーツムツム大集合！,248525,0.5442947875602278
0,3942,27,一番くじディズニーツムツム大集合！,252467,0.552928164695576
0,4290,28,一番くじディズニーツムツム大集合！,256757,0.5623236968900569
0,4181,29,一番くじディズニーツムツム大集合！,260938,0.5714805081033728
0,4170,30,一番くじディズニーツムツム大集合！,265108,0.5806132282084976
0,4974,31,一番くじディズニーツムツム大集合！,270082,0.5915067893123084
0,5956,32,一番くじディズニーツムツム大集合！,276038,0.6045510293473499
0,5130,33,一番くじディズニーツムツム大集合！,281168,0.6157862461673237
0,3450,34,一番くじディズニーツムツム大集合！,284618,0.6233420937363119
0,3160,35,一番くじディズニーツムツム大集合！,287778,0.6302628120893561
0,3254,36,一番くじディズニーツムツム大集合！,291032,0.637389399912396
0,2991,37,一番くじディズニーツムツム大集合！,294023,0.643939991239597
0,3335,38,一番くじディズニーツムツム大集合！,297358,0.6512439772229522
0,4266,39,一番くじディズニーツムツム大集合！,301624,0.660586946999562
0,3383,40,一番くじディズニーツムツム大集合！,305007,0.6679960578186597
0,2241,41,一番くじディズニーツムツム大集合！,307248,0.672904073587385
0,2637,42,一番くじディズニーツムツム大集合！,309885,0.6786793692509856
0,2927,43,一番くじディズニーツムツム大集合！,312812,0.68508979413053
0,2764,44,一番くじディズニーツムツム大集合！,315576,0.691143232588699
0,3159,45,一番くじディズニーツムツム大集合！,318735,0.6980617608409987
0,3119,46,一番くじディズニーツムツム大集合！,321854,0.7048926850635129
0,3018,47,一番くじディズニーツムツム大集合！,324872,0.7115024091108191
0,2933,48,一番くじディズニーツムツム大集合！,327805,0.7179259745948313
0,3026,49,一番くじディズニーツムツム大集合！,330831,0.7245532194480946
0,3854,50,一番くじディズニーツムツム大集合！,334685,0.732993867717915
0,3539,51,一番くじディズニーツムツム大集合！,338224,0.7407446342531756
0,3111,52,一番くじディズニーツムツム大集合！,341335,0.7475580376697328
0,2641,53,一番くじディズニーツムツム大集合！,343976,0.7533420937363119
0,2296,54,一番くじディズニーツムツム大集合！,346272,0.7583705650459921
0,1762,55,一番くじディズニーツムツム大集合！,348034,0.7622295225580377
0,1589,56,一番くじディズニーツムツム大集合！,349623,0.7657095926412615
0,1454,57,一番くじディズニーツムツム大集合！,351077,0.7688939991239597
0,1473,58,一番くじディズニーツムツム大集合！,352550,0.772120017520806
0,1953,59,一番くじディズニーツムツム大集合！,354503,0.7763972842750767
132,6885,0,一番くじワンピース最悪の世代,6885,0.004695421605895567
738936,78078,1,一番くじワンピース最悪の世代,84963,0.057942934771489485
727122,245055,2,一番くじワンピース最悪の世代,330018,0.22506516304058727
66,209414,3,一番くじワンピース最悪の世代,539432,0.36788099748895536
66,148447,4,一番くじワンピース最悪の世代,687879,0.469118651974123
0,84126,5,一番くじワンピース最悪の世代,772005,0.5264907707856801
0,68120,6,一番くじワンピース最悪の世代,840125,0.572947142578506
0,57793,7,一番くじワンピース最悪の世代,897918,0.6123607229517118
0,47109,8,一番くじワンピース最悪の世代,945027,0.6444880455998069
0,45015,9,一番くじワンピース最悪の世代,990042,0.6751873053804007
0,49555,10,一番くじワンピース最悪の世代,1039597,0.708982747309254
0,40867,11,一番くじワンピース最悪の世代,1080464,0.7368531604927158
0,24796,12,一番くじワンピース最悪の世代,1105260,0.7537634980584074
0,20482,13,一番くじワンピース最悪の世代,1125742,0.7677317806048057
0,18577,14,一番くじワンピース最悪の世代,1144319,0.7804008942101394
0,16807,15,一番くじワンピース最悪の世代,1161126,0.7918629059647199
0,15158,16,一番くじワンピース最悪の世代,1176284,0.8022003352606044
0,19812,17,一番くじワンピース最悪の世代,1196096,0.8157116922476783
0,18116,18,一番くじワンピース最悪の世代,1214212,0.8280664137890587
0,11025,19,一番くじワンピース最悪の世代,1225237,0.8355852261645123
0,10492,20,一番くじワンピース最悪の世代,1235729,0.8427405440278466
0,9407,21,一番くじワンピース最悪の世代,1245136,0.8491559152764536
0,9022,22,一番くじワンピース最悪の世代,1254158,0.8553087248230606
0,9658,23,一番くじワンピース最悪の世代,1263816,0.8618952726618028
0,10461,24,一番くじワンピース最悪の世代,1274277,0.8690294491932877
0,9809,25,一番くじワンピース最悪の世代,1284086,0.8757189757774896
0,5863,26,一番くじワンピース最悪の世代,1289949,0.8797174154108034
0,5274,27,一番くじワンピース最悪の世代,1295223,0.8833141697389796
0,4905,28,一番くじワンピース最悪の世代,1300128,0.8866592740203039
0,4501,29,一番くじワンピース最悪の世代,1304629,0.8897288590091399
0,4824,30,一番くじワンピース最悪の世代,1309453,0.8930187230362772
0,6597,31,一番くじワンピース最悪の世代,1316050,0.8975177348495078
0,6011,32,一番くじワンピース最悪の世代,1322061,0.9016171072929411
0,3371,33,一番くじワンピース最悪の世代,1325432,0.9039160566369461
0,3425,34,一番くじワンピース最悪の世代,1328857,0.9062518328170757
0,4096,35,一番くじワンピース最悪の世代,1332953,0.9090452165349766
0,3419,36,一番くじワンピース最悪の世代,1336372,0.9113769008444257
0,3573,37,一番くじワンピース最悪の世代,1339945,0.9138136098346747
0,4775,38,一番くじワンピース最悪の世代,1344720,0.9170700569179212
0,4122,39,一番くじワンピース最悪の世代,1348842,0.9198811720754377
0,3048,40,一番くじワンピース最悪の世代,1351890,0.9219598423811414
0,2624,41,一番くじワンピース最悪の世代,1354514,0.9237493538254217
0,2435,42,一番くじワンピース最悪の世代,1356949,0.9254099713432656
0,2500,43,一番くじワンピース最悪の世代,1359449,0.9271149174601486
0,2726,44,一番くじワンピース最悪の世代,1362175,0.9289739907059977
0,3084,45,一番くじワンピース最悪の世代,1365259,0.9310772122357845
0,2135,46,一番くじワンピース最悪の世代,1367394,0.9325332362196025
0,1526,47,一番くじワンピース最悪の世代,1368920,0.9335739353293478
0,1409,48,一番くじワンピース最悪の世代,1370329,0.9345348429608231
0,1037,49,一番くじワンピース最悪の世代,1371366,0.9352420546101061
0,1289,50,一番くじワンピース最悪の世代,1372655,0.9361211248279709
0,1261,51,一番くじワンピース最悪の世代,1373916,0.9369810996493266
0,1412,52,一番くじワンピース最悪の世代,1375328,0.9379440532161422
0,1232,53,一番くじワンピース最悪の世代,1376560,0.938784250662542
0,1043,54,一番くじワンピース最悪の世代,1377603,0.9394955541825056
0,939,55,一番くじワンピース最悪の世代,1378542,0.9401359319440068
0,909,56,一番くじワンピース最悪の世代,1379451,0.9407558503521055
0,982,57,一番くじワンピース最悪の世代,1380433,0.9414255531868171
0,1006,58,一番くじワンピース最悪の世代,1381439,0.9421116235042508
0,1247,59,一番くじワンピース最悪の世代,1382686,0.9429620506273519
0,4063,0,一番くじモンスターハンター３（トライ）Ｇ,4063,0.002771487039563438
1385700,89993,1,一番くじモンスターハンター３（トライ）Ｇ,94056,0.06415825375170532
0,154309,2,一番くじモンスターハンター３（トライ）Ｇ,248365,0.1694167803547067
0,141596,3,一番くじモンスターハンター３（トライ）Ｇ,389961,0.26600341064120053
0,117296,4,一番くじモンスターハンター３（トライ）Ｇ,507257,0.3460143246930423
0,86145,5,一番くじモンスターハンター３（トライ）Ｇ,593402,0.4047762619372442
0,84296,6,一番くじモンスターハンター３（トライ）Ｇ,677698,0.4622769440654843
0,58496,7,一番くじモンスターハンター３（トライ）Ｇ,736194,0.5021787175989086
0,51612,8,一番くじモンスターハンター３（トライ）Ｇ,787806,0.5373847203274216
0,50973,9,一番くじモンスターハンター３（トライ）Ｇ,838779,0.5721548431105048
0,55262,10,一番くじモンスターハンター３（トライ）Ｇ,894041,0.6098506139154161
0,46306,11,一番くじモンスターハンター３（トライ）Ｇ,940347,0.64143724420191
0,34224,12,一番くじモンスターハンター３（トライ）Ｇ,974571,0.6647824010914052
0,29767,13,一番くじモンスターハンター３（トライ）Ｇ,1004338,0.685087312414734
0,25938,14,一番くじモンスターハンター３（トライ）Ｇ,1030276,0.7027803547066849
0,23398,15,一番くじモンスターハンター３（トライ）Ｇ,1053674,0.7187407912687586
0,22897,16,一番くじモンスターハンター３（トライ）Ｇ,1076571,0.7343594815825375
0,21144,17,一番くじモンスターハンター３（トライ）Ｇ,1097715,0.7487824010914051
0,21091,18,一番くじモンスターハンター３（トライ）Ｇ,1118806,0.763169167803547
0,15034,19,一番くじモンスターハンター３（トライ）Ｇ,1133840,0.7734242837653479
0,11360,20,一番くじモンスターハンター３（トライ）Ｇ,1145200,0.7811732605729877
0,12019,21,一番くじモンスターハンター３（トライ）Ｇ,1157219,0.7893717598908595
0,10354,22,一番くじモンスターハンター３（トライ）Ｇ,1167573,0.7964345156889495
0,9942,23,一番くじモンスターハンター３（トライ）Ｇ,1177515,0.8032162346521146
0,10916,24,一番くじモンスターハンター３（トライ）Ｇ,1188431,0.810662346521146
0,10225,25,一番くじモンスターハンター３（トライ）Ｇ,1198656,0.817637107776262
0,6690,26,一番くじモンスターハンター３（トライ）Ｇ,1205346,0.822200545702592
0,6476,27,一番くじモンスターハンター３（トライ）Ｇ,1211822,0.8266180081855389
0,5208,28,一番くじモンスターハンター３（トライ）Ｇ,1217030,0.8301705320600273
0,5610,29,一番くじモンスターハンター３（トライ）Ｇ,1222640,0.8339972714870396
0,6617,30,一番くじモンスターハンター３（トライ）Ｇ,1229257,0.8385109140518417
0,7481,31,一番くじモンスターハンター３（トライ）Ｇ,1236738,0.8436139154160982
0,6851,32,一番くじモンスターハンター３（トライ）Ｇ,1243589,0.848287175989086
0,3976,33,一番くじモンスターハンター３（トライ）Ｇ,1247565,0.8509993178717599
0,3562,34,一番くじモンスターハンター３（トライ）Ｇ,1251127,0.8534290586630287
0,3600,35,一番くじモンスターハンター３（トライ）Ｇ,1254727,0.8558847203274216
0,2963,36,一番くじモンスターハンター３（トライ）Ｇ,1257690,0.8579058663028649
0,3757,37,一番くじモンスターハンター３（トライ）Ｇ,1261447,0.860468622100955
0,3759,38,一番くじモンスターハンター３（トライ）Ｇ,1265206,0.8630327421555253
0,3220,39,一番くじモンスターハンター３（トライ）Ｇ,1268426,0.8652291950886767
0,2055,40,一番くじモンスターハンター３（トライ）Ｇ,1270481,0.866630968622101
0,1943,41,一番くじモンスターハンター３（トライ）Ｇ,1272424,0.867956343792633
0,2392,42,一番くじモンスターハンター３（トライ）Ｇ,1274816,0.8695879945429741
0,1753,43,一番くじモンスターハンター３（トライ）Ｇ,1276569,0.8707837653478854
0,2153,44,一番くじモンスターハンター３（トライ）Ｇ,1278722,0.8722523874488404
0,2654,45,一番くじモンスターハンター３（トライ）Ｇ,1281376,0.87406275579809
0,2704,46,一番くじモンスターハンター３（トライ）Ｇ,1284080,0.8759072305593452
0,2149,47,一番くじモンスターハンター３（トライ）Ｇ,1286229,0.8773731241473397
0,1500,48,一番くじモンスターハンター３（トライ）Ｇ,1287729,0.8783963165075034
0,1614,49,一番くじモンスターハンター３（トライ）Ｇ,1289343,0.8794972714870396
0,2154,50,一番くじモンスターハンター３（トライ）Ｇ,1291497,0.8809665757162346
0,2348,51,一番くじモンスターハンター３（トライ）Ｇ,1293845,0.8825682128240109
0,2224,52,一番くじモンスターハンター３（トライ）Ｇ,1296069,0.8840852660300137
0,1519,53,一番くじモンスターハンター３（トライ）Ｇ,1297588,0.8851214188267394
0,836,54,一番くじモンスターハンター３（トライ）Ｇ,1298424,0.8856916780354707
0,893,55,一番くじモンスターハンター３（トライ）Ｇ,1299317,0.8863008185538881
0,904,56,一番くじモンスターハンター３（トライ）Ｇ,1300221,0.8869174624829468
36600,1492,57,一番くじモンスターハンター３（トライ）Ｇ,1301713,0.8879351978171897
34500,2165,58,一番くじモンスターハンター３（トライ）Ｇ,1303878,0.8894120054570259
300,3504,59,一番くじモンスターハンター３（トライ）Ｇ,1307382,0.8918021828103684
4560,5851,0,一番くじモンスターストライクｖｏｌ．６,5851,0.01327118490292143
230880,35081,1,一番くじモンスターストライクｖｏｌ．６,40932,0.09284158954817638
205360,41271,2,一番くじモンスターストライクｖｏｌ．６,82203,0.18645209580838323
0,34212,3,一番くじモンスターストライクｖｏｌ．６,116415,0.26405144256940666
80,17535,4,一番くじモンスターストライクｖｏｌ．６,133950,0.3038241698421339
0,15203,5,一番くじモンスターストライクｖｏｌ．６,149153,0.33830747595717653
0,11982,6,一番くじモンスターストライクｖｏｌ．６,161135,0.36548493921248415
0,12683,7,一番くじモンスターストライクｖｏｌ．６,173818,0.3942524042823444
0,16667,8,一番くじモンスターストライクｖｏｌ．６,190485,0.4320563418617311
0,16413,9,一番くじモンスターストライクｖｏｌ．６,206898,0.4692841589548176
0,9204,10,一番くじモンスターストライクｖｏｌ．６,216102,0.49016058791507894
0,12327,11,一番くじモンスターストライクｖｏｌ．６,228429,0.5181205770277627
0,7910,12,一番くじモンスターストライクｖｏｌ．６,236339,0.5360619669751406
0,6405,13,一番くじモンスターストライクｖｏｌ．６,242744,0.5505897296316458
0,7260,14,一番くじモンスターストライクｖｏｌ．６,250004,0.5670567954999093
0,8381,15,一番くじモンスターストライクｖｏｌ．６,258385,0.5860665033569226
0,7876,16,一番くじモンスターストライクｖｏｌ．６,266261,0.6039307748140084
0,4937,17,一番くじモンスターストライクｖｏｌ．６,271198,0.6151288332426057
0,5052,18,一番くじモンスターストライクｖｏｌ．６,276250,0.6265877336236617
0,4315,19,一番くじモンスターストライクｖｏｌ．６,280565,0.6363749773180911
0,4282,20,一番くじモンスターストライクｖｏｌ．６,284847,0.6460873707131192
0,4825,21,一番くじモンスターストライクｖｏｌ．６,289672,0.6570313917619307
0,6313,22,一番くじモンスターストライクｖｏｌ．６,295985,0.6713504808564689
0,5245,23,一番くじモンスターストライクｖｏｌ．６,301230,0.6832471420794775
0,3328,24,一番くじモンスターストライクｖｏｌ．６,304558,0.6907956813645436
0,3063,25,一番くじモンスターストライクｖｏｌ．６,307621,0.6977431500635094
0,3081,26,一番くじモンスターストライクｖｏｌ．６,310702,0.704731446198512
0,2737,27,一番くじモンスターストライクｖｏｌ．６,313439,0.7109394846670296
0,3194,28,一番くじモンスターストライクｖｏｌ．６,316633,0.7181840863727091
0,4122,29,一番くじモンスターストライクｖｏｌ．６,320755,0.727533569225186
0,3725,30,一番くじモンスターストライクｖｏｌ．６,324480,0.7359825802939576
0,3287,31,一番くじモンスターストライクｖｏｌ．６,327767,0.743438123752495
0,1889,32,一番くじモンスターストライクｖｏｌ．６,329656,0.7477227363454908
0,2781,33,一番くじモンスターストライクｖｏｌ．６,332437,0.7540305752132099
0,2614,34,一番くじモンスターストライクｖｏｌ．６,335051,0.7599596262021412
0,2303,35,一番くじモンスターストライクｖｏｌ．６,337354,0.7651832698239884
0,2989,36,一番くじモンスターストライクｖｏｌ．６,340343,0.7719628923970241
0,2811,37,一番くじモンスターストライクｖｏｌ．６,343154,0.7783387769914716
0,1801,38,一番くじモンスターストライクｖｏｌ．６,344955,0.7824237887860642
0,2077,39,一番くじモンスターストライクｖｏｌ．６,347032,0.7871348212665578
0,1846,40,一番くじモンスターストライクｖｏｌ．６,348878,0.7913219016512429
0,1707,41,一番くじモンスターストライクｖｏｌ．６,350585,0.7951937035020867
0,1668,42,一番くじモンスターストライクｖｏｌ．６,352253,0.7989770459081836
0,2426,43,一番くじモンスターストライクｖｏｌ．６,354679,0.8044796770096171
0,2095,44,一番くじモンスターストライクｖｏｌ．６,356774,0.8092315369261477
0,1083,45,一番くじモンスターストライクｖｏｌ．６,357857,0.8116879876610416
0,1084,46,一番くじモンスターストライクｖｏｌ．６,358941,0.8141467065868263
0,1148,47,一番くじモンスターストライクｖｏｌ．６,360089,0.8167505897296317
0,1250,48,一番くじモンスターストライクｖｏｌ．６,361339,0.8195858283433134
0,1442,49,一番くじモンスターストライクｖｏｌ．６,362781,0.8228565596080566
0,1765,50,一番くじモンスターストライクｖｏｌ．６,364546,0.8268599165305752
0,1526,51,一番くじモンスターストライクｖｏｌ．６,366072,0.8303211758301579
0,918,52,一番くじモンスターストライクｖｏｌ．６,366990,0.8324033750680457
0,883,53,一番くじモンスターストライクｖｏｌ．６,367873,0.8344061876247505
0,1057,54,一番くじモンスターストライクｖｏｌ．６,368930,0.8368036653964798
0,787,55,一番くじモンスターストライクｖｏｌ．６,369717,0.8385887316276538
0,1148,56,一番くじモンスターストライクｖｏｌ．６,370865,0.841192614770459
0,1233,57,一番くじモンスターストライクｖｏｌ．６,372098,0.8439892941389947
0,1157,58,一番くじモンスターストライクｖｏｌ．６,373255,0.8466135909998186
0,598,59,一番くじモンスターストライクｖｏｌ．６,373853,0.8479699691526039
60,5486,0,一番くじラブライブサンシャイン４ｔｈ,5486,0.007800768985757838
352264,103853,1,一番くじラブライブサンシャイン４ｔｈ,109339,0.1554736201483369
350820,122890,2,一番くじラブライブサンシャイン４ｔｈ,232229,0.3302159644173454
0,71882,3,一番くじラブライブサンシャイン４ｔｈ,304111,0.43242793602402513
0,49363,4,一番くじラブライブサンシャイン４ｔｈ,353474,0.5026192155435227
60,38739,5,一番くじラブライブサンシャイン４ｔｈ,392213,0.5577037926013559
0,37809,6,一番くじラブライブサンシャイン４ｔｈ,430022,0.6114659644173454
0,27977,7,一番くじラブライブサンシャイン４ｔｈ,457999,0.6512476111389179
0,24040,8,一番くじラブライブサンシャイン４ｔｈ,482039,0.6854310756700187
0,20403,9,一番くじラブライブサンシャイン４ｔｈ,502442,0.7144429403467262
0,16392,10,一番くじラブライブサンシャイン４ｔｈ,518834,0.7377513991900624
0,13979,11,一番くじラブライブサンシャイン４ｔｈ,532813,0.7576287141102062
0,12046,12,一番くじラブライブサンシャイン４ｔｈ,544859,0.7747574168448833
0,8623,13,一番くじラブライブサンシャイン４ｔｈ,553482,0.7870188151249033
0,8522,14,一番くじラブライブサンシャイン４ｔｈ,562004,0.7991365973517769
0,7287,15,一番くじラブライブサンシャイン４ｔｈ,569291,0.8094982822951268
0,6448,16,一番くじラブライブサンシャイン４ｔｈ,575739,0.8186669586385767
0,5749,17,一番くじラブライブサンシャイン４ｔｈ,581488,0.8268416981389635
0,6291,18,一番くじラブライブサンシャイン４ｔｈ,587779,0.8357871297265322
0,5745,19,一番くじラブライブサンシャイン４ｔｈ,593524,0.843956181462438
0,4560,20,一番くじラブライブサンシャイン４ｔｈ,598084,0.8504402329708332
0,3874,21,一番くじラブライブサンシャイン４ｔｈ,601958,0.8559488328707285
0,3157,22,一番くじラブライブサンシャイン４ｔｈ,605115,0.8604379009873959
0,3106,23,一番くじラブライブサンシャイン４ｔｈ,608221,0.86485445010693
60,3362,24,一番くじラブライブサンシャイン４ｔｈ,611583,0.8696350161532511
0,4000,25,一番くじラブライブサンシャイン４ｔｈ,615583,0.8753227806342995
0,3844,26,一番くじラブライブサンシャイン４ｔｈ,619427,0.880788722300587
0,1882,27,一番くじラブライブサンシャイン４ｔｈ,621309,0.8834648154889202
0,1823,28,一番くじラブライブサンシャイン４ｔｈ,623132,0.886057014151158
0,1738,29,一番くじラブライブサンシャイン４ｔｈ,624870,0.8885283478181736
0,2784,30,一番くじラブライブサンシャイン４ｔｈ,627654,0.8924870318969832
0,2363,31,一番くじラブライブサンシャイン４ｔｈ,630017,0.8958470787641626
0,2416,32,一番くじラブライブサンシャイン４ｔｈ,632433,0.8992824885107158
0,2223,33,一番くじラブライブサンシャイン４ｔｈ,634656,0.9024434636210584
0,1590,34,一番くじラブライブサンシャイン４ｔｈ,636246,0.9047043500022751
0,1598,35,一番くじラブライブサンシャイン４ｔｈ,637844,0.9069766119124539
0,1487,36,一番くじラブライブサンシャイン４ｔｈ,639331,0.9090910383582836
0,1555,37,一番くじラブライブサンシャイン４ｔｈ,640886,0.9113021568002913
0,1426,38,一番くじラブライブサンシャイン４ｔｈ,642312,0.913329844837785
0,1689,39,一番くじラブライブサンシャイン４ｔｈ,644001,0.9157315033899076
0,1399,40,一番くじラブライブサンシャイン４ｔｈ,645400,0.9177207990171543
0,963,41,一番くじラブライブサンシャイン４ｔｈ,646363,0.9190901283159667
0,1034,42,一番くじラブライブサンシャイン４ｔｈ,647397,0.9205604154343177
0,948,43,一番くじラブライブサンシャイン４ｔｈ,648345,0.9219084156163262
0,784,44,一番くじラブライブサンシャイン４ｔｈ,649129,0.9230232174546117
0,901,45,一番くじラブライブサンシャイン４ｔｈ,650030,0.9243043864039678
0,1041,46,一番くじラブライブサンシャイン４ｔｈ,651071,0.9257846271101606
0,958,47,一番くじラブライブサンシャイン４ｔｈ,652029,0.9271468467033717
0,816,48,一番くじラブライブサンシャイン４ｔｈ,652845,0.9283071506575056
0,617,49,一番くじラブライブサンシャイン４ｔｈ,653462,0.9291844883287073
0,728,50,一番くじラブライブサンシャイン４ｔｈ,654190,0.930219661464258
0,583,51,一番くじラブライブサンシャイン４ｔｈ,654773,0.9310486531373708
0,795,52,一番くじラブライブサンシャイン４ｔｈ,655568,0.9321790963279792
0,850,53,一番くじラブライブサンシャイン４ｔｈ,656418,0.933387746280202
0,839,54,一番くじラブライブサンシャイン４ｔｈ,657257,0.934580754880102
0,688,55,一番くじラブライブサンシャイン４ｔｈ,657945,0.9355590503708422
0,665,56,一番くじラブライブサンシャイン４ｔｈ,658610,0.9365046412158166
0,469,57,一番くじラブライブサンシャイン４ｔｈ,659079,0.9371715316012195
0,587,58,一番くじラブライブサンシャイン４ｔｈ,659666,0.9380062110388133
0,665,59,一番くじラブライブサンシャイン４ｔｈ,660331,0.9389518018837876
40,95,0,一番くじおそ松さんけも松さん☆パレード！,95,0.0001825375018493931
680,6375,1,一番くじおそ松さんけも松さん☆パレード！,6470,0.012431764599637615
263561,50118,2,一番くじおそ松さんけも松さん☆パレード！,56588,0.10873086478582587
255920,61982,3,一番くじおそ松さんけも松さん☆パレード！,118570,0.2278260167819215
160,39783,4,一番くじおそ松さんけも松さん☆パレード！,158353,0.3042669582142837
40,32123,5,一番くじおそ松さんけも松さん☆パレード！,190476,0.36598961265542107
0,23743,6,一番くじおそ松さんけも松さん☆パレード！,214219,0.4116105379860541
0,19566,7,一番くじおそ松さんけも松さん☆パレード！,233785,0.4492055775774776
0,17789,8,一番くじおそ松さんけも松さん☆パレード！,251574,0.4833862051606234
0,15393,9,一番くじおそ松さんけも松さん☆パレード！,266967,0.5129630448023887
0,16205,10,一番くじおそ松さんけも松さん☆パレード！,283172,0.5441000997231195
0,18281,11,一番くじおそ松さんけも松さん☆パレード！,301453,0.5792260794211064
0,14375,12,一番くじおそ松さんけも松さん☆パレード！,315828,0.6068468856220013
0,10101,13,一番くじおそ松さんけも松さん☆パレード！,325929,0.6262554256870615
0,7935,14,一番くじおそ松さんけも松さん☆パレード！,333864,0.6415021107099556
0,8683,15,一番くじおそ松さんけも松さん☆パレード！,342547,0.6581860383789901
0,7502,16,一番くじおそ松さんけも松さん☆パレード！,350049,0.6726007366829285
0,7159,17,一番くじおそ松さんけも松さん☆パレード！,357208,0.6863563785328212
0,8344,18,一番くじおそ松さんけも松さん☆パレード！,365552,0.7023889355373616
40,7178,19,一番くじおそ松さんけも松さん☆パレード！,372730,0.7161810848876241
0,4903,20,一番くじおそ松さんけも松さん☆パレード！,377633,0.7256019414304408
0,4844,21,一番くじおそ松さんけも松さん☆パレード！,382477,0.7349094325773718
0,4056,22,一番くじおそ松さんけも松さん☆パレード！,386533,0.742702823182647
0,4961,23,一番くじおそ松さんけも松さん☆パレード！,391494,0.7522351236739612
0,4876,24,一番くじおそ松さんけも松さん☆パレード！,396370,0.7616041011373047
0,5484,25,一番くじおそ松さんけも松さん☆パレード！,401854,0.7721413186124844
0,4345,26,一番くじおそ松さんけも松さん☆パレード！,406199,0.7804900075128592
0,3197,27,一番くじおそ松さんけも松さん☆パレード！,409396,0.7866328748119383
0,2841,28,一番くじおそ松さんけも松さん☆パレード！,412237,0.7920917068409291
0,2641,29,一番くじおそ松さんけも松さん☆パレード！,414878,0.7971662493923423
0,2886,30,一番くじおそ松さんけも松さん☆パレード！,417764,0.8027115465537881
0,2915,31,一番くじおそ松さんけも松さん☆パレード！,420679,0.8083125656894826
0,3512,32,一番くじおそ松さんけも松さん☆パレード！,424191,0.8150606889157465
0,3258,33,一番くじおそ松さんけも松さん☆パレード！,427449,0.8213207645054867
0,1987,34,一番くじおそ松さんけも松さん☆パレード！,429436,0.8251386804652209
0,1819,35,一番くじおそ松さんけも松さん☆パレード！,431255,0.8286337932637897
0,2138,36,一番くじおそ松さんけも松さん☆パレード！,433393,0.832741847779095
0,1831,37,一番くじおそ松さんけも松さん☆パレード！,435224,0.8362600179463187
0,1783,38,一番くじおそ松さんけも松さん☆パレード！,437007,0.8396859586389235
0,2367,39,一番くじおそ松さんけも松さん☆パレード！,439374,0.8442340246060552
0,2071,40,一番くじおそ松さんけも松さん☆パレード！,441445,0.848213342146372
0,1686,41,一番くじおそ松さんけも松さん☆パレード！,443131,0.8514529024423517
0,1371,42,一番くじおそ松さんけも松さん☆パレード！,444502,0.8540872068111467
0,1255,43,一番くじおそ松さんけも松さん☆パレード！,445757,0.8564986232829466
0,1304,44,一番くじおそ松さんけも松さん☆パレード！,447061,0.8590041906767529
0,1517,45,一番くじおそ松さんけも松さん☆パレード！,448578,0.8619190263641796
0,1765,46,一番くじおそ松さんけも松さん☆パレード！,450343,0.8653103810038025
0,1407,47,一番くじおそ松さんけも松さん☆パレード！,451750,0.8680138574785614
0,994,48,一番くじおそ松さんけも松さん☆パレード！,452744,0.8699237761821225
0,976,49,一番くじおそ松さんけも松さん☆パレード！,453720,0.8717991088327015
0,1328,50,一番くじおそ松さんけも松さん☆パレード！,455048,0.8743507909638172
0,857,51,一番くじおそ松さんけも松さん☆パレード！,455905,0.8759974713752375
0,917,52,一番くじおそ松さんけも松さん☆パレード！,456822,0.8777594386299311
0,1192,53,一番くじおそ松さんけも松さん☆パレード！,458014,0.8800498039162941
0,1025,54,一番くじおそ松さんけも松さん☆パレード！,459039,0.8820192874888796
0,899,55,一番くじおそ松さんけも松さん☆パレード！,459938,0.8837466686905913
0,1025,56,一番くじおそ松さんけも松さん☆パレード！,460963,0.8857161522631768
0,912,57,一番くじおそ松さんけも松さん☆パレード！,461875,0.8874685122809309
0,987,58,一番くじおそ松さんけも松さん☆パレード！,462862,0.8893649808527768
0,803,59,一番くじおそ松さんけも松さん☆パレード！,463665,0.8909079031052511
0,1304,0,一番くじぷちアイカツ！２,1304,0.0019856860057865084
330600,20928,1,一番くじぷちアイカツ！２,22232,0.03385411908024973
325950,45770,2,一番くじぷちアイカツ！２,68002,0.10355108877721943
150,39017,3,一番くじぷちアイカツ！２,107019,0.162964824120603
0,26541,4,一番くじぷちアイカツ！２,133560,0.20338053905893103
0,20218,5,一番くじぷちアイカツ！２,153778,0.23416780874067306
0,20873,6,一番くじぷちアイカツ！２,174651,0.26595248972133395
0,18258,7,一番くじぷちアイカツ！２,192909,0.29375513933302877
0,18317,8,一番くじぷちアイカツ！２,211226,0.3216476320998934
0,28414,9,一番くじぷちアイカツ！２,239640,0.36491548652352673
0,24468,10,一番くじぷちアイカツ！２,264108,0.40217450890817724
0,12114,11,一番くじぷちアイカツ！２,276222,0.4206212882594792
0,10776,12,一番くじぷちアイカツ！２,286998,0.4370306075833714
0,9518,13,一番くじぷちアイカツ！２,296516,0.4515242881072027
0,9854,14,一番くじぷちアイカツ！２,306370,0.4665296177858992
0,12374,15,一番くじぷちアイカツ！２,318744,0.48537231612608495
0,19560,16,一番くじぷちアイカツ！２,338304,0.5151576062128826
0,17308,17,一番くじぷちアイカツ！２,355612,0.5415136287498097
0,8366,18,一番くじぷちアイカツ！２,363978,0.5542530835998173
0,7269,19,一番くじぷちアイカツ！２,371247,0.5653220648698035
0,7395,20,一番くじぷちアイカツ！２,378642,0.5765829145728644
0,6655,21,一番くじぷちアイカツ！２,385297,0.5867169179229481
0,7720,22,一番くじぷちアイカツ！２,393017,0.5984726663621136
0,10447,23,一番くじぷちアイカツ！２,403464,0.6143809958885336
0,10959,24,一番くじぷちアイカツ！２,414423,0.6310689812699863
0,8932,25,一番くじぷちアイカツ！２,423355,0.6446703213034871
0,4731,26,一番くじぷちアイカツ！２,428086,0.6518745241358307
0,4482,27,一番くじぷちアイカツ！２,432568,0.6586995583980508
0,4224,28,一番くじぷちアイカツ！２,436792,0.6651317192020709
0,4807,29,一番くじぷちアイカツ！２,441599,0.6724516522003959
0,7622,30,一番くじぷちアイカツ！２,449221,0.684058169636059
0,6684,31,一番くじぷちアイカツ！２,455905,0.6942363331810568
0,3883,32,一番くじぷちアイカツ！２,459788,0.7001492310035023
0,3216,33,一番くじぷちアイカツ！２,463004,0.7050464443429267
0,3437,34,一番くじぷちアイカツ！２,466441,0.7102801888229023
0,3410,35,一番くじぷちアイカツ！２,469851,0.7154728186386478
0,3738,36,一番くじぷちアイカツ！２,473589,0.7211649154865235
0,4907,37,一番くじぷちアイカツ！２,478496,0.7286371250190345
0,4282,38,一番くじぷちアイカツ！２,482778,0.7351576062128826
0,2410,39,一番くじぷちアイカツ！２,485188,0.7388274706867671
0,2117,40,一番くじぷちアイカツ！２,487305,0.7420511649154865
0,2036,41,一番くじぷちアイカツ！２,489341,0.7451515151515151
0,1750,42,一番くじぷちアイカツ！２,491091,0.7478163544997716
0,2263,43,一番くじぷちアイカツ！２,493354,0.7512623724684027
0,3783,44,一番くじぷちアイカツ！２,497137,0.757022993756662
0,4095,45,一番くじぷちアイカツ！２,501232,0.7632587178315822
0,3169,46,一番くじぷちアイカツ！２,504401,0.7680843611999391
0,1871,47,一番くじぷちアイカツ！２,506272,0.7709334551545607
0,1785,48,一番くじぷちアイカツ！２,508057,0.7736515912897822
0,1931,49,一番くじぷちアイカツ！２,509988,0.7765920511649155
0,2070,50,一番くじぷちアイカツ！２,512058,0.7797441754225674
0,3081,51,一番くじぷちアイカツ！２,515139,0.7844358154408405
0,3107,52,一番くじぷちアイカツ！２,518246,0.7891670473580021
0,1629,53,一番くじぷちアイカツ！２,519875,0.7916476320998934
0,1554,54,一番くじぷちアイカツ！２,521429,0.7940140094411451
0,1420,55,一番くじぷちアイカツ！２,522849,0.7961763362265875
0,1154,56,一番くじぷちアイカツ！２,524003,0.7979336074310949
0,1505,57,一番くじぷちアイカツ！２,525508,0.8002253692705954
0,2316,58,一番くじぷちアイカツ！２,527824,0.803752093802345
0,2042,59,一番くじぷちアイカツ！２,529866,0.8068615806304249
0,1827,0,一番くじスティッチハロウィンＶＥＲ．,1827,0.0020756646216768915
444300,20760,1,一番くじスティッチハロウィンＶＥＲ．,22587,0.025661213360599865
435800,57417,2,一番くじスティッチハロウィンＶＥＲ．,80004,0.09089297886843899
100,71899,3,一番くじスティッチハロウィンＶＥＲ．,151903,0.172577823221995
0,66390,4,一番くじスティッチハロウィンＶＥＲ．,218293,0.24800386275846398
0,47670,5,一番くじスティッチハロウィンＶＥＲ．,265963,0.3021620086344013
0,42111,6,一番くじスティッチハロウィンＶＥＲ．,308074,0.35000454442172235
0,41385,7,一番くじスティッチハロウィンＶＥＲ．,349459,0.39702226766643944
0,39086,8,一番くじスティッチハロウィンＶＥＲ．,388545,0.44142808452624405
0,34992,9,一番くじスティッチハロウィンＶＥＲ．,423537,0.4811826857532379
0,44587,10,一番くじスティッチハロウィンＶＥＲ．,468124,0.5318382185866849
0,38622,11,一番くじスティッチハロウィンＶＥＲ．,506746,0.5757168825266985
0,24557,12,一番くじスティッチハロウィンＶＥＲ．,531303,0.6036162235855488
0,21625,13,一番くじスティッチハロウィンＶＥＲ．,552928,0.6281845035219268
0,18976,14,一番くじスティッチハロウィンＶＥＲ．,571904,0.649743240172688
0,19225,15,一番くじスティッチハロウィンＶＥＲ．,591129,0.6715848670756647
0,20070,16,一番くじスティッチハロウィンＶＥＲ．,611199,0.6943865030674846
0,24204,17,一番くじスティッチハロウィンＶＥＲ．,635403,0.7218847989093388
0,21464,18,一番くじスティッチハロウィンＶＥＲ．,656867,0.7462701658713928
0,17007,19,一番くじスティッチハロウィンＶＥＲ．,673874,0.7655919109293342
0,11160,20,一番くじスティッチハロウィンＶＥＲ．,685034,0.7782708475346513
0,10174,21,一番くじスティッチハロウィンＶＥＲ．,695208,0.7898295841854124
0,10655,22,一番くじスティッチハロウィンＶＥＲ．,705863,0.8019347875482845
0,10434,23,一番くじスティッチハロウィンＶＥＲ．,716297,0.8137889116109975
0,12376,24,一番くじスティッチハロウィンＶＥＲ．,728673,0.8278493524199045
0,10859,25,一番くじスティッチハロウィンＶＥＲ．,739532,0.8401863212906158
0,6272,26,一番くじスティッチハロウィンＶＥＲ．,745804,0.8473119745512383
0,5833,27,一番くじスティッチハロウィンＶＥＲ．,751637,0.8539388775278346
0,5643,28,一番くじスティッチハロウィンＶＥＲ．,757280,0.8603499204726198
0,5293,29,一番くじスティッチハロウィンＶＥＲ．,762573,0.8663633265167008
0,6020,30,一番くじスティッチハロウィンＶＥＲ．,768593,0.8732026812088162
0,7072,31,一番くじスティッチハロウィンＶＥＲ．,775665,0.8812372188139059
0,6194,32,一番くじスティッチハロウィンＶＥＲ．,781859,0.888274255850943
0,3483,33,一番くじスティッチハロウィンＶＥＲ．,785342,0.8922313110656669
0,3669,34,一番くじスティッチハロウィンＶＥＲ．,789011,0.8963996818904795
0,3528,35,一番くじスティッチハロウィンＶＥＲ．,792539,0.9004078618495797
0,3420,36,一番くじスティッチハロウィンＶＥＲ．,795959,0.9042933424221767
0,3751,37,一番くじスティッチハロウィンＶＥＲ．,799710,0.9085548738922972
0,5310,38,一番くじスティッチハロウィンＶＥＲ．,805020,0.914587593728698
0,3824,39,一番くじスティッチハロウィンＶＥＲ．,808844,0.918932060895251
0,2555,40,一番くじスティッチハロウィンＶＥＲ．,811399,0.921834810270393
0,2755,41,一番くじスティッチハロウィンＶＥＲ．,814154,0.9249647807316519
0,2002,42,一番くじスティッチハロウィンＶＥＲ．,816156,0.9272392638036809
0,1757,43,一番くじスティッチハロウィンＶＥＲ．,817913,0.929235401045217
0,1441,44,一番くじスティッチハロウィンＶＥＲ．,819354,0.9308725289706885
0,1294,45,一番くじスティッチハロウィンＶＥＲ．,820648,0.9323426493978642
0,1072,46,一番くじスティッチハロウィンＶＥＲ．,821720,0.9335605544194501
0,731,47,一番くじスティッチハロウィンＶＥＲ．,822451,0.934391047489207
0,728,48,一番くじスティッチハロウィンＶＥＲ．,823179,0.9352181322426721
0,688,49,一番くじスティッチハロウィンＶＥＲ．,823867,0.9359997727789139
0,646,50,一番くじスティッチハロウィンＶＥＲ．,824513,0.9367336968870711
0,769,51,一番くじスティッチハロウィンＶＥＲ．,825282,0.9376073619631902
0,852,52,一番くじスティッチハロウィンＶＥＲ．,826134,0.9385753237900477
0,818,53,一番くじスティッチハロウィンＶＥＲ．,826952,0.9395046580322653
0,506,54,一番くじスティッチハロウィンＶＥＲ．,827458,0.9400795273801409
0,473,55,一番くじスティッチハロウィンＶＥＲ．,827931,0.9406169052488071
0,546,56,一番くじスティッチハロウィンＶＥＲ．,828477,0.941237218813906
0,510,57,一番くじスティッチハロウィンＶＥＲ．,828987,0.9418166325835038
0,451,58,一番くじスティッチハロウィンＶＥＲ．,829438,0.9423290161326972
0,525,59,一番くじスティッチハロウィンＶＥＲ．,829963,0.9429254714837537
0,1455,0,一番くじ映画妖怪ウォッチエンマ大王,1455,0.002156987155919781
336502,20653,1,一番くじ映画妖怪ウォッチエンマ大王,22108,0.032774345046786606
337950,58099,2,一番くじ映画妖怪ウォッチエンマ大王,80207,0.11890410227825282
100,52699,3,一番くじ映画妖怪ウォッチエンマ大王,132906,0.1970285463537281
0,35048,4,一番くじ映画妖怪ウォッチエンマ大王,167954,0.24898599366690782
0,35609,5,一番くじ映画妖怪ウォッチエンマ大王,203563,0.30177510406907104
0,37385,6,一番くじ映画妖怪ウォッチエンマ大王,240948,0.3571970730203157
0,31649,7,一番くじ映画妖怪ウォッチエンマ大王,272597,0.4041156204414189
0,34468,8,一番くじ映画妖怪ウォッチエンマ大王,307065,0.4552132378230292
0,31343,9,一番くじ映画妖怪ウォッチエンマ大王,338408,0.5016781508319595
0,27294,10,一番くじ映画妖怪ウォッチエンマ大王,365702,0.542140561439296
0,22434,11,一番くじ映画妖怪ウォッチエンマ大王,388136,0.5753981902062406
0,22518,12,一番くじ映画妖怪ウォッチエンマ大王,410654,0.6087803460667228
0,22925,13,一番くじ映画妖怪ウォッチエンマ大王,433579,0.6427658653447028
0,21288,14,一番くじ映画妖怪ウォッチエンマ大王,454867,0.6743245887640983
0,28090,15,一番くじ映画妖怪ウォッチエンマ大王,482957,0.7159670418292438
0,21522,16,一番くじ映画妖怪ウォッチエンマ大王,504479,0.7478726621520654
0,16504,17,一番くじ映画妖怪ウォッチエンマ大王,520983,0.7723392711014125
0,11739,18,一番くじ映画妖怪ウォッチエンマ大王,532722,0.7897419324232973
0,9264,19,一番くじ映画妖怪ウォッチエンマ大王,541986,0.8034754918820195
0,7818,20,一番くじ映画妖怪ウォッチエンマ大王,549804,0.8150654063734153
0,6446,21,一番くじ映画妖怪ウォッチエンマ大王,556250,0.8246213783370296
0,6060,22,一番くじ映画妖怪ウォッチエンマ大王,562310,0.8336051186565305
0,7485,23,一番くじ映画妖怪ウォッチエンマ大王,569795,0.8447013721699735
0,7376,24,一番くじ映画妖怪ウォッチエンマ大王,577171,0.8556360369548974
0,5560,25,一番くじ映画妖怪ウォッチエンマ大王,582731,0.8638785445747696
0,3371,26,一番くじ映画妖怪ウォッチエンマ大王,586102,0.8688759354356669
0,3134,27,一番くじ映画妖怪ウォッチエンマ大王,589236,0.8735219819969402
0,3083,28,一番くじ映画妖怪ウォッチエンマ大王,592319,0.8780924228228513
0,2947,29,一番くじ映画妖怪ウォッチエンマ大王,595266,0.8824612483544634
0,4298,30,一番くじ映画妖怪ウォッチエンマ大王,599564,0.8888328846404725
0,3394,31,一番くじ映画妖怪ウォッチエンマ大王,602958,0.8938643722055527
0,1783,32,一番くじ映画妖怪ウォッチエンマ大王,604741,0.896507608012429
0,1703,33,一番くじ映画妖怪ウォッチエンマ大王,606444,0.8990322465873647
0,1731,34,一番くじ映画妖怪ウォッチエンマ大王,608175,0.9015983941934795
0,1585,35,一番くじ映画妖怪ウォッチエンマ大王,609760,0.9039481018513028
0,1766,36,一番くじ映画妖怪ウォッチエンマ大王,611526,0.9065661357463917
0,2447,37,一番くじ映画妖怪ウォッチエンマ大王,613973,0.910193728578375
0,2109,38,一番くじ映画妖怪ウォッチエンマ大王,616082,0.9133202481054092
0,1516,39,一番くじ映画妖怪ウォッチエンマ大王,617598,0.9155676656506837
0,1357,40,一番くじ映画妖怪ウォッチエンマ大王,618955,0.9175793711974762
0,1361,41,一番くじ映画妖怪ウォッチエンマ大王,620316,0.9195970066058659
0,1222,42,一番くじ映画妖怪ウォッチエンマ大王,621538,0.9214085793237586
0,1214,43,一番くじ映画妖怪ウォッチエンマ大王,622752,0.9232082923184572
0,1777,44,一番くじ映画妖怪ウォッチエンマ大王,624529,0.925842633332938
0,1692,45,一番くじ映画妖怪ウォッチエンマ大王,626221,0.9283509647884819
0,977,46,一番くじ映画妖怪ウォッチエンマ大王,627198,0.9297993334835565
0,890,47,一番くじ映画妖怪ウォッチエンマ大王,628088,0.9311187276888957
0,820,48,一番くじ映画妖怪ウォッチエンマ大王,628908,0.932334349316287
0,728,49,一番くじ映画妖怪ウォッチエンマ大王,629636,0.9334135841269465
0,814,50,一番くじ映画妖怪ウォッチエンマ大王,630450,0.9346203109619422
0,999,51,一番くじ映画妖怪ウォッチエンマ大王,631449,0.9361012938958004
0,880,52,一番くじ映画妖怪ウォッチエンマ大王,632329,0.9374058634471472
0,620,53,一番くじ映画妖怪ウォッチエンマ大王,632949,0.9383249919946869
0,480,54,一番くじ映画妖怪ウォッチエンマ大王,633429,0.9390365753863305
0,576,55,一番くじ映画妖怪ウォッチエンマ大王,634005,0.9398904754563029
0,786,56,一番くじ映画妖怪ウォッチエンマ大王,634791,0.9410556932601193
0,478,57,一番くじ映画妖怪ウォッチエンマ大王,635269,0.9417643117209644
0,637,58,一番くじ映画妖怪ウォッチエンマ大王,635906,0.9427086421802915
0,634,59,一番くじ映画妖怪ウォッチエンマ大王,636540,0.9436485252434208
0,5525,0,一番くじアイドリッシュセブンワンダーランド,5525,0.019541612138789657
132300,82205,1,一番くじアイドリッシュセブンワンダーランド,87730,0.310296042160365
150290,66255,2,一番くじアイドリッシュセブンワンダーランド,153985,0.5446362253740318
0,25392,3,一番くじアイドリッシュセブンワンダーランド,179377,0.6344462915148729
70,15624,4,一番くじアイドリッシュセブンワンダーランド,195001,0.6897074947830085
0,10347,5,一番くじアイドリッシュセブンワンダーランド,205348,0.7263042478689916
0,5608,6,一番くじアイドリッシュセブンワンダーランド,210956,0.7461394263077848
0,4277,7,一番くじアイドリッシュセブンワンダーランド,215233,0.7612669331164008
70,4129,8,一番くじアイドリッシュセブンワンダーランド,219362,0.7758709723057334
0,3143,9,一番くじアイドリッシュセブンワンダーランド,222505,0.7869875853287589
0,2444,10,一番くじアイドリッシュセブンワンダーランド,224949,0.7956318749336823
0,2724,11,一番くじアイドリッシュセブンワンダーランド,227673,0.8052665086831959
0,2172,12,一番くじアイドリッシュセブンワンダーランド,229845,0.8129487496905174
0,1373,13,一番くじアイドリッシュセブンワンダーランド,231218,0.8178049729423832
0,1242,14,一番くじアイドリッシュセブンワンダーランド,232460,0.8221978566123156
0,1220,15,一番くじアイドリッシュセブンワンダーランド,233680,0.8265129275280303
0,1262,16,一番くじアイドリッシュセブンワンダーランド,234942,0.8309765500654335
0,1137,17,一番くじアイドリッシュセブンワンダーランド,236079,0.8349980546811445
0,1408,18,一番くじアイドリッシュセブンワンダーランド,237487,0.8399780709510841
0,1025,19,一番くじアイドリッシュセブンワンダーランド,238512,0.8436034379089591
0,1195,20,一番くじアイドリッシュセブンワンダーランド,239707,0.8478300852403353
0,770,21,一番くじアイドリッシュセブンワンダーランド,240477,0.8505535316379584
0,636,22,一番くじアイドリッシュセブンワンダーランド,241113,0.8528030276235278
0,613,23,一番くじアイドリッシュセブンワンダーランド,241726,0.8549711739115057
0,709,24,一番くじアイドリッシュセブンワンダーランド,242435,0.8574788667633432
0,996,25,一番くじアイドリッシュセブンワンダーランド,243431,0.8610016623633856
0,750,26,一番くじアイドリッシュセブンワンダーランド,244181,0.863654369893538
0,468,27,一番くじアイドリッシュセブンワンダーランド,244649,0.8653096593923532
0,550,28,一番くじアイドリッシュセブンワンダーランド,245199,0.8672549782477983
0,436,29,一番くじアイドリッシュセブンワンダーランド,245635,0.8687970855586602
0,669,30,一番くじアイドリッシュセブンワンダーランド,246304,0.8711633006755561
0,650,31,一番くじアイドリッシュセブンワンダーランド,246954,0.8734623138683549
0,729,32,一番くじアイドリッシュセブンワンダーランド,247683,0.8760407455876631
0,602,33,一番くじアイドリッシュセブンワンダーランド,248285,0.8781699854985322
0,595,34,一番くじアイドリッシュセブンワンダーランド,248880,0.8802744668057865
0,5477,35,一番くじアイドリッシュセブンワンダーランド,254357,0.8996463056626464
0,4664,36,一番くじアイドリッシュセブンワンダーランド,259021,0.916142609556821
0,356,37,一番くじアイドリッシュセブンワンダーランド,259377,0.9174017613978
0,558,38,一番くじアイドリッシュセブンワンダーランド,259935,0.9193753758002334
0,398,39,一番くじアイドリッシュセブンワンダーランド,260333,0.920783079262901
0,370,40,一番くじアイドリッシュセブンワンダーランド,260703,0.9220917483111095
0,321,41,一番くじアイドリッシュセブンワンダーランド,261024,0.9232271071340148
0,294,42,一番くじアイドリッシュセブンワンダーランド,261318,0.9242669684858346
0,257,43,一番くじアイドリッシュセブンワンダーランド,261575,0.9251759629328334
0,195,44,一番くじアイドリッシュセブンワンダーランド,261770,0.9258656668906731
0,318,45,一番くじアイドリッシュセブンワンダーランド,262088,0.9269904148834577
0,295,46,一番くじアイドリッシュセブンワンダーランド,262383,0.928033813178651
0,297,47,一番くじアイドリッシュセブンワンダーランド,262680,0.9290842853605914
0,213,48,一番くじアイドリッシュセブンワンダーランド,262893,0.9298376542991547
0,143,49,一番くじアイドリッシュセブンワンダーランド,263036,0.9303434372015704
0,210,50,一番くじアイドリッシュセブンワンダーランド,263246,0.9310861953100131
0,281,51,一番くじアイドリッシュセブンワンダーランド,263527,0.9320800763979769
0,266,52,一番くじアイドリッシュセブンワンダーランド,263793,0.9330209033353376
0,345,53,一番くじアイドリッシュセブンワンダーランド,264138,0.9342411487992077
0,262,54,一番くじアイドリッシュセブンワンダーランド,264400,0.9351678279630743
0,178,55,一番くじアイドリッシュセブンワンダーランド,264578,0.9357974038835638
0,102,56,一番くじアイドリッシュセブンワンダーランド,264680,0.9361581721076646
0,106,57,一番くじアイドリッシュセブンワンダーランド,264786,0.9365330881052595
0,147,58,一番くじアイドリッシュセブンワンダーランド,264933,0.9370530187811693
0,193,59,一番くじアイドリッシュセブンワンダーランド,265126,0.9377356488522619
9300,0,0,一番くじおそ松さんメガネ男子※,0,0.0
130300,0,1,一番くじおそ松さんメガネ男子※,0,0.0
113250,50615,2,一番くじおそ松さんメガネ男子※,50615,0.19986179664363277
0,33199,3,一番くじおそ松さんメガネ男子※,83814,0.33095360315893385
0,21268,4,一番くじおそ松さんメガネ男子※,105082,0.41493385982230996
0,17800,5,一番くじおそ松さんメガネ男子※,122882,0.48522013820335635
150,11871,6,一番くじおそ松さんメガネ男子※,134753,0.5320947680157947
50,9137,7,一番くじおそ松さんメガネ男子※,143890,0.5681737413622903
50,6614,8,一番くじおそ松さんメガネ男子※,150504,0.5942902270483712
0,5971,9,一番くじおそ松さんメガネ男子※,156475,0.61786771964462
0,5045,10,一番くじおそ松さんメガネ男子※,161520,0.6377887462981244
0,3905,11,一番くじおそ松さんメガネ男子※,165425,0.653208292201382
50,2326,12,一番くじおそ松さんメガネ男子※,167751,0.6623928923988154
0,2751,13,一番くじおそ松さんメガネ男子※,170502,0.6732556762092794
50,2183,14,一番くじおそ松さんメガネ男子※,172685,0.6818756169792695
0,2916,15,一番くじおそ松さんメガネ男子※,175601,0.6933899308983218
0,2123,16,一番くじおそ松さんメガネ男子※,177724,0.7017729516288252
50,2075,17,一番くじおそ松さんメガネ男子※,179799,0.7099664363277394
0,1617,18,一番くじおそ松さんメガネ男子※,181416,0.7163514313919053
0,1234,19,一番くじおそ松さんメガネ男子※,182650,0.7212240868706812
0,991,20,一番くじおそ松さんメガネ男子※,183641,0.7251372161895361
0,1091,21,一番くじおそ松さんメガネ男子※,184732,0.7294452122408687
0,769,22,一番くじおそ松さんメガネ男子※,185501,0.7324817374136229
0,682,23,一番くじおそ松さんメガネ男子※,186183,0.7351747285291215
0,783,24,一番くじおそ松さんメガネ男子※,186966,0.7382665350444225
0,767,25,一番くじおそ松さんメガネ男子※,187733,0.7412951628825272
0,520,26,一番くじおそ松さんメガネ男子※,188253,0.7433484698914117
0,495,27,一番くじおそ松さんメガネ男子※,188748,0.7453030602171767
0,436,28,一番くじおそ松さんメガネ男子※,189184,0.7470246791707799
0,427,29,一番くじおそ松さんメガネ男子※,189611,0.74871076011846
0,407,30,一番くじおそ松さんメガネ男子※,190018,0.7503178677196446
0,520,31,一番くじおそ松さんメガネ男子※,190538,0.7523711747285291
0,490,32,一番くじおそ松さんメガネ男子※,191028,0.7543060217176702
0,336,33,一番くじおそ松さんメガネ男子※,191364,0.7556327739387957
0,264,34,一番くじおそ松さんメガネ男子※,191628,0.756675222112537
0,255,35,一番くじおそ松さんメガネ男子※,191883,0.7576821322803554
0,250,36,一番くじおそ松さんメガネ男子※,192133,0.7586692991115499
0,255,37,一番くじおそ松さんメガネ男子※,192388,0.7596762092793682
0,330,38,一番くじおそ松さんメガネ男子※,192718,0.7609792694965449
0,321,39,一番くじおそ松さんメガネ男子※,193039,0.7622467917077986
0,255,40,一番くじおそ松さんメガネ男子※,193294,0.763253701875617
0,168,41,一番くじおそ松さんメガネ男子※,193462,0.7639170779861797
0,222,42,一番くじおそ松さんメガネ男子※,193684,0.7647936821322804
0,177,43,一番くじおそ松さんメガネ男子※,193861,0.7654925962487661
0,241,44,一番くじおそ松さんメガネ男子※,194102,0.7664442250740375
0,214,45,一番くじおそ松さんメガネ男子※,194316,0.76728923988154
0,153,46,一番くじおそ松さんメガネ男子※,194469,0.767893385982231
0,129,47,一番くじおそ松さんメガネ男子※,194598,0.7684027640671274
0,110,48,一番くじおそ松さんメガネ男子※,194708,0.7688371174728529
0,86,49,一番くじおそ松さんメガネ男子※,194794,0.7691767028627838
0,61,50,一番くじおそ松さんメガネ男子※,194855,0.7694175715695952
0,112,51,一番くじおそ松さんメガネ男子※,194967,0.7698598223099704
0,122,52,一番くじおそ松さんメガネ男子※,195089,0.7703415597235933
0,130,53,一番くじおそ松さんメガネ男子※,195219,0.7708548864758145
0,93,54,一番くじおそ松さんメガネ男子※,195312,0.7712221125370188
0,67,55,一番くじおそ松さんメガネ男子※,195379,0.7714866732477789
0,50,56,一番くじおそ松さんメガネ男子※,195429,0.7716841066140178
0,84,57,一番くじおそ松さんメガネ男子※,195513,0.7720157946692991
0,103,58,一番くじおそ松さんメガネ男子※,195616,0.7724225074037512
0,80,59,一番くじおそ松さんメガネ男子※,195696,0.7727384007897334
0,3346,0,ポケモンコレクションくじ２０１９,3346,0.003988746632334359
411246,55133,1,ポケモンコレクションくじ２０１９,58479,0.0697124669193906
427614,102569,2,ポケモンコレクションくじ２０１９,161048,0.1919843597262952
0,97866,3,ポケモンコレクションくじ２０１９,258914,0.3086498342989295
0,98356,4,ポケモンコレクションくじ２０１９,357270,0.42589943494742866
0,75999,5,ポケモンコレクションくじ２０１９,433269,0.5164973893140691
0,49360,6,ポケモンコレクションくじ２０１９,482629,0.5753391507522113
0,42335,7,ポケモンコレクションくじ２０１９,524964,0.6258064516129033
0,37486,8,ポケモンコレクションくじ２０１９,562450,0.6704932885105978
0,30787,9,ポケモンコレクションくじ２０１９,593237,0.7071942874853968
0,30177,10,ポケモンコレクションくじ２０１９,623414,0.7431681091004458
0,28772,11,ポケモンコレクションくじ２０１９,652186,0.7774670386000048
0,23216,12,ポケモンコレクションくじ２０１９,675402,0.8051426936556756
0,17564,13,ポケモンコレクションくじ２０１９,692966,0.82608063324035
0,11324,14,ポケモンコレクションくじ２０１９,704290,0.8395799060629903
0,10102,15,ポケモンコレクションくじ２０１９,714392,0.8516224399780654
0,8170,16,ポケモンコレクションくじ２０１９,722562,0.8613618482225878
0,8296,17,ポケモンコレクションくじ２０１９,730858,0.8712514603151896
0,10071,18,ポケモンコレクションくじ２０１９,740929,0.8832570393152612
0,8466,19,ポケモンコレクションくじ２０１９,749395,0.8933493073933672
0,5463,20,ポケモンコレクションくじ２０１９,754858,0.8998617170922443
0,4730,21,ポケモンコレクションくじ２０１９,759588,0.9055003218653888
0,4727,22,ポケモンコレクションくじ２０１９,764315,0.9111353503564361
0,5097,23,ポケモンコレクションくじ２０１９,769412,0.9172114536394631
0,4653,24,ポケモンコレクションくじ２０１９,774065,0.9227582671721145
0,5064,25,ポケモンコレクションくじ２０１９,779129,0.9287950313520731
0,3988,26,ポケモンコレクションくじ２０１９,783117,0.9335491023531937
0,2648,27,ポケモンコレクションくじ２０１９,785765,0.9367057673509286
0,2284,28,ポケモンコレクションくじ２０１９,788049,0.9394285101208784
0,2276,29,ポケモンコレクションくじ２０１９,790325,0.942141716138569
0,2026,30,ポケモンコレクションくじ２０１９,792351,0.9445568986481654
0,2179,31,ポケモンコレクションくじ２０１９,794530,0.9471544715447154
0,2256,32,ポケモンコレクションくじ２０１９,796786,0.9498438356817586
0,1925,33,ポケモンコレクションくじ２０１９,798711,0.9521386166940848
0,1442,34,ポケモンコレクションくじ２０１９,800153,0.9538576162887729
0,1308,35,ポケモンコレクションくじ２０１９,801461,0.9554168752831224
0,1371,36,ポケモンコレクションくじ２０１９,802832,0.9570512362015116
0,1037,37,ポケモンコレクションくじ２０１９,803869,0.9582874377130868
0,1074,38,ポケモンコレクションくじ２０１９,804943,0.95956774670386
0,1304,39,ポケモンコレクションくじ２０１９,806247,0.96112223732208
0,1428,40,ポケモンコレクションくじ２０１９,807675,0.9628245476003147
0,1065,41,ポケモンコレクションくじ２０１９,808740,0.9640941277447965
0,1134,42,ポケモンコレクションくじ２０１９,809874,0.9654459623775123
0,965,43,ポケモンコレクションくじ２０１９,810839,0.9665963331187564
0,782,44,ポケモンコレクションくじ２０１９,811621,0.9675285506520754
0,785,45,ポケモンコレクションくじ２０１９,812406,0.9684643444674916
0,788,46,ポケモンコレクションくじ２０１９,813194,0.9694037145650048
0,644,47,ポケモンコレクションくじ２０１９,813838,0.9701714231218559
0,466,48,ポケモンコレクションくじ２０１９,814304,0.9707269389409436
0,486,49,ポケモンコレクションくじ２０１９,814790,0.971306296640679
0,522,50,ポケモンコレクションくじ２０１９,815312,0.97192856972558
0,478,51,ポケモンコレクションくじ２０１９,815790,0.9724983906730563
0,521,52,ポケモンコレクションくじ２０１９,816311,0.9731194716639249
0,579,53,ポケモンコレクションくじ２０１９,816890,0.9738096941086712
0,513,54,ポケモンコレクションくじ２０１９,817403,0.9744212383472808
0,432,55,ポケモンコレクションくじ２０１９,817835,0.9749362229692679
0,310,56,ポケモンコレクションくじ２０１９,818145,0.9753057721193048
0,283,57,ポケモンコレクションくじ２０１９,818428,0.9756431347304675
0,257,58,ポケモンコレクションくじ２０１９,818685,0.9759495028967885
0,306,59,ポケモンコレクションくじ２０１９,818991,0.976314283670696
0,1727,0,一番くじ仮面ライダー～平成ライダー大集合編～,1727,0.001806464569968337
478251,23200,1,一番くじ仮面ライダー～平成ライダー大集合編～,24927,0.026073967768153294
477680,54061,2,一番くじ仮面ライダー～平成ライダー大集合編～,78988,0.08262248028526868
80,50538,3,一番くじ仮面ライダー～平成ライダー大集合編～,129526,0.13548588876069417
0,38720,4,一番くじ仮面ライダー～平成ライダー大集合編～,168246,0.17598751478800975
0,34893,5,一番くじ仮面ライダー～平成ライダー大集合編～,203139,0.21248604880069372
0,33723,6,一番くじ仮面ライダー～平成ライダー大集合編～,236862,0.24776074752277955
0,30916,7,一番くじ仮面ライダー～平成ライダー大集合編～,267778,0.2800992875604988
0,32344,8,一番くじ仮面ライダー～平成ライダー大集合編～,300122,0.31393153426058906
0,34404,9,一番くじ仮面ライダー～平成ライダー大集合編～,334526,0.34991856788258713
0,32727,10,一番くじ仮面ライダー～平成ライダー大集合編～,367253,0.38415143758806125
0,25959,11,一番くじ仮面ライダー～平成ライダー大集合編～,393212,0.4113048908433062
0,28026,12,一番くじ仮面ライダー～平成ライダー大集合編～,421238,0.4406204531119412
0,27208,13,一番くじ仮面ライダー～平成ライダー大集合編～,448446,0.46908037669022634
0,27529,14,一番くじ仮面ライダー～平成ライダー大集合編～,475975,0.49787607046362437
0,23688,15,一番くじ仮面ライダー～平成ライダー大集合編～,499663,0.5226540280394263
0,21670,16,一番くじ仮面ライダー～平成ライダー大集合編～,521333,0.5453211312422137
0,19581,17,一番くじ仮面ライダー～平成ライダー大集合編～,540914,0.5658031131440956
0,14600,18,一番くじ仮面ライダー～平成ライダー大集合編～,555514,0.58107490394985
0,13417,19,一番くじ仮面ライダー～平成ライダー大集合編～,568931,0.5951092612951107
0,13002,20,一番くじ仮面ライダー～平成ライダー大集合編～,581933,0.6087095232167831
0,12647,21,一番くじ仮面ライダー～平成ライダー大集合編～,594580,0.6219384504990005
0,13822,22,一番くじ仮面ライダー～平成ライダー大集合編～,608402,0.6363964431371606
0,16735,23,一番くじ仮面ライダー～平成ライダー大集合編～,625137,0.6539014718449893
0,14932,24,一番くじ仮面ライダー～平成ライダー大集合編～,640069,0.6695205389896142
0,11082,25,一番くじ仮面ライダー～平成ライダー大集合編～,651151,0.681112455819023
0,10015,26,一番くじ仮面ライダー～平成ライダー大集合編～,661166,0.6915882767039291
0,9940,27,一番くじ仮面ライダー～平成ライダー大集合編～,671106,0.7019856466086687
0,9135,28,一番くじ仮面ライダー～平成ライダー大集合編～,680241,0.7115409759929541
0,9374,29,一番くじ仮面ライダー～平成ライダー大集合編～,689615,0.7213463025007034
0,11341,30,一番くじ仮面ライダー～平成ライダー大集合編～,700956,0.7332091367149541
0,9901,31,一番くじ仮面ライダー～平成ライダー大集合編～,710857,0.7435657121100071
0,6387,32,一番くじ仮面ライダー～平成ライダー大集合編～,717244,0.7502465975809902
0,5747,33,一番くじ仮面ライダー～平成ライダー大集合編～,722991,0.7562580346878854
0,5284,34,一番くじ仮面ライダー～平成ライダー大集合編～,728275,0.7617851677438858
0,5597,35,一番くじ仮面ライダー～平成ライダー大集合編～,733872,0.7676397028904479
0,6043,36,一番くじ仮面ライダー～平成ライダー大集合編～,739915,0.7739607598657338
0,7990,37,一番くじ仮面ライダー～平成ライダー大集合編～,747905,0.7823184042861432
0,7188,38,一番くじ仮面ライダー～平成ライダー大集合編～,755093,0.789837146225305
0,4602,39,一番くじ仮面ライダー～平成ライダー大集合編～,759695,0.7946508983683243
0,4756,40,一番くじ仮面ライダー～平成ライダー大集合編～,764451,0.7996257365239521
0,4502,41,一番くじ仮面ライダー～平成ライダー大集合編～,768953,0.8043348873600826
0,4913,42,一番くじ仮面ライダー～平成ライダー大集合編～,773866,0.8094739495675259
0,4898,43,一番くじ仮面ライダー～平成ライダー大集合編～,778764,0.8145973215789358
0,5950,44,一番くじ仮面ライダー～平成ライダー大集合編～,784714,0.8208210993388151
0,4975,45,一番くじ仮面ライダー～平成ライダー大集合編～,789689,0.8260250143565294
0,3965,46,一番くじ仮面ライダー～平成ライダー大集合編～,793654,0.8301724561746674
0,3251,47,一番くじ仮面ライダー～平成ライダー大集合編～,796905,0.83357304466162
0,2854,48,一番くじ仮面ライダー～平成ライダー大集合編～,799759,0.8365583659602243
0,2791,49,一番くじ仮面ライダー～平成ライダー大集合編～,802550,0.8394777884354887
0,3187,50,一番くじ仮面ライダー～平成ライダー大集合編～,805737,0.8428114320860325
0,4059,51,一番くじ仮面ライダー～平成ライダー大集合編～,809796,0.847057199132646
0,3879,52,一番くじ仮面ライダー～平成ライダー大集合編～,813675,0.8511146838268597
0,3289,53,一番くじ仮面ライダー～平成ライダー大集合編～,816964,0.85455502081043
0,2033,54,一番くじ仮面ライダー～平成ライダー大集合編～,818997,0.8566815653794778
0,2399,55,一番くじ仮面ライダー～平成ライダー大集合編～,821396,0.8591909507317385
0,2270,56,一番くじ仮面ライダー～平成ライダー大集合編～,823666,0.8615654003981126
0,2239,57,一番くじ仮面ライダー～平成ライダー大集合編～,825905,0.8639074236593512
0,3342,58,一番くじ仮面ライダー～平成ライダー大集合編～,829247,0.8674031993355725
0,2912,59,一番くじ仮面ライダー～平成ライダー大集合編～,832159,0.8704491893921723
8641,17190,0,一番くじシン・エヴァンゲリオン初号機覚醒,17190,0.015086344970911174
583920,280182,1,一番くじシン・エヴァンゲリオン初号機覚醒,297372,0.260980603646876
546720,289715,2,一番くじシン・エヴァンゲリオン初号機覚醒,587087,0.515241245487919
0,138402,3,一番くじシン・エヴァンゲリオン初号機覚醒,725489,0.6367060690285851
0,87467,4,一番くじシン・エヴァンゲリオン初号機覚醒,812956,0.7134691484684157
80,73131,5,一番くじシン・エヴァンゲリオン初号機覚醒,886087,0.7776506199092362
0,62622,6,一番くじシン・エヴァンゲリオン初号機覚醒,948709,0.8326091478189744
0,31877,7,一番くじシン・エヴァンゲリオン初号機覚醒,980586,0.8605851465762597
0,29577,8,一番くじシン・エヴァンゲリオン初号機覚醒,1010163,0.8865426116841504
80,20227,9,一番くじシン・エヴァンゲリオン初号機覚醒,1030390,0.9042942986955884
0,12246,10,一番くじシン・エヴァンゲリオン初号機覚醒,1042636,0.9150416739436268
0,9997,11,一番くじシン・エヴァンゲリオン初号機覚醒,1052633,0.9238152743318873
0,8428,12,一番くじシン・エヴァンゲリオン初号機覚醒,1061061,0.9312118837219303
0,6595,13,一番くじシン・エヴァンゲリオン初号機覚醒,1067656,0.9369998095557383
0,5851,14,一番くじシン・エヴァンゲリオン初号機覚醒,1073507,0.9421347836351334
0,6180,15,一番くじシン・エヴァンゲリオン初号機覚醒,1079687,0.9475584957887244
0,8547,16,一番くじシン・エヴァンゲリオン初号機覚醒,1088234,0.9550595423545405
0,3076,17,一番くじシン・エヴァンゲリオン初号機覚醒,1091310,0.9577591117047746
0,3104,18,一番くじシン・エヴァンゲリオン初号機覚醒,1094414,0.9604832545081317
0,2195,19,一番くじシン・エヴァンゲリオン初号機覚醒,1096609,0.9624096377083149
0,2134,20,一番くじシン・エヴァンゲリオン初号機覚醒,1098743,0.9642824858856228
0,2304,21,一番くじシン・エヴァンゲリオン初号機覚醒,1101047,0.966304530028321
0,3513,22,一番くじシン・エヴァンゲリオン初号機覚醒,1104560,0.96938762077194
0,5213,23,一番くじシン・エヴァンゲリオン初号機覚醒,1109773,0.9739626711694594
0,1391,24,一番くじシン・エヴァンゲリオン初号機覚醒,1111164,0.9751834452156803
0,945,25,一番くじシン・エヴァンゲリオン初号機覚醒,1112109,0.9760127992585839
0,1120,26,一番くじシン・エヴァンゲリオン初号機覚醒,1113229,0.9769957373835064
0,1050,27,一番くじシン・エヴァンゲリオン初号機覚醒,1114279,0.9779172418756215
0,744,28,一番くじシン・エヴァンゲリオン初号機覚醒,1115023,0.9785701936300344
0,975,29,一番くじシン・エヴァンゲリオン初号機覚醒,1115998,0.9794258763727126
0,1025,30,一番くじシン・エヴァンゲリオン初号機覚醒,1117023,0.980325440281682
0,621,31,一番くじシン・エヴァンゲリオン初号機覚醒,1117644,0.9808704443670185
0,797,32,一番くじシン・エヴァンゲリオン初号機覚醒,1118441,0.9815699101577001
0,866,33,一番くじシン・エヴァンゲリオン初号機覚醒,1119307,0.9823299319578636
0,612,34,一番くじシン・エヴァンゲリオン初号機覚醒,1119919,0.9828670374332678
0,628,35,一番くじシン・エヴァンゲリオン初号機覚醒,1120547,0.983418184881885
0,672,36,一番くじシン・エヴァンゲリオン初号機覚醒,1121219,0.9840079477568386
0,779,37,一番くじシン・エヴァンゲリオン初号機覚醒,1121998,0.9846916163276555
0,610,38,一番くじシン・エヴァンゲリオン初号機覚醒,1122608,0.985226966556408
0,413,39,一番くじシン・エヴァンゲリオン初号機覚醒,1123021,0.9855894249899732
0,453,40,一番くじシン・エヴァンゲリオン初号機覚醒,1123474,0.9859869883565713
0,485,41,一番くじシン・エヴァンゲリオン初号機覚醒,1123959,0.9864126356695959
0,359,42,一番くじシン・エヴァンゲリオン初号機覚醒,1124318,0.9867277024435667
0,519,43,一番くじシン・エヴァンゲリオン初号機覚醒,1124837,0.9871831889496692
0,391,44,一番くじシン・エヴァンゲリオン初号機覚醒,1125228,0.9875263396700663
0,220,45,一番くじシン・エヴァンゲリオン初号機覚醒,1125448,0.9877194168017476
0,179,46,一番くじシン・エヴァンゲリオン初号機覚醒,1125627,0.98787651137707
0,278,47,一番くじシン・エヴァンゲリオン初号機覚醒,1125905,0.988120490661649
0,224,48,一番くじシン・エヴァンゲリオン初号機覚醒,1126129,0.9883170782866335
0,204,49,一番くじシン・エヴァンゲリオン初号機覚醒,1126333,0.9884961134451016
0,225,50,一番くじシン・エヴァンゲリオン初号機覚醒,1126558,0.9886935786934119
0,693,51,一番くじシン・エヴァンゲリオン初号機覚醒,1127251,0.9893017716582079
0,125,52,一番くじシン・エヴァンゲリオン初号機覚醒,1127376,0.9894114745739359
0,2084,53,一番くじシン・エヴァンゲリオン初号機覚醒,1129460,0.9912404415849526
0,397,54,一番くじシン・エヴァンゲリオン初号機覚醒,1129857,0.9915888580453047
0,124,55,一番くじシン・エヴァンゲリオン初号機覚醒,1129981,0.9916976833377068
0,136,56,一番くじシン・エヴァンゲリオン初号機覚醒,1130117,0.9918170401100188
0,66,57,一番くじシン・エヴァンゲリオン初号機覚醒,1130183,0.9918749632495232
0,104,58,一番くじシン・エヴァンゲリオン初号機覚醒,1130287,0.9919662360754089
0,90,59,一番くじシン・エヴァンゲリオン初号機覚醒,1130377,0.992045222174733
0,6883,0,一番くじウォルトディズニー１１０ｔｈ,6883,0.005790554069288106
595056,89836,1,一番くじウォルトディズニー１１０ｔｈ,96719,0.08136809516598523
593472,212623,2,一番くじウォルトディズニー１１０ｔｈ,309342,0.26024430871737925
66,171183,3,一番くじウォルトディズニー１１０ｔｈ,480525,0.4042577356014335
0,122932,4,一番くじウォルトディズニー１１０ｔｈ,603457,0.5076783941581277
0,82697,5,一番くじウォルトディズニー１１０ｔｈ,686154,0.5772500126192519
0,68552,6,一番くじウォルトディズニー１１０ｔｈ,754706,0.6349216765096831
0,56158,7,一番くじウォルトディズニー１１０ｔｈ,810864,0.6821664731714704
0,47487,8,一番くじウォルトディズニー１１０ｔｈ,858351,0.7221165009338246
0,48250,9,一番くじウォルトディズニー１１０ｔｈ,906601,0.7627084279777229
0,34710,10,一番くじウォルトディズニー１１０ｔｈ,941311,0.791909376945468
0,21973,11,一番くじウォルトディズニー１１０ｔｈ,963284,0.8103948984570861
66,21628,12,一番くじウォルトディズニー１１０ｔｈ,984912,0.8285901771742971
0,18022,13,一番くじウォルトディズニー１１０ｔｈ,1002934,0.8437517877273568
0,15040,14,一番くじウォルトディズニー１１０ｔｈ,1017974,0.8564046909965843
0,13882,15,一番くじウォルトディズニー１１０ｔｈ,1031856,0.8680833880167583
0,15748,16,一番くじウォルトディズニー１１０ｔｈ,1047604,0.8813319199771171
0,11678,17,一番くじウォルトディズニー１１０ｔｈ,1059282,0.8911564282469335
0,8267,18,一番くじウォルトディズニー１１０ｔｈ,1067549,0.8981113186276984
0,7353,19,一番くじウォルトディズニー１１０ｔｈ,1074902,0.9042972759241499
0,6226,20,一番くじウォルトディズニー１１０ｔｈ,1081128,0.9095351067588713
0,5769,21,一番くじウォルトディズニー１１０ｔｈ,1086897,0.9143884710514361
0,6040,22,一番くじウォルトディズニー１１０ｔｈ,1092937,0.9194698231622163
0,5347,23,一番くじウォルトディズニー１１０ｔｈ,1098284,0.923968165833796
0,4479,24,一番くじウォルトディズニー１１０ｔｈ,1102763,0.9277362744603167
0,3612,25,一番くじウォルトディズニー１１０ｔｈ,1106375,0.9307749903252401
0,2951,26,一番くじウォルトディズニー１１０ｔｈ,1109326,0.9332576178217489
0,2630,27,一番くじウォルトディズニー１１０ｔｈ,1111956,0.9354701933269396
0,2349,28,一番くじウォルトディズニー１１０ｔｈ,1114305,0.9374463681792943
0,2735,29,一番くじウォルトディズニー１１０ｔｈ,1117040,0.9397472784480003
0,2786,30,一番くじウォルトディズニー１１０ｔｈ,1119826,0.9420910941732707
0,2602,31,一番くじウォルトディズニー１１０ｔｈ,1122428,0.9442801137415241
0,2010,32,一番くじウォルトディズニー１１０ｔｈ,1124438,0.945971093500244
0,1852,33,一番くじウォルトディズニー１１０ｔｈ,1126290,0.9475291504719601
0,1542,34,一番くじウォルトディズニー１１０ｔｈ,1127832,0.9488264095704406
0,1298,35,一番くじウォルトディズニー１１０ｔｈ,1129130,0.9499183955041812
0,1560,36,一番くじウォルトディズニー１１０ｔｈ,1130690,0.9512307977049788
0,1870,37,一番くじウォルトディズニー１１０ｔｈ,1132560,0.9528039977790117
0,1756,38,一番くじウォルトディズニー１１０ｔｈ,1134316,0.9542812915383709
0,1216,39,一番くじウォルトディズニー１１０ｔｈ,1135532,0.9553042922282233
0,964,40,一番くじウォルトディズニー１１０ｔｈ,1136496,0.9561152894856393
0,1001,41,一番くじウォルトディズニー１１０ｔｈ,1137497,0.956957414231151
0,1173,42,一番くじウォルトディズニー１１０ｔｈ,1138670,0.9579442397321354
0,1040,43,一番くじウォルトディズニー１１０ｔｈ,1139710,0.9588191745326671
0,1343,44,一番くじウォルトディズニー１１０ｔｈ,1141053,0.9599490182221998
0,1131,45,一番くじウォルトディズニー１１０ｔｈ,1142184,0.960900509817778
0,720,46,一番くじウォルトディズニー１１０ｔｈ,1142904,0.9615062339104538
0,720,47,一番くじウォルトディズニー１１０ｔｈ,1143624,0.9621119580031295
0,918,48,一番くじウォルトディズニー１１０ｔｈ,1144542,0.9628842562212913
0,839,49,一番くじウォルトディズニー１１０ｔｈ,1145381,0.9635900930459509
0,798,50,一番くじウォルトディズニー１１０ｔｈ,1146179,0.9642614372486665
0,731,51,一番くじウォルトディズニー１１０ｔｈ,1146910,0.9648764154594249
0,541,52,一番くじウォルトディズニー１１０ｔｈ,1147451,0.9653315498123938
0,618,53,一番くじウォルトディズニー１１０ｔｈ,1148069,0.9658514629919405
0,371,54,一番くじウォルトディズニー１１０ｔｈ,1148440,0.966163579156361
0,379,55,一番くじウォルトディズニー１１０ｔｈ,1148819,0.9664824255884777
0,380,56,一番くじウォルトディズニー１１０ｔｈ,1149199,0.9668021133040566
0,459,57,一番くじウォルトディズニー１１０ｔｈ,1149658,0.9671882624131375
0,562,58,一番くじウォルトディズニー１１０ｔｈ,1150220,0.9676610637188094
0,451,59,一番くじウォルトディズニー１１０ｔｈ,1150671,0.9680404825601938
132,86,0,名探偵コナンハート型缶バッジＶｏｌ．１,86,0.003802617615847188
12012,1708,1,名探偵コナンハート型缶バッジＶｏｌ．１,1794,0.07932437212592855
10450,1277,2,名探偵コナンハート型缶バッジＶｏｌ．１,3071,0.13578882207286877
0,944,3,名探偵コナンハート型缶バッジＶｏｌ．１,4015,0.17752918287937744
0,714,4,名探偵コナンハート型缶バッジＶｏｌ．１,4729,0.20909975238769013
0,585,5,名探偵コナンハート型缶バッジＶｏｌ．１,5314,0.23496639547223205
0,527,6,名探偵コナンハート型缶バッジＶｏｌ．１,5841,0.2582684824902724
0,561,7,名探偵コナンハート型缶バッジＶｏｌ．１,6402,0.2830739299610895
22,587,8,名探偵コナンハート型缶バッジＶｏｌ．１,6989,0.3090290060134418
0,462,9,名探偵コナンハート型缶バッジＶｏｌ．１,7451,0.32945702157764417
0,318,10,名探偵コナンハート型缶バッジＶｏｌ．１,7769,0.3435178634594977
0,249,11,名探偵コナンハート型缶バッジＶｏｌ．１,8018,0.35452776795189245
0,313,12,名探偵コナンハート型缶バッジＶｏｌ．１,8331,0.36836752741422
0,266,13,名探偵コナンハート型缶バッジＶｏｌ．１,8597,0.3801291121330032
0,206,14,名探偵コナンハート型缶バッジＶｏｌ．１,8803,0.38923770781747435
0,270,15,名探偵コナンハート型缶バッジＶｏｌ．１,9073,0.4011761584718783
0,259,16,名探偵コナンハート型缶バッジＶｏｌ．１,9332,0.4126282278033251
0,126,17,名探偵コナンハート型缶バッジＶｏｌ．１,9458,0.41819950477538026
0,150,18,名探偵コナンハート型缶バッジＶｏｌ．１,9608,0.42483197736116024
0,192,19,名探偵コナンハート型缶バッジＶｏｌ．１,9800,0.4333215422709586
0,167,20,名探偵コナンハート型缶バッジＶｏｌ．１,9967,0.440705695083127
0,178,21,名探偵コナンハート型缶バッジＶｏｌ．１,10145,0.4485762292182526
0,194,22,名探偵コナンハート型缶バッジＶｏｌ．１,10339,0.45715422709586134
0,176,23,名探偵コナンハート型缶バッジＶｏｌ．１,10515,0.4649363282631765
0,75,24,名探偵コナンハート型缶バッジＶｏｌ．１,10590,0.4682525645560665
0,104,25,名探偵コナンハート型缶バッジＶｏｌ．１,10694,0.4728510788822073
0,146,26,名探偵コナンハート型缶バッジＶｏｌ．１,10840,0.47930668553236644
0,135,27,名探偵コナンハート型缶バッジＶｏｌ．１,10975,0.48527591085956845
0,125,28,名探偵コナンハート型缶バッジＶｏｌ．１,11100,0.49080297134771844
0,199,29,名探偵コナンハート型缶バッジＶｏｌ．１,11299,0.4996020516448532
0,153,30,名探偵コナンハート型缶バッジＶｏｌ．１,11452,0.5063671736823487
0,147,31,名探偵コナンハート型缶バッジＶｏｌ．１,11599,0.5128669968164131
0,113,32,名探偵コナンハート型缶バッジＶｏｌ．１,11712,0.5178634594977007
0,163,33,名探偵コナンハート型缶バッジＶｏｌ．１,11875,0.5250707463742483
0,133,34,名探偵コナンハート型缶バッジＶｏｌ．１,12008,0.5309515387336399
0,115,35,名探偵コナンハート型缶バッジＶｏｌ．１,12123,0.5360364343827378
0,115,36,名探偵コナンハート型缶バッジＶｏｌ．１,12238,0.5411213300318358
0,70,37,名探偵コナンハート型缶バッジＶｏｌ．１,12308,0.5442164839051998
0,61,38,名探偵コナンハート型缶バッジＶｏｌ．１,12369,0.546913689423417
0,95,39,名探偵コナンハート型缶バッジＶｏｌ．１,12464,0.5511142553944111
0,90,40,名探偵コナンハート型缶バッジＶｏｌ．１,12554,0.555093738945879
0,54,41,名探偵コナンハート型缶バッジＶｏｌ．１,12608,0.5574814290767598
0,76,42,名探偵コナンハート型缶バッジＶｏｌ．１,12684,0.560841881853555
0,98,43,名探偵コナンハート型缶バッジＶｏｌ．１,12782,0.5651750972762646
0,108,44,名探偵コナンハート型缶バッジＶｏｌ．１,12890,0.5699504775380262
0,60,45,名探偵コナンハート型缶バッジＶｏｌ．１,12950,0.5726034665723382
0,78,46,名探偵コナンハート型缶バッジＶｏｌ．１,13028,0.5760523523169437
0,70,47,名探偵コナンハート型缶バッジＶｏｌ．１,13098,0.5791475061903077
0,59,48,名探偵コナンハート型缶バッジＶｏｌ．１,13157,0.5817562787407146
0,86,49,名探偵コナンハート型缶バッジＶｏｌ．１,13243,0.5855588963565618
0,75,50,名探偵コナンハート型缶バッジＶｏｌ．１,13318,0.5888751326494517
0,90,51,名探偵コナンハート型缶バッジＶｏｌ．１,13408,0.5928546162009197
0,51,52,名探偵コナンハート型缶バッジＶｏｌ．１,13459,0.5951096568800849
0,67,53,名探偵コナンハート型缶バッジＶｏｌ．１,13526,0.5980721613017332
0,54,54,名探偵コナンハート型缶バッジＶｏｌ．１,13580,0.600459851432614
0,79,55,名探偵コナンハート型缶バッジＶｏｌ．１,13659,0.6039529536611249
0,80,56,名探偵コナンハート型缶バッジＶｏｌ．１,13739,0.6074902723735408
0,125,57,名探偵コナンハート型缶バッジＶｏｌ．１,13864,0.6130173328616908
0,75,58,名探偵コナンハート型缶バッジＶｏｌ．１,13939,0.6163335691545808
0,38,59,名探偵コナンハート型缶バッジＶｏｌ．１,13977,0.6180137955429784
0,997,0,一番くじモンスターストライクｖｏｌ．２,997,0.0028872356383918356
167442,20878,1,一番くじモンスターストライクｖｏｌ．２,21875,0.06334832456351194
177673,33444,2,一番くじモンスターストライクｖｏｌ．２,55319,0.16019958704132192
66,27459,3,一番くじモンスターストライクｖｏｌ．２,82778,0.23971874791855505
0,30890,4,一番くじモンスターストライクｖｏｌ．２,113668,0.32917382201075546
66,25639,5,一番くじモンスターストライクｖｏｌ．２,139307,0.40342240228430437
66,13006,6,一番くじモンスターストライクｖｏｌ．２,152313,0.44108678213678604
0,13152,7,一番くじモンスターストライクｖｏｌ．２,165465,0.47917396680692587
0,11112,8,一番くじモンスターストライクｖｏｌ．２,176577,0.5113534677234857
0,8538,9,一番くじモンスターストライクｖｏｌ．２,185115,0.5360788617862635
0,9726,10,一番くじモンスターストライクｖｏｌ．２,194841,0.5642446128584792
0,11373,11,一番くじモンスターストライクｖｏｌ．２,206214,0.5971799497846881
0,9906,12,一番くじモンスターストライクｖｏｌ．２,216120,0.625866967070455
0,5844,13,一番くじモンスターストライクｖｏｌ．２,221964,0.6427907434704166
0,5509,14,一番くじモンスターストライクｖｏｌ．２,227473,0.6587443855284916
0,5091,15,一番くじモンスターストライクｖｏｌ．２,232564,0.6734875316017642
0,5477,16,一番くじモンスターストライクｖｏｌ．２,238041,0.6893485041107633
0,5016,17,一番くじモンスターストライクｖｏｌ．２,243057,0.7038744559283896
0,6990,18,一番くじモンスターストライクｖｏｌ．２,250047,0.7241169605546273
0,5984,19,一番くじモンスターストライクｖｏｌ．２,256031,0.7414461662317955
0,3401,20,一番くじモンスターストライクｖｏｌ．２,259432,0.7512952017445043
0,3665,21,一番くじモンスターストライクｖｏｌ．２,263097,0.761908761037088
0,3553,22,一番くじモンスターストライクｖｏｌ．２,266650,0.7721979769079067
0,2757,23,一番くじモンスターストライクｖｏｌ．２,269407,0.7801820377454657
0,3720,24,一番くじモンスターストライクｖｏｌ．２,273127,0.7909548728255235
0,4166,25,一番くじモンスターストライクｖｏｌ．２,277293,0.8030192897458248
0,3627,26,一番くじモンスターストライクｖｏｌ．２,280920,0.8135228039488812
0,2745,27,一番くじモンスターストライクｖｏｌ．２,283665,0.8214721137055367
0,2230,28,一番くじモンスターストライクｖｏｌ．２,285895,0.8279300229067542
0,3164,29,一番くじモンスターストライクｖｏｌ．２,289059,0.8370927245716205
0,2089,30,一番くじモンスターストライクｖｏｌ．２,291148,0.8431423085722228
0,2107,31,一番くじモンスターストライクｖｏｌ．２,293255,0.8492440191941804
0,2446,32,一番くじモンスターストライクｖｏｌ．２,295701,0.8563274478516593
0,2090,33,一番くじモンスターストライクｖｏｌ．２,297791,0.8623799277756702
0,1808,34,一番くじモンスターストライクｖｏｌ．２,299599,0.867615757298451
0,1482,35,一番くじモンスターストライクｖｏｌ．２,301081,0.8719075157900223
0,1334,36,一番くじモンスターストライクｖｏｌ．２,302415,0.8757706776171184
0,1362,37,一番くじモンスターストライクｖｏｌ．２,303777,0.8797149252996557
0,1046,38,一番くじモンスターストライクｖｏｌ．２,304823,0.8827440611850698
0,1375,39,一番くじモンスターストライクｖｏｌ．２,306198,0.886725955871919
0,1139,40,一番くじモンスターストライクｖｏｌ．２,307337,0.8900244126343346
0,706,41,一番くじモンスターストライクｖｏｌ．２,308043,0.8920689345608187
0,725,42,一番くじモンスターストライクｖｏｌ．２,308768,0.8941684790320665
0,601,43,一番くじモンスターストライクｖｏｌ．２,309369,0.8959089290006458
0,581,44,一番くじモンスターストライクｖｏｌ．２,309950,0.8975914605010527
0,791,45,一番くじモンスターストライクｖｏｌ．２,310741,0.8998821359172693
0,934,46,一番くじモンスターストライクｖｏｌ．２,311675,0.9025869283809181
0,1075,47,一番くじモンスターストライクｖｏｌ．２,312750,0.9057000460451822
0,521,48,一番くじモンスターストライクｖｏｌ．２,313271,0.907208822141072
0,442,49,一番くじモンスターストライクｖｏｌ．２,313713,0.9084888202876811
0,552,50,一番くじモンスターストライクｖｏｌ．２,314265,0.910087370009238
0,496,51,一番くじモンスターストライクｖｏｌ．２,314761,0.9115237480199123
0,563,52,一番くじモンスターストライクｖｏｌ．２,315324,0.9131541528989642
0,750,53,一番くじモンスターストライクｖｏｌ．２,316074,0.9153260954554274
0,691,54,一番くじモンスターストライクｖｏｌ．２,316765,0.9173271785307823
0,453,55,一番くじモンスターストライクｖｏｌ．２,317218,0.918639031834886
0,377,56,一番くじモンスターストライクｖｏｌ．２,317595,0.9197307949599349
0,415,57,一番くじモンスターストライクｖｏｌ．２,318010,0.9209326031745112
0,480,58,一番くじモンスターストライクｖｏｌ．２,318490,0.9223226464106478
0,391,59,一番くじモンスターストライクｖｏｌ．２,318881,0.9234549524634172
0,1892,0,一番くじカピバラさんさんきゅるバル～ン,1892,0.002413031389814253
389000,29174,1,一番くじカピバラさんさんきゅるバル～ン,31066,0.03962115917334544
395076,61732,2,一番くじカピバラさんさんきゅるバル～ン,92798,0.11835332289216861
0,55123,3,一番くじカピバラさんさんきゅるバル～ン,147921,0.18865645677204762
0,43105,4,一番くじカピバラさんさんきゅるバル～ン,191026,0.24363199485764134
0,36963,5,一番くじカピバラさんさんきゅるバル～ン,227989,0.29077410863232644
0,31512,6,一番くじカピバラさんさんきゅるバル～ン,259501,0.3309640902157444
0,37704,7,一番くじカピバラさんさんきゅるバル～ン,297205,0.37905126543855444
0,35293,8,一番くじカピバラさんさんきゅるバル～ン,332498,0.42406348364189184
0,40020,9,一番くじカピバラさんさんきゅるバル～ン,372518,0.4751044541600559
0,34455,10,一番くじカピバラさんさんきゅるバル～ン,406973,0.5190478984180105
0,28719,11,一番くじカピバラさんさんきゅるバル～ン,435692,0.5556757253123422
0,20154,12,一番くじカピバラさんさんきゅるバル～ン,455846,0.5813798662374565
0,18944,13,一番くじカピバラさんさんきゅるバル～ン,474790,0.6055407894132712
0,19311,14,一番くじカピバラさんさんきゅるバル～ン,494101,0.6301697794601544
0,22981,15,一番くじカピバラさんさんきゅるバル～ン,517082,0.6594794382177238
0,20704,16,一番くじカピバラさんさんきゅるバル～ン,537786,0.6858850417561563
0,18767,17,一番くじカピバラさんさんきゅるバル～ン,556553,0.7098202215091394
0,14705,18,一番くじカピバラさんさんきゅるバル～ン,571258,0.7285747810161259
0,9367,19,一番くじカピバラさんさんきゅるバル～ン,580625,0.740521327014218
0,9506,20,一番くじカピバラさんさんきゅるバル～ン,590131,0.7526451517454941
0,8651,21,一番くじカピバラさんさんきゅるバル～ン,598782,0.7636785209597029
0,9353,22,一番くじカピバラさんさんきゅるバル～ン,608135,0.7756072115458196
0,11472,23,一番くじカピバラさんさんきゅるバル～ン,619607,0.7902384462730654
0,12131,24,一番くじカピバラさんさんきゅるバル～ン,631738,0.8057101607497232
0,6698,25,一番くじカピバラさんさんきゅるバル～ン,638436,0.814252699993368
0,5985,26,一番くじカピバラさんさんきゅるバル～ン,644421,0.8218858886128385
0,6182,27,一番くじカピバラさんさんきゅるバル～ン,650603,0.829770328386534
0,5228,28,一番くじカピバラさんさんきゅるバル～ン,655831,0.8364380493727649
0,5810,29,一番くじカピバラさんさんきゅるバル～ン,661641,0.8438480453425433
0,7243,30,一番くじカピバラさんさんきゅるバル～ン,668884,0.8530856702666578
0,5878,31,一番くじカピバラさんさんきゅるバル～ン,674762,0.8605823925231738
0,3687,32,一番くじカピバラさんさんきゅるバル～ン,678449,0.8652847428055443
0,3519,33,一番くじカピバラさんさんきゅるバル～ン,681968,0.8697728281442105
0,3661,34,一番くじカピバラさんさんきゅるバル～ン,685629,0.8744420183757697
0,3365,35,一番くじカピバラさんさんきゅるバル～ン,688994,0.8787336941827067
0,4323,36,一番くじカピバラさんさんきゅるバル～ン,693317,0.8842471903233871
0,3984,37,一番くじカピバラさんさんきゅるバル～ン,697301,0.8893283304169494
0,3585,38,一番くじカピバラさんさんきゅるバル～ン,700886,0.8939005912692137
0,2481,39,一番くじカピバラさんさんきゅるバル～ン,703367,0.8970648253485631
0,1893,40,一番くじカピバラさんさんきゅるバル～ン,705260,0.8994791321249471
0,2073,41,一番くじカピバラさんさんきゅるバル～ン,707333,0.9021230084838715
0,1690,42,一番くじカピバラさんさんきゅるバル～ン,709023,0.9042784117866125
0,1868,43,一番くじカピバラさんさんきゅるバル～ン,710891,0.9066608338987547
0,2395,44,一番くじカピバラさんさんきゅるバル～ン,713286,0.9097153847331126
0,2017,45,一番くじカピバラさんさんきゅるバル～ン,715303,0.9122878394441355
0,1437,46,一番くじカピバラさんさんきゅるバル～ン,716740,0.9141205699447502
0,1199,47,一番くじカピバラさんさんきゅるバル～ン,717939,0.9156497584417838
0,1369,48,一番くじカピバラさんさんきゅるバル～ン,719308,0.9173957626556609
0,1287,49,一番くじカピバラさんさんきゅるバル～ン,720595,0.9190371851708253
0,1315,50,一番くじカピバラさんさんきゅるバル～ン,721910,0.9207143185099403
0,1829,51,一番くじカピバラさんさんきゅるバル～ン,723739,0.9230470005458654
0,1544,52,一番くじカピバラさんさんきゅるバル～ン,725283,0.9250161974094347
0,1060,53,一番くじカピバラさんさんきゅるバル～ン,726343,0.9263681071732842
0,1032,54,一番くじカピバラさんさんきゅるバル～ン,727375,0.9276843061131829
0,1032,55,一番くじカピバラさんさんきゅるバル～ン,728407,0.9290005050530816
0,907,56,一番くじカピバラさんさんきゅるバル～ン,729314,0.9301572806717716
0,1292,57,一番くじカピバラさんさんきゅるバル～ン,730606,0.9318050801197844
0,1276,58,一番くじカピバラさんさんきゅるバル～ン,731882,0.9334324733826823
0,1297,59,一番くじカピバラさんさんきゅるバル～ン,733179,0.9350866497635433
5390,39803,0,一番くじツイステッドワンダーランド第三弾,39803,0.035291353383458644
562590,402506,1,一番くじツイステッドワンダーランド第三弾,442309,0.3921735352532274
559790,248270,2,一番くじツイステッドワンダーランド第三弾,690579,0.6123022769187119
0,119702,3,一番くじツイステッドワンダーランド第三弾,810281,0.7184361256915874
0,67908,4,一番くじツイステッドワンダーランド第三弾,878189,0.7786467938714712
70,45047,5,一番くじツイステッドワンダーランド第三弾,923236,0.8185877429422613
0,37828,6,一番くじツイステッドワンダーランド第三弾,961064,0.8521279614129664
0,26436,7,一番くじツイステッドワンダーランド第三弾,987500,0.875567456376791
0,20890,8,一番くじツイステッドワンダーランド第三弾,1008390,0.8940895871754859
0,13518,9,一番くじツイステッドワンダーランド第三弾,1021908,0.9060753298340191
0,10475,10,一番くじツイステッドワンダーランド第三弾,1032383,0.9153629947510286
0,8260,11,一番くじツイステッドワンダーランド第三弾,1040643,0.9226867286139878
0,7287,12,一番くじツイステッドワンダーランド第三弾,1047930,0.929147751454107
0,6460,13,一番くじツイステッドワンダーランド第三弾,1054390,0.9348755142573415
0,5132,14,一番くじツイステッドワンダーランド第三弾,1059522,0.9394258050787345
0,4981,15,一番くじツイステッドワンダーランド第三弾,1064503,0.9438422116612285
0,3755,16,一番くじツイステッドワンダーランド第三弾,1068258,0.9471715846219322
0,2811,17,一番くじツイステッドワンダーランド第三弾,1071069,0.9496639594268691
0,3022,18,一番くじツイステッドワンダーランド第三弾,1074091,0.9523434175060292
0,2965,19,一番くじツイステッドワンダーランド第三弾,1077056,0.9549723365016315
0,2078,20,一番くじツイステッドワンダーランド第三弾,1079134,0.9568147964250249
0,2304,21,一番くじツイステッドワンダーランド第三弾,1081438,0.9588576393814725
0,2483,22,一番くじツイステッドワンダーランド第三弾,1083921,0.961059192793304
0,2077,23,一番くじツイステッドワンダーランド第三弾,1085998,0.9629007660661086
0,1348,24,一番くじツイステッドワンダーランド第三弾,1087346,0.9640959710597248
0,1203,25,一番くじツイステッドワンダーランド第三弾,1088549,0.9651626117179741
0,1103,26,一番くじツイステッドワンダーランド第三弾,1089652,0.96614058731735
0,1207,27,一番くじツイステッドワンダーランド第三弾,1090859,0.9672107745779543
0,1178,28,一番くじツイステッドワンダーランド第三弾,1092037,0.9682552489714853
0,1336,29,一番くじツイステッドワンダーランド第三弾,1093373,0.9694398141580366
0,1345,30,一番くじツイステッドワンダーランド第三弾,1094718,0.9706323591998866
0,1091,31,一番くじツイステッドワンダーランド第三弾,1095809,0.9715996949921974
0,764,32,一番くじツイステッドワンダーランド第三弾,1096573,0.9722770960419918
0,944,33,一番くじツイステッドワンダーランド第三弾,1097517,0.9731140941977585
0,785,34,一番くじツイステッドワンダーランド第三弾,1098302,0.9738101149099163
0,827,35,一番くじツイステッドワンダーランド第三弾,1099129,0.974543374946801
0,878,36,一番くじツイステッドワンダーランド第三弾,1100007,0.9753218541637112
0,744,37,一番くじツイステッドワンダーランド第三弾,1100751,0.9759815222017307
0,747,38,一番くじツイステッドワンダーランド第三弾,1101498,0.9766438501915166
0,662,39,一番くじツイステッドワンダーランド第三弾,1102160,0.9772308128812598
0,434,40,一番くじツイステッドワンダーランド第三弾,1102594,0.9776156192367712
0,405,41,一番くじツイステッドワンダーランド第三弾,1102999,0.9779747127252092
0,597,42,一番くじツイステッドワンダーランド第三弾,1103596,0.9785040431266846
0,576,43,一番くじツイステッドワンダーランド第三弾,1104172,0.9790147538657966
0,486,44,一番くじツイステッドワンダーランド第三弾,1104658,0.9794456660519223
0,415,45,一番くじツイステッドワンダーランド第三弾,1105073,0.9798136260462477
0,453,46,一番くじツイステッドワンダーランド第三弾,1105526,0.9802152787629451
0,240,47,一番くじツイステッドワンダーランド第三弾,1105766,0.9804280749042418
0,361,48,一番くじツイステッドワンダーランド第三弾,1106127,0.9807481557667754
0,296,49,一番くじツイステッドワンダーランド第三弾,1106423,0.9810106043410413
0,484,50,一番くじツイステッドワンダーランド第三弾,1106907,0.9814397432259895
0,429,51,一番くじツイステッドワンダーランド第三弾,1107336,0.9818201163285573
0,244,52,一番くじツイステッドワンダーランド第三弾,1107580,0.9820364590722088
0,288,53,一番くじツイステッドワンダーランド第三弾,1107868,0.9822918144417648
0,219,54,一番くじツイステッドワンダーランド第三弾,1108087,0.982485990920698
0,175,55,一番くじツイステッドワンダーランド第三弾,1108262,0.9826411547737268
0,226,56,一番くじツイステッドワンダーランド第三弾,1108488,0.9828415378067811
0,396,57,一番くじツイステッドワンダーランド第三弾,1108884,0.9831926514399205
0,263,58,一番くじツイステッドワンダーランド第三弾,1109147,0.9834258405447581
0,127,59,一番くじツイステッドワンダーランド第三弾,1109274,0.9835384451695276
0,216,0,一番くじ続・夏目友人帳＊,216,0.004153846153846154
28400,2542,1,一番くじ続・夏目友人帳＊,2758,0.05303846153846154
23600,3743,2,一番くじ続・夏目友人帳＊,6501,0.12501923076923077
0,3644,3,一番くじ続・夏目友人帳＊,10145,0.19509615384615384
0,3533,4,一番くじ続・夏目友人帳＊,13678,0.26303846153846155
0,3757,5,一番くじ続・夏目友人帳＊,17435,0.33528846153846154
0,2945,6,一番くじ続・夏目友人帳＊,20380,0.39192307692307693
0,2547,7,一番くじ続・夏目友人帳＊,22927,0.44090384615384615
0,2714,8,一番くじ続・夏目友人帳＊,25641,0.49309615384615385
0,2147,9,一番くじ続・夏目友人帳＊,27788,0.5343846153846153
0,1733,10,一番くじ続・夏目友人帳＊,29521,0.5677115384615384
0,1619,11,一番くじ続・夏目友人帳＊,31140,0.5988461538461538
0,1301,12,一番くじ続・夏目友人帳＊,32441,0.6238653846153847
0,1258,13,一番くじ続・夏目友人帳＊,33699,0.6480576923076923
0,1178,14,一番くじ続・夏目友人帳＊,34877,0.6707115384615384
0,1212,15,一番くじ続・夏目友人帳＊,36089,0.6940192307692308
0,1078,16,一番くじ続・夏目友人帳＊,37167,0.71475
0,612,17,一番くじ続・夏目友人帳＊,37779,0.7265192307692308
0,524,18,一番くじ続・夏目友人帳＊,38303,0.7365961538461538
0,524,19,一番くじ続・夏目友人帳＊,38827,0.7466730769230769
0,544,20,一番くじ続・夏目友人帳＊,39371,0.7571346153846154
0,456,21,一番くじ続・夏目友人帳＊,39827,0.7659038461538461
0,533,22,一番くじ続・夏目友人帳＊,40360,0.7761538461538462
0,485,23,一番くじ続・夏目友人帳＊,40845,0.7854807692307693
0,323,24,一番くじ続・夏目友人帳＊,41168,0.7916923076923077
0,251,25,一番くじ続・夏目友人帳＊,41419,0.7965192307692308
0,306,26,一番くじ続・夏目友人帳＊,41725,0.8024038461538462
0,229,27,一番くじ続・夏目友人帳＊,41954,0.8068076923076923
0,300,28,一番くじ続・夏目友人帳＊,42254,0.8125769230769231
0,328,29,一番くじ続・夏目友人帳＊,42582,0.8188846153846154
0,352,30,一番くじ続・夏目友人帳＊,42934,0.8256538461538462
0,182,31,一番くじ続・夏目友人帳＊,43116,0.8291538461538461
0,179,32,一番くじ続・夏目友人帳＊,43295,0.8325961538461538
0,162,33,一番くじ続・夏目友人帳＊,43457,0.8357115384615385
0,153,34,一番くじ続・夏目友人帳＊,43610,0.8386538461538462
0,134,35,一番くじ続・夏目友人帳＊,43744,0.8412307692307692
0,200,36,一番くじ続・夏目友人帳＊,43944,0.8450769230769231
0,161,37,一番くじ続・夏目友人帳＊,44105,0.848173076923077
0,105,38,一番くじ続・夏目友人帳＊,44210,0.8501923076923077
0,110,39,一番くじ続・夏目友人帳＊,44320,0.8523076923076923
0,116,40,一番くじ続・夏目友人帳＊,44436,0.8545384615384616
0,99,41,一番くじ続・夏目友人帳＊,44535,0.8564423076923077
0,94,42,一番くじ続・夏目友人帳＊,44629,0.85825
0,112,43,一番くじ続・夏目友人帳＊,44741,0.8604038461538461
0,56,44,一番くじ続・夏目友人帳＊,44797,0.8614807692307692
0,28,45,一番くじ続・夏目友人帳＊,44825,0.8620192307692308
0,24,46,一番くじ続・夏目友人帳＊,44849,0.8624807692307692
0,28,47,一番くじ続・夏目友人帳＊,44877,0.8630192307692308
0,24,48,一番くじ続・夏目友人帳＊,44901,0.8634807692307692
0,11,49,一番くじ続・夏目友人帳＊,44912,0.8636923076923076
0,22,50,一番くじ続・夏目友人帳＊,44934,0.8641153846153846
0,14,51,一番くじ続・夏目友人帳＊,44948,0.8643846153846154
0,7,52,一番くじ続・夏目友人帳＊,44955,0.8645192307692308
0,8,53,一番くじ続・夏目友人帳＊,44963,0.8646730769230769
0,5,54,一番くじ続・夏目友人帳＊,44968,0.8647692307692307
0,10,55,一番くじ続・夏目友人帳＊,44978,0.8649615384615384
0,8,56,一番くじ続・夏目友人帳＊,44986,0.8651153846153846
0,5,57,一番くじ続・夏目友人帳＊,44991,0.8652115384615384
0,1,58,一番くじ続・夏目友人帳＊,44992,0.8652307692307692
0,3,59,一番くじ続・夏目友人帳＊,44995,0.8652884615384615
0,5270,0,一番くじ妖怪ウォッチ誕生の秘密だニャン！,5270,0.004801472330035169
542850,90964,1,一番くじ妖怪ウォッチ誕生の秘密だニャン！,96234,0.08767834690865359
554532,206250,2,一番くじ妖怪ウォッチ誕生の秘密だニャン！,302484,0.2755917564095556
132,211184,3,一番くじ妖怪ウォッチ誕生の秘密だニャン！,513668,0.4680005102133785
0,150063,4,一番くじ妖怪ウォッチ誕生の秘密だニャン！,663731,0.6047222070373003
0,85003,5,一番くじ妖怪ウォッチ誕生の秘密だニャン！,748734,0.682168042420598
0,75192,6,一番くじ妖怪ウォッチ誕生の秘密だニャン！,823926,0.7506751216312251
0,49644,7,一番くじ妖怪ウォッチ誕生の秘密だニャン！,873570,0.7959055376373476
66,39367,8,一番くじ妖怪ウォッチ誕生の秘密だニャン！,912937,0.8317726270522422
0,29389,9,一番くじ妖怪ウォッチ誕生の秘密だニャン！,942326,0.8585488073762277
0,25505,10,一番くじ妖怪ウォッチ誕生の秘密だニャン！,967831,0.8817862934820241
0,20270,11,一番くじ妖怪ウォッチ誕生の秘密だニャン！,988101,0.900254195593943
0,14767,12,一番くじ妖怪ウォッチ誕生の秘密だニャン！,1002868,0.9137083401665482
0,12566,13,一番くじ妖怪ウォッチ誕生の秘密だニャン！,1015434,0.9251571639424917
0,10624,14,一番くじ妖怪ウォッチ誕生の秘密だニャン！,1026058,0.9348366406093406
0,13672,15,一番くじ妖怪ウォッチ誕生の秘密だニャン！,1039730,0.9472931358078682
0,8618,16,一番くじ妖怪ウォッチ誕生の秘密だニャン！,1048348,0.9551449552652198
0,6131,17,一番くじ妖怪ウォッチ誕生の秘密だニャン！,1054479,0.9607308806647351
0,4031,18,一番くじ妖怪ウォッチ誕生の秘密だニャン！,1058510,0.9644035058947867
0,2856,19,一番くじ妖怪ウォッチ誕生の秘密だニャン！,1061366,0.9670055941252574
0,2394,20,一番くじ妖怪ウォッチ誕生の秘密だニャン！,1063760,0.9691867563184461
0,1974,21,一番くじ妖怪ウォッチ誕生の秘密だニャン！,1065734,0.970985258477742
0,1587,22,一番くじ妖怪ウォッチ誕生の秘密だニャン！,1067321,0.9724311667486653
0,1476,23,一番くじ妖怪ウォッチ誕生の秘密だニャン！,1068797,0.9737759434392026
0,1809,24,一番くじ妖怪ウォッチ誕生の秘密だニャン！,1070606,0.9754241148708978
0,1446,25,一番くじ妖怪ウォッチ誕生の秘密だニャン！,1072052,0.9767415587018714
0,1109,26,一番くじ妖怪ウォッチ誕生の秘密だニャン！,1073161,0.977751963410412
0,711,27,一番くじ妖怪ウォッチ誕生の秘密だニャン！,1073872,0.9783997521820733
0,773,28,一番くじ妖怪ウォッチ誕生の秘密だニャン！,1074645,0.9791040288634997
0,560,29,一番くじ妖怪ウォッチ誕生の秘密だニャン！,1075205,0.9796142422420233
0,632,30,一番くじ妖怪ウォッチ誕生の秘密だニャン！,1075837,0.9801900544835
0,684,31,一番くじ妖怪ウォッチ誕生の秘密だニャン！,1076521,0.980813243681554
0,486,32,一番くじ妖怪ウォッチ誕生の秘密だニャン！,1077007,0.981256036006487
0,510,33,一番くじ妖怪ウォッチ誕生の秘密だニャン！,1077517,0.9817206946190711
0,438,34,一番くじ妖怪ウォッチ誕生の秘密だニャン！,1077955,0.982119754368702
0,287,35,一番くじ妖怪ウォッチ誕生の秘密だニャン！,1078242,0.9823812387251954
0,299,36,一番くじ妖怪ウォッチ誕生の秘密だニャン！,1078541,0.9826536562255143
0,492,37,一番くじ妖怪ウォッチ誕生の秘密だニャン！,1079033,0.9831019151223601
0,585,38,一番くじ妖怪ウォッチ誕生の秘密だニャン！,1079618,0.9836349058838536
0,435,39,一番くじ妖怪ウォッチ誕生の秘密だニャン！,1080053,0.9840312323475282
0,331,40,一番くじ妖怪ウォッチ誕生の秘密だニャン！,1080384,0.9843328048980484
0,244,41,一番くじ妖怪ウォッチ誕生の秘密だニャン！,1080628,0.9845551121558337
0,311,42,一番くじ妖怪ウォッチ誕生の秘密だニャン！,1080939,0.9848384627999781
0,286,43,一番くじ妖怪ウォッチ誕生の秘密だニャン！,1081225,0.9850990360611527
0,183,44,一番くじ妖怪ウォッチ誕生の秘密だニャン！,1081408,0.9852657665044917
0,242,45,一番くじ妖怪ウォッチ誕生の秘密だニャン！,1081650,0.9854862515716394
0,178,46,一番くじ妖怪ウォッチ誕生の秘密だニャン！,1081828,0.9856484265383845
0,178,47,一番くじ妖怪ウォッチ誕生の秘密だニャン！,1082006,0.9858106015051294
0,144,48,一番くじ妖怪ウォッチ誕生の秘密だニャン！,1082150,0.9859417992310355
0,161,49,一番くじ妖怪ウォッチ誕生の秘密だニャン！,1082311,0.9860884855773611
0,131,50,一番くじ妖怪ウォッチ誕生の秘密だニャン！,1082442,0.9862078390641229
0,148,51,一番くじ妖怪ウォッチ誕生の秘密だニャン！,1082590,0.9863426811713042
0,174,52,一番くじ妖怪ウォッチ誕生の秘密だニャン！,1082764,0.986501211756774
0,151,53,一番くじ妖怪ウォッチ誕生の秘密だニャン！,1082915,0.9866387871499116
0,102,54,一番くじ妖怪ウォッチ誕生の秘密だニャン！,1083017,0.9867317188724284
0,122,55,一番くじ妖怪ウォッチ誕生の秘密だニャン！,1083139,0.9868428725013211
0,145,56,一番くじ妖怪ウォッチ誕生の秘密だニャン！,1083284,0.986974981322546
0,89,57,一番くじ妖怪ウォッチ誕生の秘密だニャン！,1083373,0.9870560688059185
0,132,58,一番くじ妖怪ウォッチ誕生の秘密だニャン！,1083505,0.987176333387999
0,94,59,一番くじ妖怪ウォッチ誕生の秘密だニャン！,1083599,0.9872619763479655
250,5070,0,一番くじぷちアイカツ！nan,5070,0.007522177069377618
339351,63729,1,一番くじぷちアイカツ！nan,68799,0.10207460753374965
334256,103527,2,一番くじぷちアイカツ！nan,172326,0.25567390249656163
100,90846,3,一番くじぷちアイカツ！nan,263172,0.39045885280123205
0,69756,4,一番くじぷちアイカツ！nan,332928,0.49395332689423105
0,57425,5,一番くじぷちアイカツ！nan,390353,0.5791527387697754
0,48533,6,一番くじぷちアイカツ！nan,438886,0.651159409323642
0,49449,7,一番くじぷちアイカツ！nan,488335,0.7245251162079919
50,35698,8,一番くじぷちアイカツ！nan,524033,0.7774889578298149
0,28219,9,一番くじぷちアイカツ！nan,552252,0.8193564755262186
0,21141,10,一番くじぷちアイカツ！nan,573393,0.8507226186078186
0,15522,11,一番くじぷちアイカツ！nan,588915,0.8737520530202209
0,10080,12,一番くじぷちアイカツ！nan,598995,0.8887073873120012
0,8202,13,一番くじぷちアイカツ！nan,607197,0.9008764003934677
0,5516,14,一番くじぷちアイカツ！nan,612713,0.909060291658692
0,4909,15,一番くじぷちアイカツ！nan,617622,0.9163435988053537
0,4837,16,一番くじぷちアイカツ！nan,622459,0.9235200821356455
0,6930,17,一番くじぷちアイカツ！nan,629389,0.9338018744612445
0,5928,18,一番くじぷちアイカツ！nan,635317,0.9425970353423629
0,4905,19,一番くじぷちアイカツ！nan,640222,0.9498744078325596
0,1995,20,一番くじぷちアイカツ！nan,642217,0.9528343177444745
0,1787,21,一番くじぷちアイカツ！nan,644004,0.9554856255202098
0,1570,22,一番くじぷちアイカツ！nan,645574,0.9578149781827192
0,1653,23,一番くじぷちアイカツ！nan,647227,0.9602674749668771
0,2117,24,一番くじぷちアイカツ！nan,649344,0.9634083919009743
0,1610,25,一番くじぷちアイカツ！nan,650954,0.9657970911281337
0,1000,26,一番くじぷちアイカツ！nan,651954,0.9672807552443817
0,806,27,一番くじぷちアイカツ！nan,652760,0.9684765885220776
0,944,28,一番くじぷちアイカツ！nan,653704,0.9698771674478158
0,765,29,一番くじぷちアイカツ！nan,654469,0.9710121704967456
0,950,30,一番くじぷちアイカツ！nan,655419,0.9724216514071812
0,1167,31,一番くじぷちアイカツ！nan,656586,0.9741530874308427
0,950,32,一番くじぷちアイカツ！nan,657536,0.9755625683412783
0,628,33,一番くじぷちアイカツ！nan,658164,0.9764943094062821
0,524,34,一番くじぷちアイカツ！nan,658688,0.977271749403196
0,537,35,一番くじぷちアイカツ！nan,659225,0.9780684770336213
0,439,36,一番くじぷちアイカツ！nan,659664,0.9787198055806542
0,628,37,一番くじぷちアイカツ！nan,660292,0.979651546645658
0,557,38,一番くじぷちアイカツ！nan,660849,0.9804779475584081
0,572,39,一番くじぷちアイカツ！nan,661421,0.981326603432902
0,256,40,一番くじぷちアイカツ！nan,661677,0.9817064214466615
0,233,41,一番くじぷちアイカツ！nan,661910,0.9820521151857473
0,263,42,一番くじぷちアイカツ！nan,662173,0.9824423188483206
0,222,43,一番くじぷちアイカツ！nan,662395,0.9827716922821277
0,255,44,一番くじぷちアイカツ！nan,662650,0.9831500266317709
0,223,45,一番くじぷちアイカツ！nan,662873,0.9834808837296942
0,270,46,一番くじぷちアイカツ！nan,663143,0.9838814730410812
0,160,47,一番くじぷちアイカツ！nan,663303,0.9841188592996809
0,256,48,一番くじぷちアイカツ！nan,663559,0.9844986773134403
0,166,49,一番くじぷちアイカツ！nan,663725,0.9847449655567375
0,186,50,一番くじぷちアイカツ！nan,663911,0.9850209270823597
0,117,51,一番くじぷちアイカツ！nan,664028,0.9851945157839607
0,205,52,一番くじぷちアイカツ！nan,664233,0.9854986669277915
0,149,53,一番くじぷちアイカツ！nan,664382,0.9857197328811125
0,138,54,一番くじぷちアイカツ！nan,664520,0.9859244785291548
0,77,55,一番くじぷちアイカツ！nan,664597,0.9860387206661059
0,101,56,一番くじぷちアイカツ！nan,664698,0.9861885707418468
0,128,57,一番くじぷちアイカツ！nan,664826,0.9863784797487266
0,97,58,一番くじぷちアイカツ！nan,664923,0.9865223951680027
0,159,59,一番くじぷちアイカツ！nan,665082,0.9867582977624861
0,1489,0,一番くじモンスターハンター：ワールド,1489,0.0023161398705823792
307920,34678,1,一番くじモンスターハンター：ワールド,36167,0.0562577775012444
334720,52645,2,一番くじモンスターハンター：ワールド,88812,0.1381470881035341
0,47605,3,一番くじモンスターハンター：ワールド,136417,0.2121966774514684
0,43246,4,一番くじモンスターハンター：ワールド,179663,0.2794658412145346
80,35957,5,一番くじモンスターハンター：ワールド,215620,0.3353969636635142
0,30690,6,一番くじモンスターハンター：ワールド,246310,0.38313526630164263
0,26822,7,一番くじモンスターハンター：ワールド,273132,0.424856893977103
0,25321,8,一番くじモンスターハンター：ワールド,298453,0.46424371577899454
0,20422,9,一番くじモンスターハンター：ワールド,318875,0.4960101418616227
0,18618,10,一番くじモンスターハンター：ワールド,337493,0.5249704454952713
0,17695,11,一番くじモンスターハンター：ワールド,355188,0.5524950223992036
0,15695,12,一番くじモンスターハンター：ワールド,370883,0.5769085988053758
0,11805,13,一番くじモンスターハンター：ワールド,382688,0.5952712792434047
0,10672,14,一番くじモンスターハンター：ワールド,393360,0.6118715778994525
0,9780,15,一番くじモンスターハンター：ワールド,403140,0.6270843703334993
0,8813,16,一番くじモンスターハンター：ワールド,411953,0.6407929940268791
0,10328,17,一番くじモンスターハンター：ワールド,422281,0.6568582005973121
0,11203,18,一番くじモンスターハンター：ワールド,433484,0.6742844698855152
80,9127,19,一番くじモンスターハンター：ワールド,442611,0.6884815206570433
0,7162,20,一番くじモンスターハンター：ワールド,449773,0.6996220134395221
0,6600,21,一番くじモンスターハンター：ワールド,456373,0.7098883150821305
0,5781,22,一番くじモンスターハンター：ワールド,462154,0.718880662020906
0,5630,23,一番くじモンスターハンター：ワールド,467784,0.7276381284221005
0,6854,24,一番くじモンスターハンター：ワールド,474638,0.7382995271279243
80,5654,25,一番くじモンスターハンター：ワールド,480292,0.7470943255350921
0,5438,26,一番くじモンスターハンター：ワールド,485730,0.7555531358885017
0,3822,27,一番くじモンスターハンター：ワールド,489552,0.7614982578397212
0,3035,28,一番くじモンスターハンター：ワールド,492587,0.7662192010950721
0,2924,29,一番くじモンスターハンター：ワールド,495511,0.7707674838227974
0,2572,30,一番くじモンスターハンター：ワールド,498083,0.7747682304629169
0,2809,31,一番くじモンスターハンター：ワールド,500892,0.7791376306620209
0,3759,32,一番くじモンスターハンター：ワールド,504651,0.784984756097561
0,3381,33,一番くじモンスターハンター：ワールド,508032,0.7902439024390244
0,2337,34,一番くじモンスターハンター：ワールド,510369,0.7938791065206571
0,2236,35,一番くじモンスターハンター：ワールド,512605,0.7973572050771528
0,2167,36,一番くじモンスターハンター：ワールド,514772,0.8007279741164759
0,2011,37,一番くじモンスターハンター：ワールド,516783,0.8038560851169736
0,2007,38,一番くじモンスターハンター：ワールド,518790,0.8069779741164759
0,2646,39,一番くじモンスターハンター：ワールド,521436,0.8110938277750125
0,2929,40,一番くじモンスターハンター：ワールド,524365,0.8156498880039821
0,1922,41,一番くじモンスターハンター：ワールド,526287,0.8186395594823295
0,1290,42,一番くじモンスターハンター：ワールド,527577,0.8206461548033848
0,1365,43,一番くじモンスターハンター：ワールド,528942,0.822769412643106
0,1204,44,一番くじモンスターハンター：ワールド,530146,0.8246422349427576
0,1409,45,一番くじモンスターハンター：ワールド,531555,0.8268339347934296
0,1838,46,一番くじモンスターハンター：ワールド,533393,0.829692944250871
0,1886,47,一番くじモンスターハンター：ワールド,535279,0.8326266177202588
0,1531,48,一番くじモンスターハンター：ワールド,536810,0.8350080886012942
0,1239,49,一番くじモンスターハンター：ワールド,538049,0.8369353534096565
0,1209,50,一番くじモンスターハンター：ワールド,539258,0.8388159532105525
0,987,51,一番くじモンスターハンター：ワールド,540245,0.8403512319561971
0,1301,52,一番くじモンスターハンター：ワールド,541546,0.8423749377799901
0,1483,53,一番くじモンスターハンター：ワールド,543029,0.8446817446490792
0,1268,54,一番くじモンスターハンター：ワールド,544297,0.846654118964659
0,978,55,一番くじモンスターハンター：ワールド,545275,0.8481753982080638
0,866,56,一番くじモンスターハンター：ワールド,546141,0.8495224614235938
0,707,57,一番くじモンスターハンター：ワールド,546848,0.850622200099552
0,754,58,一番くじモンスターハンター：ワールド,547602,0.8517950472872076
0,784,59,一番くじモンスターハンター：ワールド,548386,0.8530145594823295
0,4044,0,一番くじワンピースメモリーズ２,4044,0.0030985656491357115
649040,44216,1,一番くじワンピースメモリーズ２,48260,0.036977442687262475
655840,146030,2,一番くじワンピースメモリーズ２,194290,0.1488675370847125
160,128676,3,一番くじワンピースメモリーズ２,322966,0.24746076989089125
0,85087,4,一番くじワンピースメモリーズ２,408053,0.3126555412529116
0,74601,5,一番くじワンピースメモリーズ２,482654,0.36981580237832534
0,67000,6,一番くじワンピースメモリーズ２,549654,0.42115207796984183
0,58155,7,一番くじワンピースメモリーズ２,607809,0.4657111989702096
0,55468,8,一番くじワンピースメモリーズ２,663277,0.508211505455437
0,64837,9,一番くじワンピースメモリーズ２,728114,0.5578904621797229
80,56533,10,一番くじワンピースメモリーズ２,784647,0.6012067855829349
0,32427,11,一番くじワンピースメモリーズ２,817074,0.6260527767561603
0,27867,12,一番くじワンピースメモリーズ２,844941,0.6474048363368886
0,25154,13,一番くじワンピースメモリーズ２,870095,0.6666781598626946
0,21372,14,一番くじワンピースメモリーズ２,891467,0.6830536655633198
0,24207,15,一番くじワンピースメモリーズ２,915674,0.7016013853132279
0,28110,16,一番くじワンピースメモリーズ２,943784,0.723139634669609
0,25617,17,一番くじワンピースメモリーズ２,969401,0.7427677148461445
0,20031,18,一番くじワンピースメモリーズ２,989432,0.7581157288218708
0,12630,19,一番くじワンピースメモリーズ２,1002062,0.7677929998774059
0,12507,20,一番くじワンピースメモリーズ２,1014569,0.7773760267255119
0,11793,21,一番くじワンピースメモリーズ２,1026362,0.7864119774426873
0,11454,22,一番くじワンピースメモリーズ２,1037816,0.795188181929631
0,13237,23,一番くじワンピースメモリーズ２,1051053,0.8053305443177639
0,11092,24,一番くじワンピースメモリーズ２,1062145,0.8138293796738997
0,8688,25,一番くじワンピースメモリーズ２,1070833,0.8204862388132892
0,7284,26,一番くじワンピースメモリーズ２,1078117,0.8260673348044624
0,6954,27,一番くじワンピースメモリーズ２,1085071,0.8313955804830208
0,6188,28,一番くじワンピースメモリーズ２,1091259,0.836136906951085
0,6351,29,一番くじワンピースメモリーズ２,1097610,0.8410031261493196
0,6793,30,一番くじワンピースメモリーズ２,1104403,0.8462080115238445
0,6602,31,一番くじワンピースメモリーズ２,1111005,0.8512665502022803
0,4778,32,一番くじワンピースメモリーズ２,1115783,0.8549275162437171
0,4305,33,一番くじワンピースメモリーズ２,1120088,0.8582260635037391
0,4051,34,一番くじワンピースメモリーズ２,1124139,0.8613299926443545
0,4036,35,一番くじワンピースメモリーズ２,1128175,0.864422428588942
0,3890,36,一番くじワンピースメモリーズ２,1132065,0.8674029974255241
0,4319,37,一番くじワンピースメモリーズ２,1136384,0.8707122716685056
0,3843,38,一番くじワンピースメモリーズ２,1140227,0.8736568284908668
0,3020,39,一番くじワンピースメモリーズ２,1143247,0.8759707919578277
0,3020,40,一番くじワンピースメモリーズ２,1146267,0.8782847554247886
0,3073,41,一番くじワンピースメモリーズ２,1149340,0.8806393281843815
0,3359,42,一番くじワンピースメモリーズ２,1152699,0.8832130378815741
0,3304,43,一番くじワンピースメモリーズ２,1156003,0.8857446058599976
0,3835,44,一番くじワンピースメモリーズ２,1159838,0.8886830329778105
0,3526,45,一番くじワンピースメモリーズ２,1163364,0.8913847002574475
0,3305,46,一番くじワンピースメモリーズ２,1166669,0.8939170344489396
0,2607,47,一番くじワンピースメモリーズ２,1169276,0.8959145519185975
0,2267,48,一番くじワンピースメモリーズ２,1171543,0.8976515569449552
0,2126,49,一番くじワンピースメモリーズ２,1173669,0.8992805259286503
0,2037,50,一番くじワンピースメモリーズ２,1175706,0.900841301949246
0,2238,51,一番くじワンピースメモリーズ２,1177944,0.9025560867966164
0,2519,52,一番くじワンピースメモリーズ２,1180463,0.9044861775162437
0,1561,53,一番くじワンピースメモリーズ２,1182024,0.9056822361162192
0,1826,54,一番くじワンピースメモリーズ２,1183850,0.9070813411793551
0,1616,55,一番くじワンピースメモリーズ２,1185466,0.9083195414980998
0,1769,56,一番くじワンピースメモリーズ２,1187235,0.9096749724163296
0,1709,57,一番くじワンピースメモリーズ２,1188944,0.9109844305504474
0,2017,58,一番くじワンピースメモリーズ２,1190961,0.9125298823096727
0,1659,59,一番くじワンピースメモリーズ２,1192620,0.9138010297903641
66,2130,0,一番くじアラジンディズニープリンセス,2130,0.004314535731648031
261426,32955,1,一番くじアラジンディズニープリンセス,35085,0.0710683033543996
232122,49227,2,一番くじアラジンディズニープリンセス,84312,0.1707826932425863
0,35519,3,一番くじアラジンディズニープリンセス,119831,0.24273010857235455
0,35168,4,一番くじアラジンディズニープリンセス,154999,0.31396653702803434
66,32071,5,一番くじアラジンディズニープリンセス,187070,0.3789296710419705
0,28726,6,一番くじアラジンディズニープリンセス,215796,0.43711716091395236
0,30324,7,一番くじアラジンディズニープリンセス,246120,0.4985415653864852
0,34402,8,一番くじアラジンディズニープリンセス,280522,0.5682263814616756
0,32622,9,一番くじアラジンディズニープリンセス,313144,0.6343056230756765
0,18626,10,一番くじアラジンディズニープリンセス,331770,0.6720345162858532
0,15469,11,一番くじアラジンディズニープリンセス,347239,0.7033685788364933
0,13221,12,一番くじアラジンディズニープリンセス,360460,0.7301490844271593
0,11681,13,一番くじアラジンディズニープリンセス,372141,0.7538101604278075
0,11633,14,一番くじアラジンディズニープリンセス,383774,0.7773740074542214
0,13101,15,一番くじアラジンディズニープリンセス,396875,0.8039114406093015
0,10977,16,一番くじアラジンディズニープリンセス,407852,0.826146491654513
0,5767,17,一番くじアラジンディズニープリンセス,413619,0.8378281477880408
0,5390,18,一番くじアラジンディズニープリンセス,419009,0.8487461513531033
0,4975,19,一番くじアラジンディズニープリンセス,423984,0.8588235294117647
0,4327,20,一番くじアラジンディズニープリンセス,428311,0.8675883163182628
0,4295,21,一番くじアラジンディズニープリンセス,432606,0.8762882839086048
0,5271,22,一番くじアラジンディズニープリンセス,437877,0.8869652406417112
0,4207,23,一番くじアラジンディズニープリンセス,442084,0.8954869551126236
0,2734,24,一番くじアラジンディズニープリンセス,444818,0.9010249554367201
0,2320,25,一番くじアラジンディズニープリンセス,447138,0.9057243558580457
0,2052,26,一番くじアラジンディズニープリンセス,449190,0.909880894506563
0,1804,27,一番くじアラジンディズニープリンセス,450994,0.9135350834548696
0,1874,28,一番くじアラジンディズニープリンセス,452868,0.9173310646572679
0,2519,29,一番くじアラジンディズニープリンセス,455387,0.9224335602009399
0,1960,30,一番くじアラジンディズニープリンセス,457347,0.926403743315508
0,1109,31,一番くじアラジンディズニープリンセス,458456,0.9286501377410469
0,1037,32,一番くじアラジンディズニープリンセス,459493,0.9307506887052341
0,1040,33,一番くじアラジンディズニープリンセス,460533,0.9328573164803111
0,1112,34,一番くじアラジンディズニープリンセス,461645,0.9351097877167396
0,1067,35,一番くじアラジンディズニープリンセス,462712,0.9372711067898234
0,1471,36,一番くじアラジンディズニープリンセス,464183,0.9402507697293794
0,1222,37,一番くじアラジンディズニープリンセス,465405,0.9427260573650948
0,1022,38,一番くじアラジンディズニープリンセス,466427,0.9447962242748339
0,611,39,一番くじアラジンディズニープリンセス,467038,0.9460338680926916
0,626,40,一番くじアラジンディズニープリンセス,467664,0.9473018959649976
0,445,41,一番くじアラジンディズニープリンセス,468109,0.9482032895802949
0,697,42,一番くじアラジンディズニープリンセス,468806,0.9496151353103225
0,801,43,一番くじアラジンディズニープリンセス,469607,0.9512376438178577
0,769,44,一番くじアラジンディズニープリンセス,470376,0.9527953330092368
0,445,45,一番くじアラジンディズニープリンセス,470821,0.9536967266245341
0,381,46,一番くじアラジンディズニープリンセス,471202,0.9544684816075191
0,478,47,一番くじアラジンディズニープリンセス,471680,0.9554367201426025
0,481,48,一番くじアラジンディズニープリンセス,472161,0.9564110354885756
0,401,49,一番くじアラジンディズニープリンセス,472562,0.9572233025441581
0,500,50,一番くじアラジンディズニープリンセス,473062,0.958236104359099
0,363,51,一番くじアラジンディズニープリンセス,473425,0.9589713984767461
0,307,52,一番くじアラジンディズニープリンセス,473732,0.9595932587911198
0,315,53,一番くじアラジンディズニープリンセス,474047,0.9602313239345325
0,280,54,一番くじアラジンディズニープリンセス,474327,0.9607984929508994
0,207,55,一番くじアラジンディズニープリンセス,474534,0.9612177929022849
0,331,56,一番くじアラジンディズニープリンセス,474865,0.9618882677037758
0,332,57,一番くじアラジンディズニープリンセス,475197,0.9625607681088965
0,262,58,一番くじアラジンディズニープリンセス,475459,0.9630914762599254
0,144,59,一番くじアラジンディズニープリンセス,475603,0.9633831631826284
1188,18800,0,一番くじワンピースメモリーズ,18800,0.01041861784842241
891016,186536,1,一番くじワンピースメモリーズ,205336,0.11379347417679064
910740,345534,2,一番くじワンピースメモリーズ,550870,0.30528212841279007
1056,252461,3,一番くじワンピースメモリーズ,803331,0.4451914199356927
66,213008,4,一番くじワンピースメモリーズ,1016339,0.5632365768855204
0,150652,5,一番くじワンピースメモリーズ,1166991,0.6467251734866126
0,86469,6,一番くじワンピースメモリーズ,1253460,0.6946447195895508
66,67559,7,一番くじワンピースメモリーズ,1321019,0.7320846878460172
132,58806,8,一番くじワンピースメモリーズ,1379825,0.7646739028031624
66,48699,9,一番くじワンピースメモリーズ,1428524,0.7916620023031795
132,42256,10,一番くじワンピースメモリーズ,1470780,0.8150795084629103
0,45270,11,一番くじワンピースメモリーズ,1516050,0.8401673185691912
0,36379,12,一番くじワンピースメモリーズ,1552429,0.8603278982876891
0,24964,13,一番くじワンピースメモリーズ,1577393,0.874162492754073
0,21478,14,一番くじワンピースメモリーズ,1598871,0.8860652094640951
0,19111,15,一番くじワンピースメモリーズ,1617982,0.8966561778524569
0,14928,16,一番くじワンピースメモリーズ,1632910,0.9049290037695447
0,12989,17,一番くじワンピースメモリーズ,1645899,0.9121272711755637
0,14489,18,一番くじワンピースメモリーズ,1660388,0.9201568112822548
0,12678,19,一番くじワンピースメモリーズ,1673066,0.9271827281483345
0,7305,20,一番くじワンピースメモリーズ,1680371,0.9312310262006072
0,6889,21,一番くじワンピースメモリーズ,1687260,0.9350487846238934
0,5993,22,一番くじワンピースメモリーズ,1693253,0.9383699961539783
0,5301,23,一番くじワンピースメモリーズ,1698554,0.9413077138781532
0,5463,24,一番くじワンピースメモリーズ,1704017,0.9443352090540006
0,5096,25,一番くじワンピースメモリーズ,1709113,0.9471593195090836
0,4568,26,一番くじワンピースメモリーズ,1713681,0.94969082197353
0,3632,27,一番くじワンピースメモリーズ,1717313,0.9517036102727572
0,3405,28,一番くじワンピースメモリーズ,1720718,0.9535905993032826
0,3186,29,一番くじワンピースメモリーズ,1723904,0.95535622251951
0,2821,30,一番くじワンピースメモリーズ,1726725,0.9569195693785738
0,2700,31,一番くじワンピースメモリーズ,1729425,0.9584158602397834
0,2750,32,一番くじワンピースメモリーズ,1732175,0.9599398601910154
0,2732,33,一番くじワンピースメモリーズ,1734907,0.9614538848698393
0,2526,34,一番くじワンピースメモリーズ,1737433,0.962853748097771
0,2956,35,一番くじワンピースメモリーズ,1740389,0.9644919094998953
0,2343,36,一番くじワンピースメモリーズ,1742732,0.965790357458345
0,1881,37,一番くじワンピースメモリーズ,1744613,0.9668327734249876
0,1826,38,一番くじワンピースメモリーズ,1746439,0.9678447093926057
0,1705,39,一番くじワンピースメモリーズ,1748144,0.9687895893623695
0,1420,40,一番くじワンピースメモリーズ,1749564,0.9695765275190057
0,1261,41,一番くじワンピースメモリーズ,1750825,0.9702753507693705
0,1039,42,一番くじワンピースメモリーズ,1751864,0.970851145660036
0,924,43,一番くじワンピースメモリーズ,1752788,0.97136320964365
0,1069,44,一番くじワンピースメモリーズ,1753857,0.971955629988329
0,856,45,一番くじワンピースメモリーズ,1754713,0.9724300096095124
0,1108,46,一番くじワンピースメモリーズ,1755821,0.9730440430444088
0,1033,47,一番くじワンピースメモリーズ,1756854,0.9736165128442716
0,593,48,一番くじワンピースメモリーズ,1757447,0.9739451426519372
0,482,49,一番くじワンピースメモリーズ,1757929,0.9742122582797532
0,594,50,一番くじワンピースメモリーズ,1758523,0.9745414422692193
0,517,51,一番くじワンピースメモリーズ,1759040,0.9748279542600509
0,545,52,一番くじワンピースメモリーズ,1759585,0.9751299833412951
0,772,53,一番くじワンピースメモリーズ,1760357,0.9755578116912409
0,697,54,一番くじワンピースメモリーズ,1761054,0.9759440764061532
0,464,55,一番くじワンピースメモリーズ,1761518,0.976201216761561
0,507,56,一番くじワンピースメモリーズ,1762025,0.9764821869343882
0,558,57,一番くじワンピースメモリーズ,1762583,0.9767914203790382
0,578,58,一番くじワンピースメモリーズ,1763161,0.9771117374596971
0,495,59,一番くじワンピースメモリーズ,1763656,0.9773860574509189
0,16510,0,一番くじワンピースフルフォース,16510,0.011922299248989023
663200,218627,1,一番くじワンピースフルフォース,235137,0.16979852686308491
721360,225314,2,一番くじワンピースフルフォース,460451,0.3325036106296938
80,163979,3,一番くじワンピースフルフォース,624430,0.45091709994222995
0,138899,4,一番くじワンピースフルフォース,763329,0.5512196707105719
0,97693,5,一番くじワンピースフルフォース,861022,0.621766320046216
0,63360,6,一番くじワンピースフルフォース,924382,0.6675202195262854
0,57436,7,一番くじワンピースフルフォース,981818,0.7089962449451185
0,38162,8,一番くじワンピースフルフォース,1019980,0.7365540150202196
0,36407,9,一番くじワンピースフルフォース,1056387,0.7628444540727903
0,31382,10,一番くじワンピースフルフォース,1087769,0.7855062102830733
0,29196,11,一番くじワンピースフルフォース,1116965,0.806589399191219
0,21572,12,一番くじワンピースフルフォース,1138537,0.8221670999422299
0,14878,13,一番くじワンピースフルフォース,1153415,0.8329108896591566
0,13248,14,一番くじワンピースフルフォース,1166663,0.8424776140958983
0,16079,15,一番くじワンピースフルフォース,1182742,0.8540886770652801
0,9418,16,一番くじワンピースフルフォース,1192160,0.8608896591565569
0,10933,17,一番くじワンピースフルフォース,1203093,0.8687846620450607
0,12930,18,一番くじワンピースフルフォース,1216023,0.8781217504332756
0,9180,19,一番くじワンピースフルフォース,1225203,0.8847508665511266
0,6141,20,一番くじワンピースフルフォース,1231344,0.8891854419410745
0,7128,21,一番くじワンピースフルフォース,1238472,0.8943327556325823
0,14004,22,一番くじワンピースフルフォース,1252476,0.9044454072790294
0,11836,23,一番くじワンピースフルフォース,1264312,0.9129924898902368
0,4863,24,一番くじワンピースフルフォース,1269175,0.9165041883304448
0,6498,25,一番くじワンピースフルフォース,1275673,0.9211965626805315
0,11199,26,一番くじワンピースフルフォース,1286872,0.9292836510687464
0,3317,27,一番くじワンピースフルフォース,1290189,0.9316789428076256
0,3388,28,一番くじワンピースフルフォース,1293577,0.9341255054881571
0,2776,29,一番くじワンピースフルフォース,1296353,0.9361301270941652
0,2926,30,一番くじワンピースフルフォース,1299279,0.9382430675909879
0,2800,31,一番くじワンピースフルフォース,1302079,0.9402650202195263
0,3542,32,一番くじワンピースフルフォース,1305621,0.9428227902946273
0,3062,33,一番くじワンピースフルフォース,1308683,0.9450339399191219
0,2012,34,一番くじワンピースフルフォース,1310695,0.9464868573079145
0,1925,35,一番くじワンピースフルフォース,1312620,0.9478769497400347
0,1799,36,一番くじワンピースフルフォース,1314419,0.9491760543038706
0,1621,37,一番くじワンピースフルフォース,1316040,0.9503466204506066
0,1628,38,一番くじワンピースフルフォース,1317668,0.951522241478914
0,2267,39,一番くじワンピースフルフォース,1319935,0.9531593009820912
0,2396,40,一番くじワンピースフルフォース,1322331,0.9548895147313692
0,1459,41,一番くじワンピースフルフォース,1323790,0.9559430964760254
0,1405,42,一番くじワンピースフルフォース,1325195,0.9569576834199884
0,1295,43,一番くじワンピースフルフォース,1326490,0.9578928365106875
0,1179,44,一番くじワンピースフルフォース,1327669,0.9587442229924898
0,1143,45,一番くじワンピースフルフォース,1328812,0.9595696129404968
0,1807,46,一番くじワンピースフルフォース,1330619,0.9608744945118428
0,1707,47,一番くじワンピースフルフォース,1332326,0.9621071634893126
0,1432,48,一番くじワンピースフルフォース,1333758,0.9631412478336222
0,1152,49,一番くじワンピースフルフォース,1334910,0.963973136915078
0,755,50,一番くじワンピースフルフォース,1335665,0.9645183419988446
0,821,51,一番くじワンピースフルフォース,1336486,0.9651112073945696
0,988,52,一番くじワンピースフルフォース,1337474,0.9658246678220682
0,1042,53,一番くじワンピースフルフォース,1338516,0.96657712305026
0,1192,54,一番くじワンピースフルフォース,1339708,0.9674378971692663
0,801,55,一番くじワンピースフルフォース,1340509,0.9680163200462161
160,762,56,一番くじワンピースフルフォース,1341271,0.968566580011554
0,629,57,一番くじワンピースフルフォース,1341900,0.9690207972270364
0,685,58,一番くじワンピースフルフォース,1342585,0.9695154534950895
0,751,59,一番くじワンピースフルフォース,1343336,0.9700577700751011
0,2751,0,一番くじ仮面ライダーフォーゼ青春まっしぐら,2751,0.0020883150007970667
657000,35981,1,一番くじ仮面ライダーフォーゼ青春まっしぐら,38732,0.029401896259858958
660330,80821,2,一番くじ仮面ライダーフォーゼ青春まっしぐら,119553,0.0907540251873107
0,77423,3,一番くじ仮面ライダーフォーゼ青春まっしぐら,196976,0.14952669414649328
0,57233,4,一番くじ仮面ライダーフォーゼ青春まっしぐら,254209,0.1929729073201096
0,52084,5,一番くじ仮面ライダーフォーゼ青春まっしぐら,306293,0.23251045675722865
0,48210,6,一番くじ仮面ライダーフォーゼ青春まっしぐら,354503,0.2691072092793757
0,44939,7,一番くじ仮面ライダーフォーゼ青春まっしぐら,399442,0.30322090895978987
0,48476,8,一番くじ仮面ライダーフォーゼ青春まっしぐら,447918,0.3400195850698003
0,51618,9,一番くじ仮面ライダーフォーゼ青春まっしぐら,499536,0.37920338867254216
0,48799,10,一番くじ仮面ライダーフォーゼ青春まっしぐら,548335,0.41624725771067234
0,42537,11,一番くじ仮面ライダーフォーゼ青春まっしぐら,590872,0.448537572210456
0,39745,12,一番くじ仮面ライダーフォーゼ青春まっしぐら,630617,0.4787084481489073
0,38714,13,一番くじ仮面ライダーフォーゼ青春まっしぐら,669331,0.50809668040658
0,30456,14,一番くじ仮面ライダーフォーゼ青春まっしぐら,699787,0.5312161721056986
0,25374,15,一番くじ仮面ライダーフォーゼ青春まっしぐら,725161,0.5504778605209021
0,26139,16,一番くじ仮面ライダーフォーゼ青春まっしぐら,751300,0.5703202690290208
0,26066,17,一番くじ仮面ライダーフォーゼ青春まっしぐら,777366,0.5901072624171619
0,18930,18,一番くじ仮面ライダーフォーゼ青春まっしぐら,796296,0.6044772380496914
0,17219,19,一番くじ仮面ライダーフォーゼ青春まっしぐら,813515,0.6175483743632955
0,16485,20,一番くじ仮面ライダーフォーゼ青春まっしぐら,830000,0.6300623230321939
0,15842,21,一番くじ仮面ライダーフォーゼ青春まっしぐら,845842,0.6420881631785506
0,18834,22,一番くじ仮面ライダーフォーゼ青春まっしぐら,864676,0.6563852641327533
0,20893,23,一番くじ仮面ライダーフォーゼ青春まっしぐら,885569,0.6722453751148155
0,18442,24,一番くじ仮面ライダーフォーゼ青春まっしぐら,904011,0.6862449044658514
0,13111,25,一番くじ仮面ライダーフォーゼ青春まっしぐら,917122,0.6961976118360623
0,11349,26,一番くじ仮面ライダーフォーゼ青春まっしぐら,928471,0.7048127652144869
0,11137,27,一番くじ仮面ライダーフォーゼ青春まっしぐら,939608,0.7132669870116068
0,10350,28,一番くじ仮面ライダーフォーゼ青春まっしぐら,949958,0.721123788268695
0,11160,29,一番くじ仮面ライダーフォーゼ青春まっしぐら,961118,0.729595469624164
0,12642,30,一番くじ仮面ライダーフォーゼ青春まっしぐら,973760,0.7391921538263002
0,10971,31,一番くじ仮面ライダーフォーゼ青春まっしぐら,984731,0.7475203631588136
0,7002,32,一番くじ仮面ライダーフォーゼ青春まっしぐら,991733,0.7528356600092612
0,6221,33,一番くじ仮面ライダーフォーゼ青春まっしぐら,997954,0.7575580909870724
0,6350,34,一番くじ仮面ライダーフォーゼ青春まっしぐら,1004304,0.7623784473138849
0,5952,35,一番くじ仮面ライダーフォーゼ青春まっしぐら,1010256,0.766896677370135
0,6443,36,一番くじ仮面ライダーフォーゼ青春まっしぐら,1016699,0.7717876310415765
0,8974,37,一番くじ仮面ライダーフォーゼ青春まっしぐら,1025673,0.7785998952426499
0,8247,38,一番くじ仮面ライダーフォーゼ青春まっしぐら,1033920,0.7848602855776456
0,5357,39,一番くじ仮面ライダーフォーゼ青春まっしぐら,1039277,0.7889268444505173
0,5286,40,一番くじ仮面ライダーフォーゼ青春まっしぐら,1044563,0.7929395064258766
0,5061,41,一番くじ仮面ライダーフォーゼ青春まっしぐら,1049624,0.7967813683739078
0,5092,42,一番くじ仮面ライダーフォーゼ青春まっしぐら,1054716,0.8006467627701487
0,5372,43,一番くじ仮面ライダーフォーゼ青春まっしぐら,1060088,0.8047247083115089
0,6233,44,一番くじ仮面ライダーフォーゼ青春まっしぐら,1066321,0.8094562486241109
0,5255,45,一番くじ仮面ライダーフォーゼ青春まっしぐら,1071576,0.8134453781512605
0,4188,46,一番くじ仮面ライダーフォーゼ青春まっしぐら,1075764,0.8166245359932591
0,2793,47,一番くじ仮面ライダーフォーゼ青春まっしぐら,1078557,0.818744733665824
0,2711,48,一番くじ仮面ライダーフォーゼ青春まっしぐら,1081268,0.8208026842173184
0,2896,49,一番くじ仮面ライダーフォーゼ青春まっしぐら,1084164,0.8230010703468379
0,3144,50,一番くじ仮面ライダーフォーゼ青春まっしぐら,1087308,0.8253877160620345
0,4437,51,一番くじ仮面ライダーフォーゼ青春まっしぐら,1091745,0.8287558926009428
0,3156,52,一番くじ仮面ライダーフォーゼ青春まっしぐら,1094901,0.8311516476509303
0,2382,53,一番くじ仮面ライダーフォーゼ青春まっしぐら,1097283,0.8329598506069095
0,2611,54,一番くじ仮面ライダーフォーゼ青春まっしぐら,1099894,0.8349418900351468
0,2622,55,一番くじ仮面ライダーフォーゼ青春まっしぐら,1102516,0.8369322796869425
0,2377,56,一番くじ仮面ライダーフォーゼ青春まっしぐら,1104893,0.8387366870867589
0,2580,57,一番くじ仮面ライダーフォーゼ青春まっしぐら,1107473,0.8406951940667866
0,3638,58,一番くじ仮面ライダーフォーゼ青春まっしぐら,1111111,0.8434568407308723
0,2907,59,一番くじ仮面ライダーフォーゼ青春まっしぐら,1114018,0.8456635770839501
0,83,0,一番くじＤＸルパン三世２ｎｄ＊,83,0.0015090909090909091
29700,1000,1,一番くじＤＸルパン三世２ｎｄ＊,1083,0.019690909090909092
25300,2401,2,一番くじＤＸルパン三世２ｎｄ＊,3484,0.06334545454545455
0,2261,3,一番くじＤＸルパン三世２ｎｄ＊,5745,0.10445454545454545
0,2380,4,一番くじＤＸルパン三世２ｎｄ＊,8125,0.14772727272727273
0,2864,5,一番くじＤＸルパン三世２ｎｄ＊,10989,0.1998
0,2822,6,一番くじＤＸルパン三世２ｎｄ＊,13811,0.2511090909090909
0,1853,7,一番くじＤＸルパン三世２ｎｄ＊,15664,0.2848
0,1833,8,一番くじＤＸルパン三世２ｎｄ＊,17497,0.3181272727272727
0,1674,9,一番くじＤＸルパン三世２ｎｄ＊,19171,0.34856363636363635
0,1533,10,一番くじＤＸルパン三世２ｎｄ＊,20704,0.3764363636363636
0,1419,11,一番くじＤＸルパン三世２ｎｄ＊,22123,0.4022363636363636
0,1520,12,一番くじＤＸルパン三世２ｎｄ＊,23643,0.4298727272727273
0,1432,13,一番くじＤＸルパン三世２ｎｄ＊,25075,0.45590909090909093
0,1012,14,一番くじＤＸルパン三世２ｎｄ＊,26087,0.4743090909090909
0,1115,15,一番くじＤＸルパン三世２ｎｄ＊,27202,0.4945818181818182
0,1123,16,一番くじＤＸルパン三世２ｎｄ＊,28325,0.515
0,854,17,一番くじＤＸルパン三世２ｎｄ＊,29179,0.5305272727272727
0,870,18,一番くじＤＸルパン三世２ｎｄ＊,30049,0.5463454545454546
0,852,19,一番くじＤＸルパン三世２ｎｄ＊,30901,0.5618363636363637
0,580,20,一番くじＤＸルパン三世２ｎｄ＊,31481,0.5723818181818182
0,500,21,一番くじＤＸルパン三世２ｎｄ＊,31981,0.5814727272727273
0,500,22,一番くじＤＸルパン三世２ｎｄ＊,32481,0.5905636363636364
0,432,23,一番くじＤＸルパン三世２ｎｄ＊,32913,0.5984181818181818
0,465,24,一番くじＤＸルパン三世２ｎｄ＊,33378,0.6068727272727272
0,506,25,一番くじＤＸルパン三世２ｎｄ＊,33884,0.6160727272727273
0,449,26,一番くじＤＸルパン三世２ｎｄ＊,34333,0.6242363636363636
0,563,27,一番くじＤＸルパン三世２ｎｄ＊,34896,0.6344727272727273
0,583,28,一番くじＤＸルパン三世２ｎｄ＊,35479,0.6450727272727272
0,523,29,一番くじＤＸルパン三世２ｎｄ＊,36002,0.6545818181818182
0,331,30,一番くじＤＸルパン三世２ｎｄ＊,36333,0.6606
0,318,31,一番くじＤＸルパン三世２ｎｄ＊,36651,0.6663818181818182
0,323,32,一番くじＤＸルパン三世２ｎｄ＊,36974,0.6722545454545454
0,395,33,一番くじＤＸルパン三世２ｎｄ＊,37369,0.6794363636363636
0,381,34,一番くじＤＸルパン三世２ｎｄ＊,37750,0.6863636363636364
0,286,35,一番くじＤＸルパン三世２ｎｄ＊,38036,0.6915636363636364
0,350,36,一番くじＤＸルパン三世２ｎｄ＊,38386,0.6979272727272727
0,188,37,一番くじＤＸルパン三世２ｎｄ＊,38574,0.7013454545454545
0,267,38,一番くじＤＸルパン三世２ｎｄ＊,38841,0.7062
0,186,39,一番くじＤＸルパン三世２ｎｄ＊,39027,0.7095818181818182
0,177,40,一番くじＤＸルパン三世２ｎｄ＊,39204,0.7128
0,130,41,一番くじＤＸルパン三世２ｎｄ＊,39334,0.7151636363636363
0,118,42,一番くじＤＸルパン三世２ｎｄ＊,39452,0.7173090909090909
0,106,43,一番くじＤＸルパン三世２ｎｄ＊,39558,0.7192363636363637
0,70,44,一番くじＤＸルパン三世２ｎｄ＊,39628,0.7205090909090909
0,50,45,一番くじＤＸルパン三世２ｎｄ＊,39678,0.7214181818181818
0,43,46,一番くじＤＸルパン三世２ｎｄ＊,39721,0.7222
0,36,47,一番くじＤＸルパン三世２ｎｄ＊,39757,0.7228545454545454
0,28,48,一番くじＤＸルパン三世２ｎｄ＊,39785,0.7233636363636363
0,32,49,一番くじＤＸルパン三世２ｎｄ＊,39817,0.7239454545454546
0,9,50,一番くじＤＸルパン三世２ｎｄ＊,39826,0.7241090909090909
0,4,51,一番くじＤＸルパン三世２ｎｄ＊,39830,0.7241818181818181
0,1,52,一番くじＤＸルパン三世２ｎｄ＊,39831,0.7242
0,5,53,一番くじＤＸルパン三世２ｎｄ＊,39836,0.7242909090909091
0,0,54,一番くじＤＸルパン三世２ｎｄ＊,39836,0.7242909090909091
0,0,55,一番くじＤＸルパン三世２ｎｄ＊,39836,0.7242909090909091
0,0,56,一番くじＤＸルパン三世２ｎｄ＊,39836,0.7242909090909091
0,0,57,一番くじＤＸルパン三世２ｎｄ＊,39836,0.7242909090909091
0,0,58,一番くじＤＸルパン三世２ｎｄ＊,39836,0.7242909090909091
0,0,59,一番くじＤＸルパン三世２ｎｄ＊,39836,0.7242909090909091
0,4076,0,一番くじアイドリッシュセブンハッピー,4076,0.01496878442893867
131530,52971,1,一番くじアイドリッシュセブンハッピー,57047,0.20950055086301872
140630,52634,2,一番くじアイドリッシュセブンハッピー,109681,0.4027947117150202
70,22469,3,一番くじアイドリッシュセブンハッピー,132150,0.48531031950055087
70,15502,4,一番くじアイドリッシュセブンハッピー,147652,0.5422401762761659
0,11587,5,一番くじアイドリッシュセブンハッピー,159239,0.5847925082629453
0,7782,6,一番くじアイドリッシュセブンハッピー,167021,0.6133712816746236
0,6198,7,一番くじアイドリッシュセブンハッピー,173219,0.63613294160852
0,8097,8,一番くじアイドリッシュセブンハッピー,181316,0.66586852735953
0,5508,9,一番くじアイドリッシュセブンハッピー,186824,0.6860962174072714
0,3859,10,一番くじアイドリッシュセブンハッピー,190683,0.700268086669115
0,3330,11,一番くじアイドリッシュセブンハッピー,194013,0.7124972456849064
0,3108,12,一番くじアイドリッシュセブンハッピー,197121,0.7239111274329784
0,2374,13,一番くじアイドリッシュセブンハッピー,199495,0.7326294528094014
0,2255,14,一番くじアイドリッシュセブンハッピー,201750,0.7409107601909658
0,2591,15,一番くじアイドリッシュセブンハッピー,204341,0.7504260007344841
0,1938,16,一番くじアイドリッシュセブンハッピー,206279,0.7575431509364672
0,1542,17,一番くじアイドリッシュセブンハッピー,207821,0.7632060227690047
0,1438,18,一番くじアイドリッシュセブンハッピー,209259,0.7684869629085568
0,1690,19,一番くじアイドリッシュセブンハッピー,210949,0.774693352919574
0,1570,20,一番くじアイドリッシュセブンハッピー,212519,0.7804590525156078
0,1333,21,一番くじアイドリッシュセブンハッピー,213852,0.7853543885420492
0,1542,22,一番くじアイドリッシュセブンハッピー,215394,0.7910172603745869
0,1447,23,一番くじアイドリッシュセブンハッピー,216841,0.7963312522952626
0,1422,24,一番くじアイドリッシュセブンハッピー,218263,0.8015534337128167
0,1148,25,一番くじアイドリッシュセブンハッピー,219411,0.8057693720161586
0,948,26,一番くじアイドリッシュセブンハッピー,220359,0.809250826294528
0,974,27,一番くじアイドリッシュセブンハッピー,221333,0.8128277634961439
0,937,28,一番くじアイドリッシュセブンハッピー,222270,0.8162688211531399
0,812,29,一番くじアイドリッシュセブンハッピー,223082,0.8192508262945281
0,968,30,一番くじアイドリッシュセブンハッピー,224050,0.8228057289753948
0,767,31,一番くじアイドリッシュセブンハッピー,224817,0.8256224752111642
0,608,32,一番くじアイドリッシュセブンハッピー,225425,0.8278553066470804
0,699,33,一番くじアイドリッシュセブンハッピー,226124,0.8304223283143591
0,719,34,一番くじアイドリッシュセブンハッピー,226843,0.8330627983841351
0,690,35,一番くじアイドリッシュセブンハッピー,227533,0.8355967682702902
0,785,36,一番くじアイドリッシュセブンハッピー,228318,0.8384796180683071
0,830,37,一番くじアイドリッシュセブンハッピー,229148,0.8415277267719428
0,925,38,一番くじアイドリッシュセブンハッピー,230073,0.8449247153874403
0,653,39,一番くじアイドリッシュセブンハッピー,230726,0.8473228057289754
0,661,40,一番くじアイドリッシュセブンハッピー,231387,0.8497502754315094
0,630,41,一番くじアイドリッシュセブンハッピー,232017,0.8520639001101726
0,755,42,一番くじアイドリッシュセブンハッピー,232772,0.8548365773044436
0,628,43,一番くじアイドリッシュセブンハッピー,233400,0.8571428571428571
0,527,44,一番くじアイドリッシュセブンハッピー,233927,0.8590782225486596
0,518,45,一番くじアイドリッシュセブンハッピー,234445,0.8609805361733383
0,553,46,一番くじアイドリッシュセブンハッピー,234998,0.8630113845023871
0,481,47,一番くじアイドリッシュセブンハッピー,235479,0.8647778185824458
0,387,48,一番くじアイドリッシュセブンハッピー,235866,0.8661990451707675
0,410,49,一番くじアイドリッシュセブンハッピー,236276,0.8677047374219611
0,870,50,一番くじアイドリッシュセブンハッピー,237146,0.8708997429305912
0,988,51,一番くじアイドリッシュセブンハッピー,238134,0.8745280940139551
0,522,52,一番くじアイドリッシュセブンハッピー,238656,0.8764450973191333
0,488,53,一番くじアイドリッシュセブンハッピー,239144,0.8782372383400661
0,342,54,一番くじアイドリッシュセブンハッピー,239486,0.879493206022769
0,479,55,一番くじアイドリッシュセブンハッピー,239965,0.8812522952625781
0,357,56,一番くじアイドリッシュセブンハッピー,240322,0.8825633492471538
0,357,57,一番くじアイドリッシュセブンハッピー,240679,0.8838744032317297
0,452,58,一番くじアイドリッシュセブンハッピー,241131,0.8855343371281674
0,478,59,一番くじアイドリッシュセブンハッピー,241609,0.8872897539478516
0,10,0,とるパカ！傘マーカー刀剣乱舞オンライン壱●,10,0.03571428571428571
196,60,1,とるパカ！傘マーカー刀剣乱舞オンライン壱●,70,0.25
84,16,2,とるパカ！傘マーカー刀剣乱舞オンライン壱●,86,0.30714285714285716
0,30,3,とるパカ！傘マーカー刀剣乱舞オンライン壱●,116,0.4142857142857143
0,41,4,とるパカ！傘マーカー刀剣乱舞オンライン壱●,157,0.5607142857142857
0,5,5,とるパカ！傘マーカー刀剣乱舞オンライン壱●,162,0.5785714285714286
0,12,6,とるパカ！傘マーカー刀剣乱舞オンライン壱●,174,0.6214285714285714
0,7,7,とるパカ！傘マーカー刀剣乱舞オンライン壱●,181,0.6464285714285715
0,12,8,とるパカ！傘マーカー刀剣乱舞オンライン壱●,193,0.6892857142857143
0,13,9,とるパカ！傘マーカー刀剣乱舞オンライン壱●,206,0.7357142857142858
0,10,10,とるパカ！傘マーカー刀剣乱舞オンライン壱●,216,0.7714285714285715
0,8,11,とるパカ！傘マーカー刀剣乱舞オンライン壱●,224,0.8
0,0,12,とるパカ！傘マーカー刀剣乱舞オンライン壱●,224,0.8
0,0,13,とるパカ！傘マーカー刀剣乱舞オンライン壱●,224,0.8
0,2,14,とるパカ！傘マーカー刀剣乱舞オンライン壱●,226,0.8071428571428572
0,0,15,とるパカ！傘マーカー刀剣乱舞オンライン壱●,226,0.8071428571428572
0,1,16,とるパカ！傘マーカー刀剣乱舞オンライン壱●,227,0.8107142857142857
0,1,17,とるパカ！傘マーカー刀剣乱舞オンライン壱●,228,0.8142857142857143
0,8,18,とるパカ！傘マーカー刀剣乱舞オンライン壱●,236,0.8428571428571429
0,0,19,とるパカ！傘マーカー刀剣乱舞オンライン壱●,236,0.8428571428571429
0,1,20,とるパカ！傘マーカー刀剣乱舞オンライン壱●,237,0.8464285714285714
0,2,21,とるパカ！傘マーカー刀剣乱舞オンライン壱●,239,0.8535714285714285
0,0,22,とるパカ！傘マーカー刀剣乱舞オンライン壱●,239,0.8535714285714285
0,0,23,とるパカ！傘マーカー刀剣乱舞オンライン壱●,239,0.8535714285714285
0,0,24,とるパカ！傘マーカー刀剣乱舞オンライン壱●,239,0.8535714285714285
0,0,25,とるパカ！傘マーカー刀剣乱舞オンライン壱●,239,0.8535714285714285
0,0,26,とるパカ！傘マーカー刀剣乱舞オンライン壱●,239,0.8535714285714285
0,0,27,とるパカ！傘マーカー刀剣乱舞オンライン壱●,239,0.8535714285714285
0,0,28,とるパカ！傘マーカー刀剣乱舞オンライン壱●,239,0.8535714285714285
0,0,29,とるパカ！傘マーカー刀剣乱舞オンライン壱●,239,0.8535714285714285
0,0,30,とるパカ！傘マーカー刀剣乱舞オンライン壱●,239,0.8535714285714285
0,0,31,とるパカ！傘マーカー刀剣乱舞オンライン壱●,239,0.8535714285714285
0,0,32,とるパカ！傘マーカー刀剣乱舞オンライン壱●,239,0.8535714285714285
0,0,33,とるパカ！傘マーカー刀剣乱舞オンライン壱●,239,0.8535714285714285
0,0,34,とるパカ！傘マーカー刀剣乱舞オンライン壱●,239,0.8535714285714285
0,0,35,とるパカ！傘マーカー刀剣乱舞オンライン壱●,239,0.8535714285714285
0,0,36,とるパカ！傘マーカー刀剣乱舞オンライン壱●,239,0.8535714285714285
0,4,37,とるパカ！傘マーカー刀剣乱舞オンライン壱●,243,0.8678571428571429
0,0,38,とるパカ！傘マーカー刀剣乱舞オンライン壱●,243,0.8678571428571429
0,0,39,とるパカ！傘マーカー刀剣乱舞オンライン壱●,243,0.8678571428571429
0,0,40,とるパカ！傘マーカー刀剣乱舞オンライン壱●,243,0.8678571428571429
0,0,41,とるパカ！傘マーカー刀剣乱舞オンライン壱●,243,0.8678571428571429
0,0,42,とるパカ！傘マーカー刀剣乱舞オンライン壱●,243,0.8678571428571429
0,0,43,とるパカ！傘マーカー刀剣乱舞オンライン壱●,243,0.8678571428571429
0,0,44,とるパカ！傘マーカー刀剣乱舞オンライン壱●,243,0.8678571428571429
0,0,45,とるパカ！傘マーカー刀剣乱舞オンライン壱●,243,0.8678571428571429
0,0,46,とるパカ！傘マーカー刀剣乱舞オンライン壱●,243,0.8678571428571429
0,16,47,とるパカ！傘マーカー刀剣乱舞オンライン壱●,259,0.925
0,0,48,とるパカ！傘マーカー刀剣乱舞オンライン壱●,259,0.925
0,0,49,とるパカ！傘マーカー刀剣乱舞オンライン壱●,259,0.925
0,0,50,とるパカ！傘マーカー刀剣乱舞オンライン壱●,259,0.925
0,0,51,とるパカ！傘マーカー刀剣乱舞オンライン壱●,259,0.925
0,0,52,とるパカ！傘マーカー刀剣乱舞オンライン壱●,259,0.925
0,1,53,とるパカ！傘マーカー刀剣乱舞オンライン壱●,260,0.9285714285714286
0,4,54,とるパカ！傘マーカー刀剣乱舞オンライン壱●,264,0.9428571428571428
0,2,55,とるパカ！傘マーカー刀剣乱舞オンライン壱●,266,0.95
0,2,56,とるパカ！傘マーカー刀剣乱舞オンライン壱●,268,0.9571428571428572
0,4,57,とるパカ！傘マーカー刀剣乱舞オンライン壱●,272,0.9714285714285714
0,0,58,とるパカ！傘マーカー刀剣乱舞オンライン壱●,272,0.9714285714285714
0,6,59,とるパカ！傘マーカー刀剣乱舞オンライン壱●,278,0.9928571428571429
0,2201,0,一番くじディズニープリンセスアリエル,2201,0.003527198369251676
305941,38926,1,一番くじディズニープリンセスアリエル,41127,0.0659078088742452
318007,74298,2,一番くじディズニープリンセスアリエル,115425,0.18497359008217842
0,60189,3,一番くじディズニープリンセスアリエル,175614,0.28142908424250973
0,64557,4,一番くじディズニープリンセスアリエル,240171,0.3848844886604018
0,53360,5,一番くじディズニープリンセスアリエル,293531,0.4703962128690658
0,27721,6,一番くじディズニープリンセスアリエル,321252,0.5148203228163741
0,23712,7,一番くじディズニープリンセスアリエル,344964,0.5528198356431328
0,24709,8,一番くじディズニープリンセスアリエル,369673,0.5924170843963539
0,21476,9,一番くじディズニープリンセスアリエル,391149,0.6268333098293611
0,18240,10,一番くじディズニープリンセスアリエル,409389,0.6560637043114832
0,22793,11,一番くじディズニープリンセスアリエル,432182,0.6925904796092358
0,18731,12,一番くじディズニープリンセスアリエル,450913,0.7226077229779105
0,10189,13,一番くじディズニープリンセスアリエル,461102,0.7389360392815477
0,10425,14,一番くじディズニープリンセスアリエル,471527,0.7556425558646684
60,9020,15,一番くじディズニープリンセスアリエル,480547,0.770097498750016
0,8007,16,一番くじディズニープリンセスアリエル,488554,0.782929065011987
0,8791,17,一番くじディズニープリンセスアリエル,497345,0.797017025422751
0,10950,18,一番くじディズニープリンセスアリエル,508295,0.814564877373367
0,9017,19,一番くじディズニープリンセスアリエル,517312,0.8290150126280432
0,5111,20,一番くじディズニープリンセスアリエル,522423,0.8372056127485545
0,4711,21,一番くじディズニープリンセスアリエル,527134,0.8447551954462122
0,5751,22,一番くじディズニープリンセスアリエル,532885,0.8539714234432891
0,3665,23,一番くじディズニープリンセスアリエル,536550,0.8598447455801849
0,3740,24,一番くじディズニープリンセスアリエル,540290,0.8658382584838656
0,4885,25,一番くじディズニープリンセスアリエル,545175,0.8736666837604646
0,5063,26,一番くじディズニープリンセスアリエル,550238,0.8817803617902334
0,4385,27,一番くじディズニープリンセスアリエル,554623,0.8888075152882655
0,3859,28,一番くじディズニープリンセスアリエル,558482,0.8949917308752452
0,3031,29,一番くじディズニープリンセスアリエル,561513,0.899849040396918
0,2124,30,一番くじディズニープリンセスアリエル,563637,0.9032528429122704
0,2072,31,一番くじディズニープリンセスアリエル,565709,0.9065733131626518
0,2712,32,一番くじディズニープリンセスアリエル,568421,0.9109194112895989
0,2593,33,一番くじディズニープリンセスアリエル,571014,0.915074806733247
0,1541,34,一番くじディズニープリンセスアリエル,572555,0.9175443263547903
0,1210,35,一番くじディズニープリンセスアリエル,573765,0.9194834040589224
0,1286,36,一番くじディズニープリンセスアリエル,575051,0.9215442750733965
0,1204,37,一番くじディズニープリンセスアリエル,576255,0.9234737375161857
0,1491,38,一番くじディズニープリンセスアリエル,577746,0.9258631299598723
0,1748,39,一番くじディズニープリンセスアリエル,579494,0.9286643760977423
0,1700,40,一番くじディズニープリンセスアリエル,581194,0.93138870014487
0,942,41,一番くじディズニープリンセスアリエル,582136,0.9328982961756901
0,852,42,一番くじディズニープリンセスアリエル,582988,0.9342636632863681
0,983,43,一番くじディズニープリンセスアリエル,583971,0.9358389636030308
0,876,44,一番くじディズニープリンセスアリエル,584847,0.93724279175908
0,933,45,一番くじディズニープリンセスアリエル,585780,0.938737964897886
0,1129,46,一番くじディズニープリンセスアリエル,586909,0.94054723657389
0,884,47,一番くじディズニープリンセスアリエル,587793,0.9419638850783965
0,841,48,一番くじディズニープリンセスアリエル,588634,0.9433116242099461
0,569,49,一番くじディズニープリンセスアリエル,589203,0.9442234714939552
0,643,50,一番くじディズニープリンセスアリエル,589846,0.9452539070011923
0,487,51,一番くじディズニープリンセスアリエル,590333,0.9460343457135165
0,492,52,一番くじディズニープリンセスアリエル,590825,0.9468227971436264
0,724,53,一番くじディズニープリンセスアリエル,591549,0.9479830386789913
0,650,54,一番くじディズニープリンセスアリエル,592199,0.9490246919911283
0,465,55,一番くじディズニープリンセスアリエル,592664,0.9497698747451956
0,369,56,一番くじディズニープリンセスアリエル,593033,0.950361213317778
0,364,57,一番くじディズニープリンセスアリエル,593397,0.9509445391725747
0,395,58,一番くじディズニープリンセスアリエル,593792,0.9515775438776426
0,399,59,一番くじディズニープリンセスアリエル,594191,0.952216958756939
0,370,0,＃一番くじ呪術廻戦nan,370,0.11212121212121212
2772,2273,1,＃一番くじ呪術廻戦nan,2643,0.8009090909090909
528,518,2,＃一番くじ呪術廻戦nan,3161,0.9578787878787879
0,127,3,＃一番くじ呪術廻戦nan,3288,0.9963636363636363
0,7,4,＃一番くじ呪術廻戦nan,3295,0.9984848484848485
0,0,5,＃一番くじ呪術廻戦nan,3295,0.9984848484848485
0,0,6,＃一番くじ呪術廻戦nan,3295,0.9984848484848485
0,0,7,＃一番くじ呪術廻戦nan,3295,0.9984848484848485
0,0,8,＃一番くじ呪術廻戦nan,3295,0.9984848484848485
0,0,9,＃一番くじ呪術廻戦nan,3295,0.9984848484848485
0,0,10,＃一番くじ呪術廻戦nan,3295,0.9984848484848485
0,0,11,＃一番くじ呪術廻戦nan,3295,0.9984848484848485
0,0,12,＃一番くじ呪術廻戦nan,3295,0.9984848484848485
0,0,13,＃一番くじ呪術廻戦nan,3295,0.9984848484848485
0,0,14,＃一番くじ呪術廻戦nan,3295,0.9984848484848485
0,0,15,＃一番くじ呪術廻戦nan,3295,0.9984848484848485
0,0,16,＃一番くじ呪術廻戦nan,3295,0.9984848484848485
0,0,17,＃一番くじ呪術廻戦nan,3295,0.9984848484848485
0,0,18,＃一番くじ呪術廻戦nan,3295,0.9984848484848485
0,0,19,＃一番くじ呪術廻戦nan,3295,0.9984848484848485
0,0,20,＃一番くじ呪術廻戦nan,3295,0.9984848484848485
0,0,21,＃一番くじ呪術廻戦nan,3295,0.9984848484848485
0,0,22,＃一番くじ呪術廻戦nan,3295,0.9984848484848485
0,0,23,＃一番くじ呪術廻戦nan,3295,0.9984848484848485
0,0,24,＃一番くじ呪術廻戦nan,3295,0.9984848484848485
0,0,25,＃一番くじ呪術廻戦nan,3295,0.9984848484848485
0,0,26,＃一番くじ呪術廻戦nan,3295,0.9984848484848485
0,0,27,＃一番くじ呪術廻戦nan,3295,0.9984848484848485
0,0,28,＃一番くじ呪術廻戦nan,3295,0.9984848484848485
0,0,29,＃一番くじ呪術廻戦nan,3295,0.9984848484848485
0,0,30,＃一番くじ呪術廻戦nan,3295,0.9984848484848485
0,0,31,＃一番くじ呪術廻戦nan,3295,0.9984848484848485
0,0,32,＃一番くじ呪術廻戦nan,3295,0.9984848484848485
0,0,33,＃一番くじ呪術廻戦nan,3295,0.9984848484848485
0,0,34,＃一番くじ呪術廻戦nan,3295,0.9984848484848485
0,0,35,＃一番くじ呪術廻戦nan,3295,0.9984848484848485
0,0,36,＃一番くじ呪術廻戦nan,3295,0.9984848484848485
0,0,37,＃一番くじ呪術廻戦nan,3295,0.9984848484848485
0,0,38,＃一番くじ呪術廻戦nan,3295,0.9984848484848485
0,0,39,＃一番くじ呪術廻戦nan,3295,0.9984848484848485
0,0,40,＃一番くじ呪術廻戦nan,3295,0.9984848484848485
0,0,41,＃一番くじ呪術廻戦nan,3295,0.9984848484848485
0,0,42,＃一番くじ呪術廻戦nan,3295,0.9984848484848485
0,0,43,＃一番くじ呪術廻戦nan,3295,0.9984848484848485
0,0,44,＃一番くじ呪術廻戦nan,3295,0.9984848484848485
0,0,45,＃一番くじ呪術廻戦nan,3295,0.9984848484848485
0,0,46,＃一番くじ呪術廻戦nan,3295,0.9984848484848485
0,0,47,＃一番くじ呪術廻戦nan,3295,0.9984848484848485
0,0,48,＃一番くじ呪術廻戦nan,3295,0.9984848484848485
0,0,49,＃一番くじ呪術廻戦nan,3295,0.9984848484848485
0,0,50,＃一番くじ呪術廻戦nan,3295,0.9984848484848485
0,0,51,＃一番くじ呪術廻戦nan,3295,0.9984848484848485
0,0,52,＃一番くじ呪術廻戦nan,3295,0.9984848484848485
0,0,53,＃一番くじ呪術廻戦nan,3295,0.9984848484848485
0,0,54,＃一番くじ呪術廻戦nan,3295,0.9984848484848485
0,0,55,＃一番くじ呪術廻戦nan,3295,0.9984848484848485
0,0,56,＃一番くじ呪術廻戦nan,3295,0.9984848484848485
0,0,57,＃一番くじ呪術廻戦nan,3295,0.9984848484848485
0,0,58,＃一番くじ呪術廻戦nan,3295,0.9984848484848485
0,0,59,＃一番くじ呪術廻戦nan,3295,0.9984848484848485
5589,6343,0,一番くじラブライブサンシャイン５周年記念,6343,0.011468752486131904
286578,68056,1,一番くじラブライブサンシャイン５周年記念,74399,0.13452052912119306
260901,60126,2,一番くじラブライブサンシャイン５周年記念,134525,0.2432341050286764
0,28169,3,一番くじラブライブサンシャイン５周年記念,162694,0.2941663592903585
0,20357,4,一番くじラブライブサンシャイン５周年記念,183051,0.3309737681442427
0,14933,5,一番くじラブライブサンシャイン５周年記念,197984,0.35797406467197523
0,13394,6,一番くじラブライブサンシャイン５周年記念,211378,0.3821917015629181
0,15902,7,一番くじラブライブサンシャイン５周年記念,227280,0.41094404304714793
0,14958,8,一番くじラブライブサンシャイン５周年記念,242238,0.43798954197313894
0,11707,9,一番くじラブライブサンシャイン５周年記念,253945,0.45915692102960215
0,8736,10,一番くじラブライブサンシャイン５周年記念,262681,0.4749524470770321
0,6970,11,一番くじラブライブサンシャイン５周年記念,269651,0.48755487571148576
0,6915,12,一番くじラブライブサンシャイン５周年記念,276566,0.5000578590697708
0,6208,13,一番くじラブライブサンシャイン５周年記念,282774,0.5112825186053072
0,7697,14,一番くじラブライブサンシャイン５周年記念,290471,0.5251994329811163
0,8210,15,一番くじラブライブサンシャイン５周年記念,298681,0.5400439005691886
0,6873,16,一番くじラブライブサンシャイン５周年記念,305554,0.5524709438983995
0,6949,17,一番くじラブライブサンシャイン５周年記念,312503,0.565035402518316
0,6888,18,一番くじラブライブサンシャイン５周年記念,319391,0.5774895672864819
0,5115,19,一番くじラブライブサンシャイン５周年記念,324506,0.5867379779701591
0,4504,20,一番くじラブライブサンシャイン５周年記念,329010,0.5948816420404001
0,4782,21,一番くじラブライブサンシャイン５周年記念,333792,0.6035279567792748
0,5437,22,一番くじラブライブサンシャイン５周年記念,339229,0.6133585743525208
0,4660,23,一番くじラブライブサンシャイン５周年記念,343889,0.6217843013878944
0,4042,24,一番くじラブライブサンシャイン５周年記念,347931,0.6290926251383193
0,4189,25,一番くじラブライブサンシャイン５周年記念,352120,0.6366667389905039
0,3405,26,一番くじラブライブサンシャイン５周年記念,355525,0.6428233056333037
0,3672,27,一番くじラブライブサンシャイン５周年記念,359197,0.6494626338895036
0,4549,28,一番くじラブライブサンシャイン５周年記念,363746,0.6576876622766098
0,5082,29,一番くじラブライブサンシャイン５周年記念,368828,0.6668764057945858
0,4438,30,一番くじラブライブサンシャイン５周年記念,373266,0.6749007355334244
0,3443,31,一番くじラブライブサンシャイン５周年記念,376709,0.6811260098215771
0,2971,32,一番くじラブライブサンシャイン５周年記念,379680,0.6864978628306103
0,3093,33,一番くじラブライブサンシャイン５周年記念,382773,0.6920903035431448
0,2792,34,一番くじラブライブサンシャイン５周年記念,385565,0.6971385073806476
0,3233,35,一番くじラブライブサンシャイン５周年記念,388798,0.7029840815234293
0,3816,36,一番くじラブライブサンシャイン５周年記念,392614,0.7098837755935979
0,3272,37,一番くじラブライブサンシャイン５周年記念,395886,0.7157998654776628
0,2462,38,一番くじラブライブサンシャイン５周年記念,398348,0.7202513976581542
0,2977,39,一番くじラブライブサンシャイン５周年記念,401325,0.7256340992427694
0,2512,40,一番くじラブライブサンシャイン５周年記念,403837,0.7301760362197777
0,2037,41,一番くじラブライブサンシャイン５周年記念,405874,0.7338591276298755
0,2487,42,一番くじラブライブサンシャイン５周年記念,408361,0.7383558622086254
0,2825,43,一番くじラブライブサンシャイン５周年記念,411186,0.7434637332118292
0,2505,44,一番くじラブライブサンシャイン５周年記念,413691,0.7479930135173252
0,1861,45,一番くじラブライブサンシャイン５周年記念,415552,0.7513578800436836
0,1979,46,一番くじラブライブサンシャイン５周年記念,417531,0.7549361018898219
0,1314,47,一番くじラブライブサンシャイン５周年記念,418845,0.7573119399422856
0,1256,48,一番くじラブライブサンシャイン５周年記念,420101,0.7595829084307897
0,1668,49,一番くじラブライブサンシャイン５周年記念,421769,0.762598812442593
0,1621,50,一番くじラブライブサンシャイン５周年記念,423390,0.7655297359456703
0,1597,51,一番くじラブライブサンシャイン５周年記念,424987,0.7684172651464196
0,1170,52,一番くじラブライブサンシャイン５周年記念,426157,0.7705327373849147
0,1030,53,一番くじラブライブサンシャイン５周年記念,427187,0.7723950761931625
0,972,54,一番くじラブライブサンシャイン５周年記念,428159,0.7741525454374507
0,1158,55,一番くじラブライブサンシャイン５周年記念,429317,0.7762463205247817
0,1044,56,一番くじラブライブサンシャイン５周年記念,430361,0.7781339726760543
0,1313,57,一番くじラブライブサンシャイン５周年記念,431674,0.7805080026325877
0,1114,58,一番くじラブライブサンシャイン５周年記念,432788,0.7825222214989839
0,787,59,一番くじラブライブサンシャイン５周年記念,433575,0.7839451929961596
0,1510,0,一番くじソードアート・オンライン,1510,0.003909486329743165
185360,25639,1,一番くじソードアート・オンライン,27149,0.07029049295774648
200800,40565,2,一番くじソードアート・オンライン,67714,0.1753158657829329
0,34259,3,一番くじソードアート・オンライン,101973,0.2640146023198012
0,31409,4,一番くじソードアート・オンライン,133382,0.34533450704225355
0,25746,5,一番くじソードアート・オンライン,159128,0.41199254349627173
0,20282,6,一番くじソードアート・オンライン,179410,0.4645039353769677
0,15904,7,一番くじソードアート・オンライン,195314,0.505680405965203
0,14413,8,一番くじソードアート・オンライン,209727,0.5429965824357912
0,12383,9,一番くじソードアート・オンライン,222110,0.5750569594034797
0,12938,10,一番くじソードアート・オンライン,235048,0.6085542667771334
0,14054,11,一番くじソードアート・オンライン,249102,0.6449409693454847
0,10997,12,一番くじソードアート・オンライン,260099,0.6734129038939519
0,7255,13,一番くじソードアート・オンライン,267354,0.6921965617232808
0,6323,14,一番くじソードアート・オンライン,273677,0.7085672120961061
0,6362,15,一番くじソードアート・オンライン,280039,0.725038835956918
0,4703,16,一番くじソードアート・オンライン,284742,0.7372152029826015
0,4949,17,一番くじソードアート・オンライン,289691,0.7500284797017398
0,5309,18,一番くじソードアート・オンライン,295000,0.7637738193869097
0,4454,19,一番くじソードアート・オンライン,299454,0.7753055095277548
0,3599,20,一番くじソードアート・オンライン,303053,0.7846235501242751
0,3101,21,一番くじソードアート・オンライン,306154,0.7926522369511185
0,2811,22,一番くじソードアート・オンライン,308965,0.7999300952775477
0,2732,23,一番くじソードアート・オンライン,311697,0.8070034175642088
80,2884,24,一番くじソードアート・オンライン,314581,0.8144702775476388
0,3446,25,一番くじソードアート・オンライン,318027,0.8233921913835957
0,3156,26,一番くじソードアート・オンライン,321183,0.8315632767191383
0,2151,27,一番くじソードアート・オンライン,323334,0.8371323529411765
0,2065,28,一番くじソードアート・オンライン,325399,0.8424787696768848
0,1834,29,一番くじソードアート・オンライン,327233,0.8472271126760563
0,1857,30,一番くじソードアート・オンライン,329090,0.8520350041425021
0,1786,31,一番くじソードアート・オンライン,330876,0.8566590720795361
0,1962,32,一番くじソードアート・オンライン,332838,0.8617388152444077
0,1685,33,一番くじソードアート・オンライン,334523,0.8661013877381939
0,1335,34,一番くじソードアート・オンライン,335858,0.8695577879038939
0,1693,35,一番くじソードアート・オンライン,337551,0.8739410729080365
0,1148,36,一番くじソードアート・オンライン,338699,0.8769133181441591
0,1440,37,一番くじソードアート・オンライン,340139,0.880641570008285
0,1220,38,一番くじソードアート・オンライン,341359,0.8838002278376139
0,1288,39,一番くじソードアート・オンライン,342647,0.887134942004971
0,948,40,一番くじソードアート・オンライン,343595,0.8895893744821872
0,1332,41,一番くじソードアート・オンライン,344927,0.8930380074565037
0,1515,42,一番くじソードアート・オンライン,346442,0.8969604391052195
0,1049,43,一番くじソードアート・オンライン,347491,0.8996763670256835
0,878,44,一番くじソードアート・オンライン,348369,0.9019495650372825
0,890,45,一番くじソードアート・オンライン,349259,0.9042538318144159
0,891,46,一番くじソードアート・オンライン,350150,0.9065606876553438
0,806,47,一番くじソードアート・オンライン,350956,0.9086474730737365
0,566,48,一番くじソードアート・オンライン,351522,0.9101128831814416
0,604,49,一番くじソードアート・オンライン,352126,0.9116766777133388
0,661,50,一番くじソードアート・オンライン,352787,0.9133880488815245
0,574,51,一番くじソードアート・オンライン,353361,0.9148741714995857
0,595,52,一番くじソードアート・オンライン,353956,0.9164146644573322
0,549,53,一番くじソードアート・オンライン,354505,0.9178360604805302
0,636,54,一番くじソードアート・オンライン,355141,0.9194827050538525
0,483,55,一番くじソードアート・オンライン,355624,0.9207332228666114
0,357,56,一番くじソードアート・オンライン,355981,0.9216575186412593
0,351,57,一番くじソードアート・オンライン,356332,0.92256628003314
0,475,58,一番くじソードアート・オンライン,356807,0.9237960853355427
0,428,59,一番くじソードアート・オンライン,357235,0.9249042046396023
165,0,0,とるパカ！ワンピース缶バッジセット●,0,0.0
108,2,1,とるパカ！ワンピース缶バッジセット●,2,0.006600660066006601
27,3,2,とるパカ！ワンピース缶バッジセット●,5,0.0165016501650165
0,2,3,とるパカ！ワンピース缶バッジセット●,7,0.0231023102310231
0,3,4,とるパカ！ワンピース缶バッジセット●,10,0.033003300330033
0,2,5,とるパカ！ワンピース缶バッジセット●,12,0.039603960396039604
0,1,6,とるパカ！ワンピース缶バッジセット●,13,0.0429042904290429
0,4,7,とるパカ！ワンピース缶バッジセット●,17,0.056105610561056105
0,0,8,とるパカ！ワンピース缶バッジセット●,17,0.056105610561056105
0,0,9,とるパカ！ワンピース缶バッジセット●,17,0.056105610561056105
3,0,10,とるパカ！ワンピース缶バッジセット●,17,0.056105610561056105
0,0,11,とるパカ！ワンピース缶バッジセット●,17,0.056105610561056105
0,1,12,とるパカ！ワンピース缶バッジセット●,18,0.0594059405940594
0,0,13,とるパカ！ワンピース缶バッジセット●,18,0.0594059405940594
0,0,14,とるパカ！ワンピース缶バッジセット●,18,0.0594059405940594
0,1,15,とるパカ！ワンピース缶バッジセット●,19,0.0627062706270627
0,0,16,とるパカ！ワンピース缶バッジセット●,19,0.0627062706270627
0,1,17,とるパカ！ワンピース缶バッジセット●,20,0.066006600660066
0,0,18,とるパカ！ワンピース缶バッジセット●,20,0.066006600660066
0,0,19,とるパカ！ワンピース缶バッジセット●,20,0.066006600660066
0,1,20,とるパカ！ワンピース缶バッジセット●,21,0.06930693069306931
0,0,21,とるパカ！ワンピース缶バッジセット●,21,0.06930693069306931
0,0,22,とるパカ！ワンピース缶バッジセット●,21,0.06930693069306931
0,0,23,とるパカ！ワンピース缶バッジセット●,21,0.06930693069306931
0,0,24,とるパカ！ワンピース缶バッジセット●,21,0.06930693069306931
0,1,25,とるパカ！ワンピース缶バッジセット●,22,0.07260726072607261
0,0,26,とるパカ！ワンピース缶バッジセット●,22,0.07260726072607261
0,0,27,とるパカ！ワンピース缶バッジセット●,22,0.07260726072607261
0,0,28,とるパカ！ワンピース缶バッジセット●,22,0.07260726072607261
0,0,29,とるパカ！ワンピース缶バッジセット●,22,0.07260726072607261
0,1,30,とるパカ！ワンピース缶バッジセット●,23,0.07590759075907591
0,0,31,とるパカ！ワンピース缶バッジセット●,23,0.07590759075907591
0,0,32,とるパカ！ワンピース缶バッジセット●,23,0.07590759075907591
0,0,33,とるパカ！ワンピース缶バッジセット●,23,0.07590759075907591
0,0,34,とるパカ！ワンピース缶バッジセット●,23,0.07590759075907591
0,0,35,とるパカ！ワンピース缶バッジセット●,23,0.07590759075907591
0,0,36,とるパカ！ワンピース缶バッジセット●,23,0.07590759075907591
0,0,37,とるパカ！ワンピース缶バッジセット●,23,0.07590759075907591
0,0,38,とるパカ！ワンピース缶バッジセット●,23,0.07590759075907591
0,0,39,とるパカ！ワンピース缶バッジセット●,23,0.07590759075907591
0,0,40,とるパカ！ワンピース缶バッジセット●,23,0.07590759075907591
0,0,41,とるパカ！ワンピース缶バッジセット●,23,0.07590759075907591
0,0,42,とるパカ！ワンピース缶バッジセット●,23,0.07590759075907591
0,0,43,とるパカ！ワンピース缶バッジセット●,23,0.07590759075907591
0,0,44,とるパカ！ワンピース缶バッジセット●,23,0.07590759075907591
0,0,45,とるパカ！ワンピース缶バッジセット●,23,0.07590759075907591
0,0,46,とるパカ！ワンピース缶バッジセット●,23,0.07590759075907591
0,0,47,とるパカ！ワンピース缶バッジセット●,23,0.07590759075907591
0,1,48,とるパカ！ワンピース缶バッジセット●,24,0.07920792079207921
0,0,49,とるパカ！ワンピース缶バッジセット●,24,0.07920792079207921
0,0,50,とるパカ！ワンピース缶バッジセット●,24,0.07920792079207921
0,0,51,とるパカ！ワンピース缶バッジセット●,24,0.07920792079207921
0,2,52,とるパカ！ワンピース缶バッジセット●,26,0.0858085808580858
0,0,53,とるパカ！ワンピース缶バッジセット●,26,0.0858085808580858
0,1,54,とるパカ！ワンピース缶バッジセット●,27,0.0891089108910891
0,0,55,とるパカ！ワンピース缶バッジセット●,27,0.0891089108910891
0,0,56,とるパカ！ワンピース缶バッジセット●,27,0.0891089108910891
0,0,57,とるパカ！ワンピース缶バッジセット●,27,0.0891089108910891
0,0,58,とるパカ！ワンピース缶バッジセット●,27,0.0891089108910891
0,0,59,とるパカ！ワンピース缶バッジセット●,27,0.0891089108910891
0,1802,0,一番くじ仮面ライダーウィザードショータイム,1802,0.0012420733388475325
727500,41268,1,一番くじ仮面ライダーウィザードショータイム,43070,0.029687069203198236
723300,89144,2,一番くじ仮面ライダーウィザードショータイム,132214,0.0911317893575958
0,93323,3,一番くじ仮面ライダーウィザードショータイム,225537,0.15545698924731183
0,91215,4,一番くじ仮面ライダーウィザードショータイム,316752,0.21832919768403639
0,105328,5,一番くじ仮面ライダーウィザードショータイム,422080,0.29092914254204577
0,85462,6,一番くじ仮面ライダーウィザードショータイム,507542,0.3498359525778881
0,90460,7,一番くじ仮面ライダーウィザードショータイム,598002,0.41218775847808103
0,107468,8,一番くじ仮面ライダーウィザードショータイム,705470,0.4862627515853322
0,81131,9,一番くじ仮面ライダーウィザードショータイム,786601,0.5421843121036669
0,64487,10,一番くじ仮面ライダーウィザードショータイム,851088,0.5866335814722912
0,49568,11,一番くじ仮面ライダーウィザードショータイム,900656,0.620799558864075
0,44446,12,一番くじ仮面ライダーウィザードショータイム,945102,0.6514350703060381
0,39631,13,一番くじ仮面ライダーウィザードショータイム,984733,0.6787517231872071
0,28708,14,一番くじ仮面ライダーウィザードショータイム,1013441,0.6985394265232975
0,24494,15,一番くじ仮面ライダーウィザードショータイム,1037935,0.7154225255031706
0,19035,16,一番くじ仮面ライダーウィザードショータイム,1056970,0.7285428728977116
0,17937,17,一番くじ仮面ライダーウィザードショータイム,1074907,0.7409063964709126
0,17421,18,一番くじ仮面ライダーウィザードショータイム,1092328,0.7529142542045768
0,20530,19,一番くじ仮面ライダーウィザードショータイム,1112858,0.7670650675489386
0,19063,20,一番くじ仮面ライダーウィザードショータイム,1131921,0.7802047146401985
0,11533,21,一番くじ仮面ライダーウィザードショータイム,1143454,0.7881541218637993
0,10299,22,一番くじ仮面ライダーウィザードショータイム,1153753,0.7952529638819962
0,10071,23,一番くじ仮面ライダーウィザードショータイム,1163824,0.8021946512269092
0,9443,24,一番くじ仮面ライダーウィザードショータイム,1173267,0.8087034739454094
0,9493,25,一番くじ仮面ライダーウィザードショータイム,1182760,0.8152467604080508
0,12604,26,一番くじ仮面ライダーウィザードショータイム,1195364,0.8239343810311552
0,11360,27,一番くじ仮面ライダーウィザードショータイム,1206724,0.8317645437000276
0,7525,28,一番くじ仮面ライダーウィザードショータイム,1214249,0.8369513371932726
0,6839,29,一番くじ仮面ライダーウィザードショータイム,1221088,0.841665288116901
0,6950,30,一番くじ仮面ライダーウィザードショータイム,1228038,0.8464557485525227
0,7095,31,一番くじ仮面ライダーウィザードショータイム,1235133,0.8513461538461539
0,7999,32,一番くじ仮面ライダーウィザードショータイム,1243132,0.8568596636338571
0,8277,33,一番くじ仮面ライダーウィザードショータイム,1251409,0.8625647918389854
0,7488,34,一番くじ仮面ライダーウィザードショータイム,1258897,0.867726082161566
0,5020,35,一番くじ仮面ライダーウィザードショータイム,1263917,0.8711862420733388
0,4591,36,一番くじ仮面ライダーウィザードショータイム,1268508,0.8743507030603804
0,4818,37,一番くじ仮面ライダーウィザードショータイム,1273326,0.877671629445823
0,4178,38,一番くじ仮面ライダーウィザードショータイム,1277504,0.8805514199062586
0,4203,39,一番くじ仮面ライダーウィザードショータイム,1281707,0.8834484422387648
0,5259,40,一番くじ仮面ライダーウィザードショータイム,1286966,0.8870733388475324
0,4812,41,一番くじ仮面ライダーウィザードショータイム,1291778,0.890390129583678
0,2991,42,一番くじ仮面ライダーウィザードショータイム,1294769,0.8924517507582024
0,3175,43,一番くじ仮面ライダーウィザードショータイム,1297944,0.8946401985111663
0,2622,44,一番くじ仮面ライダーウィザードショータイム,1300566,0.8964474772539288
0,2666,45,一番くじ仮面ライダーウィザードショータイム,1303232,0.8982850840915357
0,3093,46,一番くじ仮面ライダーウィザードショータイム,1306325,0.9004170113041081
0,3914,47,一番くじ仮面ライダーウィザードショータイム,1310239,0.9031148331954784
0,3698,48,一番くじ仮面ライダーウィザードショータイム,1313937,0.9056637717121588
0,3004,49,一番くじ仮面ライダーウィザードショータイム,1316941,0.90773435346016
0,2123,50,一番くじ仮面ライダーウィザードショータイム,1319064,0.9091976840363937
0,2089,51,一番くじ仮面ライダーウィザードショータイム,1321153,0.9106375792666115
0,2285,52,一番くじ仮面ライダーウィザードショータイム,1323438,0.9122125723738627
0,2713,53,一番くじ仮面ライダーウィザードショータイム,1326151,0.9140825751309622
0,2768,54,一番くじ仮面ライダーウィザードショータイム,1328919,0.9159904880066171
0,2516,55,一番くじ仮面ライダーウィザードショータイム,1331435,0.9177247036118004
0,1554,56,一番くじ仮面ライダーウィザードショータイム,1332989,0.9187958367797078
0,1613,57,一番くじ仮面ライダーウィザードショータイム,1334602,0.9199076371657017
0,1792,58,一番くじ仮面ライダーウィザードショータイム,1336394,0.9211428177557209
0,1783,59,一番くじ仮面ライダーウィザードショータイム,1338177,0.9223717948717949
0,18540,0,一番くじドラゴンボールＶＳオムニバス,18540,0.013327390879291506
673840,145207,1,一番くじドラゴンボールＶＳオムニバス,163747,0.11770875265972741
717040,171238,2,一番くじドラゴンボールＶＳオムニバス,334985,0.24080237506469607
80,139345,3,一番くじドラゴンボールＶＳオムニバス,474330,0.34096986600724594
80,130475,4,一番くじドラゴンボールＶＳオムニバス,604805,0.4347611996089482
0,111973,5,一番くじドラゴンボールＶＳオムニバス,716778,0.5152524584507447
0,55499,6,一番くじドラゴンボールＶＳオムニバス,772277,0.5551476508137329
0,49311,7,一番くじドラゴンボールＶＳオムニバス,821588,0.5905946287883145
0,54523,8,一番くじドラゴンボールＶＳオムニバス,876111,0.6297882281902352
0,36759,9,一番くじドラゴンボールＶＳオムニバス,912870,0.6562122606245328
0,41919,10,一番くじドラゴンボールＶＳオムニバス,954789,0.6863455345333257
0,48657,11,一番くじドラゴンボールＶＳオムニバス,1003446,0.7213223877163725
0,41609,12,一番くじドラゴンボールＶＳオムニバス,1045055,0.7512328195985968
0,36569,13,一番くじドラゴンボールＶＳオムニバス,1081624,0.7775202714359652
0,19294,14,一番くじドラゴンボールＶＳオムニバス,1100918,0.7913896716314912
0,20044,15,一番くじドラゴンボールＶＳオムニバス,1120962,0.8057982057622635
80,15691,16,一番くじドラゴンボールＶＳオムニバス,1136653,0.8170776065328657
0,15544,17,一番くじドラゴンボールＶＳオムニバス,1152197,0.8282513370521594
0,18910,18,一番くじドラゴンボールＶＳオムニバス,1171107,0.8418447006728391
0,18070,19,一番くじドラゴンボールＶＳオムニバス,1189177,0.8548342342860429
0,12214,20,一番くじドラゴンボールＶＳオムニバス,1201391,0.8636142101328426
0,13376,21,一番くじドラゴンボールＶＳオムニバス,1214767,0.8732294841566508
0,9233,22,一番くじドラゴンボールＶＳオムニバス,1224000,0.8798665823221576
0,7774,23,一番くじドラゴンボールＶＳオムニバス,1231774,0.8854548852722985
0,6998,24,一番くじドラゴンボールＶＳオムニバス,1238772,0.8904853643107712
0,9051,25,一番くじドラゴンボールＶＳオムニバス,1247823,0.896991632641325
0,8782,26,一番くじドラゴンボールＶＳオムニバス,1256605,0.9033045316004371
0,5124,27,一番くじドラゴンボールＶＳオムニバス,1261729,0.9069878946460406
0,4373,28,一番くじドラゴンボールＶＳオムニバス,1266102,0.9101314049111507
0,4367,29,一番くじドラゴンボールＶＳオムニバス,1270469,0.9132706021047788
0,3551,30,一番くじドラゴンボールＶＳオムニバス,1274020,0.9158232215768589
0,4574,31,一番くじドラゴンボールＶＳオムニバス,1278594,0.9191112197366151
0,5298,32,一番くじドラゴンボールＶＳオムニバス,1283892,0.9229196618551958
0,5176,33,一番くじドラゴンボールＶＳオムニバス,1289068,0.9266404048536431
0,3039,34,一番くじドラゴンボールＶＳオムニバス,1292107,0.9288249755592616
0,2627,35,一番くじドラゴンボールＶＳオムニバス,1294734,0.930713382023118
0,2505,36,一番くじドラゴンボールＶＳオムニバス,1297239,0.9325140893668411
0,1956,37,一番くじドラゴンボールＶＳオムニバス,1299195,0.9339201506699638
0,2622,38,一番くじドラゴンボールＶＳオムニバス,1301817,0.9358049629075853
0,3224,39,一番くじドラゴンボールＶＳオムニバス,1305041,0.9381225199838978
0,2944,40,一番くじドラゴンボールＶＳオムニバス,1307985,0.9402388003910518
0,2935,41,一番くじドラゴンボールＶＳオムニバス,1310920,0.9423486111909828
0,1677,42,一番くじドラゴンボールＶＳオムニバス,1312597,0.9435541146701938
0,1765,43,一番くじドラゴンボールＶＳオムニバス,1314362,0.9448228765311404
0,2061,44,一番くじドラゴンボールＶＳオムニバス,1316423,0.9463044165851976
0,2032,45,一番くじドラゴンボールＶＳオムニバス,1318455,0.9477651101270919
0,2465,46,一番くじドラゴンボールＶＳオムニバス,1320920,0.949537063660935
0,1937,47,一番くじドラゴンボールＶＳオムニバス,1322857,0.9509294669043649
0,1412,48,一番くじドラゴンボールＶＳオムニバス,1324269,0.9519444763931221
0,1496,49,一番くじドラゴンボールＶＳオムニバス,1325765,0.9530198688826269
0,1468,50,一番くじドラゴンボールＶＳオムニバス,1327233,0.9540751337052159
0,1259,51,一番くじドラゴンボールＶＳオムニバス,1328492,0.9549801598711829
0,1516,52,一番くじドラゴンボールＶＳオムニバス,1330008,0.9560699292656277
0,1889,53,一番くじドラゴンボールＶＳオムニバス,1331897,0.9574278279372017
0,1589,54,一番くじドラゴンボールＶＳオムニバス,1333486,0.9585700730346771
0,1091,55,一番くじドラゴンボールＶＳオムニバス,1334577,0.9593543331991489
0,880,56,一番くじドラゴンボールＶＳオムニバス,1335457,0.9599869170165047
0,655,57,一番くじドラゴンボールＶＳオムニバス,1336112,0.9604577606532866
0,953,58,一番くじドラゴンボールＶＳオムニバス,1337065,0.961142820173673
0,773,59,一番くじドラゴンボールＶＳオムニバス,1337838,0.9616984875496003
0,1634,0,一番くじ夏目友人帳ニャンコ先生茶房,1634,0.00472636815920398
164640,32189,1,一番くじ夏目友人帳ニャンコ先生茶房,33823,0.09783350688418373
181020,45008,2,一番くじ夏目友人帳ニャンコ先生茶房,78831,0.2280197847969455
60,37489,3,一番くじ夏目友人帳ニャンコ先生茶房,116320,0.33645724864051835
0,38163,4,一番くじ夏目友人帳ニャンコ先生茶房,154483,0.4468442670369085
0,28640,5,一番くじ夏目友人帳ニャンコ先生茶房,183123,0.5296858729607775
0,17506,6,一番くじ夏目友人帳ニャンコ先生茶房,200629,0.5803222260789078
0,14575,7,一番くじ夏目友人帳ニャンコ先生茶房,215204,0.6224806201550388
0,12271,8,一番くじ夏目友人帳ニャンコ先生茶房,227475,0.6579746615758417
0,11743,9,一番くじ夏目友人帳ニャンコ先生茶房,239218,0.691941455513132
0,10704,10,一番くじ夏目友人帳ニャンコ先生茶房,249922,0.7229029272243434
0,10986,11,一番くじ夏目友人帳ニャンコ先生茶房,260908,0.7546800879324309
0,9431,12,一番くじ夏目友人帳ニャンコ先生茶房,270339,0.7819593891010066
0,7488,13,一番くじ夏目友人帳ニャンコ先生茶房,277827,0.8036185352308226
0,5775,14,一番くじ夏目友人帳ニャンコ先生茶房,283602,0.8203228045817424
0,4899,15,一番くじ夏目友人帳ニャンコ先生茶房,288501,0.8344932315168344
0,4610,16,一番くじ夏目友人帳ニャンコ先生茶房,293111,0.8478277218558371
0,4144,17,一番くじ夏目友人帳ニャンコ先生茶房,297255,0.8598143005900729
0,4450,18,一番くじ夏目友人帳ニャンコ先生茶房,301705,0.8726859886613444
0,3429,19,一番くじ夏目友人帳ニャンコ先生茶房,305134,0.8826044197616568
0,2941,20,一番くじ夏目友人帳ニャンコ先生茶房,308075,0.8911113039453893
0,2138,21,一番くじ夏目友人帳ニャンコ先生茶房,310213,0.8972954992479463
0,1863,22,一番くじ夏目友人帳ニャンコ先生茶房,312076,0.9026842531528404
0,1507,23,一番くじ夏目友人帳ニャンコ先生茶房,313583,0.9070432720120328
0,1573,24,一番くじ夏目友人帳ニャンコ先生茶房,315156,0.9115931968066644
0,2054,25,一番くじ夏目友人帳ニャンコ先生茶房,317210,0.9175344209186626
0,1579,26,一番くじ夏目友人帳ニャンコ先生茶房,318789,0.9221017007983339
0,1100,27,一番くじ夏目友人帳ニャンコ先生茶房,319889,0.9252834663889853
0,925,28,一番くじ夏目友人帳ニャンコ先生茶房,320814,0.9279590419993058
0,1058,29,一番くじ夏目友人帳ニャンコ先生茶房,321872,0.9310193219946777
0,718,30,一番くじ夏目友人帳ニャンコ先生茶房,322590,0.9330961471711211
0,883,31,一番くじ夏目友人帳ニャンコ先生茶房,323473,0.9356502371861622
0,1088,32,一番くじ夏目友人帳ニャンコ先生茶房,324561,0.9387972926067337
0,834,33,一番くじ夏目友人帳ニャンコ先生茶房,325395,0.9412096494272822
0,731,34,一番くじ夏目友人帳ニャンコ先生茶房,326126,0.9433240772879787
0,590,35,一番くじ夏目友人帳ニャンコ先生茶房,326716,0.9450306606502372
0,487,36,一番くじ夏目友人帳ニャンコ先生茶房,327203,0.9464393150526438
0,413,37,一番くじ夏目友人帳ニャンコ先生茶房,327616,0.9476339234062247
0,589,38,一番くじ夏目友人帳ニャンコ先生茶房,328205,0.9493376142543098
0,601,39,一番くじ夏目友人帳ニャンコ先生茶房,328806,0.9510760152724749
0,428,40,一番くじ夏目友人帳ニャンコ先生茶房,329234,0.9523140113386556
0,339,41,一番くじ夏目友人帳ニャンコ先生茶房,329573,0.9532945736434109
0,301,42,一番くじ夏目友人帳ニャンコ先生茶房,329874,0.95416522040958
0,399,43,一番くじ夏目友人帳ニャンコ先生茶房,330273,0.9553193335647344
0,296,44,一番くじ夏目友人帳ニャンコ先生茶房,330569,0.9561755177600371
0,317,45,一番くじ夏目友人帳ニャンコ先生茶房,330886,0.9570924447529793
0,335,46,一番くじ夏目友人帳ニャンコ先生茶房,331221,0.9580614370010413
0,327,47,一番くじ夏目友人帳ニャンコ先生茶房,331548,0.9590072891357168
0,294,48,一番くじ夏目友人帳ニャンコ先生茶房,331842,0.9598576883026727
0,1438,49,一番くじ夏目友人帳ニャンコ先生茶房,333280,0.964017123683906
0,211,50,一番くじ夏目友人帳ニャンコ先生茶房,333491,0.9646274441744764
0,235,51,一番くじ夏目友人帳ニャンコ先生茶房,333726,0.9653071850052065
0,209,52,一番くじ夏目友人帳ニャンコ先生茶房,333935,0.9659117204674303
0,248,53,一番くじ夏目友人帳ニャンコ先生茶房,334183,0.9666290639824135
0,195,54,一番くじ夏目友人帳ニャンコ先生茶房,334378,0.9671931042462109
0,122,55,一番くじ夏目友人帳ニャンコ先生茶房,334500,0.9675459909753558
0,189,56,一番くじ夏目友人帳ニャンコ先生茶房,334689,0.9680926761541132
0,165,57,一番くじ夏目友人帳ニャンコ先生茶房,334854,0.9685699409927109
0,133,58,一番くじ夏目友人帳ニャンコ先生茶房,334987,0.9689546453777623
0,164,59,一番くじ夏目友人帳ニャンコ先生茶房,335151,0.9694290177021867
0,58,0,一番くじうさぎのモフィ＊,58,0.0003687737636541665
38478,1637,1,一番くじうさぎのモフィ＊,1695,0.010777095334376072
54978,3284,2,一番くじうさぎのモフィ＊,4979,0.03165732015920854
33198,3352,3,一番くじうさぎのモフィ＊,8331,0.052969900431083815
24882,3963,4,一番くじうさぎのモフィ＊,12294,0.07816732155800557
5742,5119,5,一番くじうさぎのモフィ＊,17413,0.1107147852846552
0,5014,6,一番くじうさぎのモフィ＊,22427,0.142594641335724
0,5552,7,一番くじうさぎのモフィ＊,27979,0.17789519195310216
0,7071,8,一番くじうさぎのモフィ＊,35050,0.22285380027721613
0,5965,9,一番くじうさぎのモフィ＊,41015,0.2607802744185455
0,4032,10,一番くじうさぎのモフィ＊,45047,0.28641640916084893
0,3439,11,一番くじうさぎのモフィ＊,48486,0.3082821500782055
0,3084,12,一番くじうさぎのモフィ＊,51570,0.32789074123526496
0,3290,13,一番くじうさぎのモフィ＊,54860,0.34880911507013057
0,3874,14,一番くじうさぎのモフィ＊,58734,0.3734406592148934
0,4918,15,一番くじうさぎのモフィ＊,63652,0.40471013110543114
0,3737,16,一番くじうさぎのモフィ＊,67389,0.42847060618776944
0,2727,17,一番くじうさぎのモフィ＊,70116,0.4458093312478541
0,2918,18,一番くじうさぎのモフィ＊,73034,0.46436246646066204
0,2712,19,一番くじうさぎのモフィ＊,75746,0.48160581899566374
0,2424,20,一番くじうさぎのモフィ＊,78170,0.49701801904907233
0,1962,21,一番くじうさぎのモフィ＊,80132,0.5094927453299254
0,2345,22,一番くじうさぎのモフィ＊,82477,0.5244026500845637
0,2122,23,一番くじうさぎのモフィ＊,84599,0.5378946832996351
0,1348,24,一番くじうさぎのモフィ＊,85947,0.546465494220425
0,1209,25,一番くじうさぎのモフィ＊,87156,0.5541525197421127
0,1230,26,一番くじうさぎのモフィ＊,88386,0.5619730667989166
0,1029,27,一番くじうさぎのモフィ＊,89415,0.5685156220196086
0,1255,28,一番くじうさぎのモフィ＊,90670,0.5764951232848841
0,1545,29,一番くじうさぎのモフィ＊,92215,0.5863184933684304
0,1498,30,一番くじうさぎのモフィ＊,93713,0.5958430295400501
0,915,31,一番くじうさぎのモフィ＊,94628,0.6016607535701115
0,943,32,一番くじうさぎのモフィ＊,95571,0.6076565063136612
0,782,33,一番くじうさぎのモフィ＊,96353,0.6126285939546535
0,882,34,一番くじうさぎのモフィ＊,97235,0.6182364984295324
0,847,35,一番くじうさぎのモフィ＊,98082,0.6236218670125511
0,770,36,一番くじうさぎのモフィ＊,98852,0.628517656633477
0,544,37,一番くじうさぎのモフィ＊,99396,0.6319765002098195
0,332,38,一番くじうさぎのモフィ＊,99728,0.6340874120983228
0,332,39,一番くじうさぎのモフィ＊,100060,0.6361983239868259
0,205,40,一番くじうさぎのモフィ＊,100265,0.6375017484962932
0,166,41,一番くじうさぎのモフィ＊,100431,0.6385572044405448
0,158,42,一番くじうさぎのモフィ＊,100589,0.6395617950380854
0,106,43,一番くじうさぎのモフィ＊,100695,0.6402357608820051
0,60,44,一番くじうさぎのモフィ＊,100755,0.640617250982337
0,23,45,一番くじうさぎのモフィ＊,100778,0.6407634888541309
0,27,46,一番くじうさぎのモフィ＊,100805,0.6409351593992803
0,18,47,一番くじうさぎのモフィ＊,100823,0.6410496064293798
0,23,48,一番くじうさぎのモフィ＊,100846,0.6411958443011737
0,17,49,一番くじうさぎのモフィ＊,100863,0.6413039331629344
0,38,50,一番くじうさぎのモフィ＊,100901,0.6415455435598113
0,34,51,一番くじうさぎのモフィ＊,100935,0.6417617212833326
0,6,52,一番くじうさぎのモフィ＊,100941,0.6417998702933659
0,27,53,一番くじうさぎのモフィ＊,100968,0.6419715408385153
0,27,54,一番くじうさぎのモフィ＊,100995,0.6421432113836646
0,12,55,一番くじうさぎのモフィ＊,101007,0.642219509403731
0,13,56,一番くじうさぎのモフィ＊,101020,0.6423021655921363
0,16,57,一番くじうさぎのモフィ＊,101036,0.642403896285558
0,18,58,一番くじうさぎのモフィ＊,101054,0.6425183433156576
0,8,59,一番くじうさぎのモフィ＊,101062,0.6425692086623686
0,867,0,一番くじぷち劇場版アイカツ！いちごまつり,867,0.0013104575114003757
328251,30062,1,一番くじぷち劇場版アイカツ！いちごまつり,30929,0.046748720150060236
333350,51544,2,一番くじぷち劇場版アイカツ！いちごまつり,82473,0.12465670396507865
0,48012,3,一番くじぷち劇場版アイカツ！いちごまつり,130485,0.19722612269328493
0,41016,4,一番くじぷち劇場版アイカツ！いちごまつり,171501,0.25922119222915324
0,33232,5,一番くじぷち劇場版アイカツ！いちごまつり,204733,0.3094508623777775
0,33122,6,一番くじぷち劇場版アイカツ！いちごまつり,237855,0.35951426917432106
0,31282,7,一番くじぷち劇場版アイカツ！いちごまつり,269137,0.40679654353605876
0,36014,8,一番くじぷち劇場版アイカツ！いちごまつり,305151,0.46123116500730804
0,30128,9,一番くじぷち劇場版アイカツ！いちごまつり,335279,0.5067691856572164
0,27506,10,一番くじぷち劇場版アイカツ！いちごまつり,362785,0.5483440925875264
0,22678,11,一番くじぷち劇場版アイカツ！いちごまつり,385463,0.5826215498465087
0,17353,12,一番くじぷち劇場版アイカツ！いちごまつり,402816,0.6088503493797621
0,13169,13,一番くじぷち劇場版アイカツ！いちごまつり,415985,0.62875509559387
0,11928,14,一番くじぷち劇場版アイカツ！いちごまつり,427913,0.6467840888995029
0,9467,15,一番くじぷち劇場版アイカツ！いちごまつり,437380,0.6610933175735829
0,10167,16,一番くじぷち劇場版アイカツ！いちごまつり,447547,0.6764605857609042
0,15199,17,一番くじぷち劇場版アイカツ！いちごまつり,462746,0.6994336465634121
0,14467,18,一番くじぷち劇場版アイカツ！いちごまつり,477213,0.7213003003320733
0,12766,19,一番くじぷち劇場版アイカツ！いちごまつり,489979,0.740595918083558
0,5579,20,一番くじぷち劇場版アイカツ！いちごまつり,495558,0.7490284930040916
0,5424,21,一番くじぷち劇場版アイカツ！いちごまつり,500982,0.7572267877466933
0,4519,22,一番くじぷち劇場版アイカツ！いちごまつり,505501,0.7640571885471757
0,4855,23,一番くじぷち劇場版アイカツ！いちごまつり,510356,0.7713954483140141
0,6912,24,一番くじぷち劇場版アイカツ！いちごまつり,517268,0.7818428327647631
0,6505,25,一番くじぷち劇場版アイカツ！いちごまつり,523773,0.7916750428128132
0,3579,26,一番くじぷち劇場版アイカツ！いちごまつり,527352,0.7970846476955143
0,3197,27,一番くじぷち劇場版アイカツ！いちごまつり,530549,0.8019168653009896
0,2894,28,一番くじぷち劇場版アイカツ！いちごまつり,533443,0.8062911029457331
0,2843,29,一番くじぷち劇場版アイカツ！いちごまつり,536286,0.810588254854512
0,3633,30,一番くじぷち劇場版アイカツ！いちごまつり,539919,0.8160794799282347
0,5263,31,一番くじぷち劇場版アイカツ！いちごまつり,545182,0.8240344255827908
0,4619,32,一番くじぷち劇場版アイカツ！いちごまつり,549801,0.8310159748851649
0,2367,33,一番くじぷち劇場版アイカツ！いちごまつり,552168,0.8345936599249396
0,2383,34,一番くじぷち劇場版アイカツ！いちごまつり,554551,0.838195528725017
0,2120,35,一番くじぷち劇場版アイカツ！いちごまつり,556671,0.8413998769651194
0,2039,36,一番くじぷち劇場版アイカツ！いちごまつり,558710,0.8444817949186897
0,2327,37,一番くじぷち劇場版アイカツ！いちごまつり,561037,0.8479990205577077
0,3380,38,一番くじぷち劇場版アイカツ！いちごまつり,564417,0.8531078399216446
0,3332,39,一番くじぷち劇場版アイカツ！いちごまつり,567749,0.8581441080046736
0,1774,40,一番くじぷち劇場版アイカツ！いちごまつり,569523,0.8608254824282309
0,1598,41,一番くじぷち劇場版アイカツ！いちごまつり,571121,0.8632408354884591
0,1497,42,一番くじぷち劇場版アイカツ！いちごまつり,572618,0.8655035285617767
0,1275,43,一番くじぷち劇場版アイカツ！いちごまつり,573893,0.8674306719608949
0,1686,44,一番くじぷち劇場版アイカツ！いちごまつり,575579,0.8699790357027877
0,2157,45,一番くじぷち劇場版アイカツ！いちごまつり,577736,0.8732393088885899
0,1908,46,一番くじぷち劇場版アイカツ！いちごまつり,579644,0.8761232223046821
0,1022,47,一番くじぷち劇場版アイカツ！いちごまつり,580666,0.8776679599940145
0,1120,48,一番くじぷち劇場版アイカツ！いちごまつり,581786,0.8793608232152007
0,1559,49,一番くじぷち劇場版アイカツ！いちごまつり,583345,0.8817172283596911
0,911,50,一番くじぷち劇場版アイカツ！いちごまつり,584256,0.8830941912119238
0,1015,51,一番くじぷち劇場版アイカツ！いちごまつり,585271,0.8846283485061238
0,1641,52,一番くじぷち劇場版アイカツ！いちごまつり,586912,0.8871086954221653
0,1576,53,一番くじぷち劇場版アイカツ！いちごまつり,588488,0.8894907958119773
0,871,54,一番くじぷち劇場版アイカツ！いちごまつり,589359,0.8908072992634534
0,739,55,一番くじぷち劇場版アイカツ！いちごまつり,590098,0.8919242866924324
0,728,56,一番くじぷち劇場版アイカツ！いちごまつり,590826,0.8930246477862035
0,857,57,一番くじぷち劇場版アイカツ！いちごまつり,591683,0.8943199904474147
0,938,58,一番くじぷち劇場版アイカツ！いちごまつり,592621,0.8957377633951581
0,1459,59,一番くじぷち劇場版アイカツ！いちごまつり,594080,0.897943020037757
0,8045,0,一番くじスプラトゥーン２,8045,0.009129948273083619
433818,135078,1,一番くじスプラトゥーン２,143123,0.16242456018502757
447282,182411,2,一番くじスプラトゥーン２,325534,0.3694354979651961
66,125613,3,一番くじスプラトゥーン２,451147,0.5119886604794103
0,108115,4,一番くじスプラトゥーン２,559262,0.6346840436421741
0,82703,5,一番くじスプラトゥーン２,641965,0.7285403658334525
0,58526,6,一番くじスプラトゥーン２,700491,0.7949591790877087
0,40616,7,一番くじスプラトゥーン２,741107,0.841052650692378
0,29892,8,一番くじスプラトゥーン２,770999,0.8749758842261276
0,25125,9,一番くじスプラトゥーン２,796124,0.9034892403928432
0,17973,10,一番くじスプラトゥーン２,814097,0.923886078219087
0,10701,11,一番くじスプラトゥーン２,824798,0.9360302145112271
0,7398,12,一番くじスプラトゥーン２,832196,0.9444259083986445
0,5839,13,一番くじスプラトゥーン２,838035,0.9510523556287919
0,5056,14,一番くじスプラトゥーン２,843091,0.9567902075204899
0,4290,15,一番くじスプラトゥーン２,847381,0.9616587566928365
0,4308,16,一番くじスプラトゥーン２,851689,0.9665477333442279
0,3250,17,一番くじスプラトゥーン２,854939,0.9702360281717634
0,2084,18,一番くじスプラトゥーン２,857023,0.9726010763011737
0,1659,19,一番くじスプラトゥーン２,858682,0.9744838089531371
0,1534,20,一番くじスプラトゥーン２,860216,0.9762246841117338
0,1392,21,一番くじスプラトゥーン２,861608,0.9778044091578658
0,1593,22,一番くじスプラトゥーン２,863201,0.9796122410533316
0,1283,23,一番くじスプラトゥーン２,864484,0.9810682663652479
0,1198,24,一番くじスプラトゥーン２,865682,0.9824278285816748
0,947,25,一番くじスプラトゥーン２,866629,0.9835025409514212
0,662,26,一番くじスプラトゥーン２,867291,0.9842538182362914
0,503,27,一番くじスプラトゥーン２,867794,0.9848246527895992
0,384,28,一番くじスプラトゥーン２,868178,0.9852604390092219
0,309,29,一番くじスプラトゥーン２,868487,0.9856111107328245
0,257,30,一番くじスプラトゥーン２,868744,0.9859027697391864
0,269,31,一番くじスプラトゥーン２,869013,0.9862080470649117
0,237,32,一番くじスプラトゥーン２,869250,0.986477008872335
0,147,33,一番くじスプラトゥーン２,869397,0.9866438332845343
0,217,34,一番くじスプラトゥーン２,869614,0.9868900978930191
0,261,35,一番くじスプラトゥーン２,869875,0.9871862963391688
0,345,36,一番くじスプラトゥーン２,870220,0.987577823020861
0,256,37,一番くじスプラトゥーン２,870476,0.9878683471672761
0,174,38,一番くじスプラトゥーン２,870650,0.9880658127980426
0,116,39,一番くじスプラトゥーン２,870766,0.988197456551887
0,86,40,一番くじスプラトゥーン２,870852,0.9882950545073232
0,102,41,一番くじスプラトゥーン２,870954,0.9884108102219105
0,90,42,一番くじスプラトゥーン２,871044,0.9885129476171346
0,77,43,一番くじスプラトゥーン２,871121,0.9886003318330485
0,196,44,一番くじスプラトゥーン２,871317,0.9888227643826475
0,96,45,一番くじスプラトゥーン２,871413,0.9889317109375532
0,53,46,一番くじスプラトゥーン２,871466,0.9889918585147407
0,72,47,一番くじスプラトゥーン２,871538,0.98907356843092
0,51,48,一番くじスプラトゥーン２,871589,0.9891314462882136
0,75,49,一番くじスプラトゥーン２,871664,0.9892165607842336
0,69,50,一番くじスプラトゥーン２,871733,0.989294866120572
0,92,51,一番くじスプラトゥーン２,871825,0.98939927323569
0,71,52,一番くじスプラトゥーン２,871896,0.9894798482919223
0,51,53,一番くじスプラトゥーン２,871947,0.989537726149216
0,62,54,一番くじスプラトゥーン２,872009,0.9896080874659259
0,68,55,一番くじスプラトゥーン２,872077,0.9896852579423173
0,61,56,一番くじスプラトゥーン２,872138,0.9897544843990803
0,42,57,一番くじスプラトゥーン２,872180,0.9898021485168516
0,35,58,一番くじスプラトゥーン２,872215,0.9898418686149942
0,66,59,一番くじスプラトゥーン２,872281,0.9899167693714919
0,10947,0,一番くじハイキュー！！新・ゴミ捨て場の決戦！,10947,0.01298941695352074
422221,82643,1,一番くじハイキュー！！新・ゴミ捨て場の決戦！,93590,0.11105138692609903
420482,113347,2,一番くじハイキュー！！新・ゴミ捨て場の決戦！,206937,0.2455459008048526
0,61969,3,一番くじハイキュー！！新・ゴミ捨て場の決戦！,268906,0.3190766561892252
60,42591,4,一番くじハイキュー！！新・ゴミ捨て場の決戦！,311497,0.3696139958683521
0,35657,5,一番くじハイキュー！！新・ゴミ捨て場の決戦！,347154,0.4119236368943582
0,28463,6,一番くじハイキュー！！新・ゴミ捨て場の決戦！,375617,0.4456970702320819
0,24782,7,一番くじハイキュー！！新・ゴミ捨て場の決戦！,400399,0.4751027275758428
0,23488,8,一番くじハイキュー！！新・ゴミ捨て場の決戦！,423887,0.5029729591830681
0,23088,9,一番くじハイキュー！！新・ゴミ捨て場の決戦！,446975,0.5303685615054292
0,20439,10,一番くじハイキュー！！新・ゴミ捨て場の決戦！,467414,0.5546209313887771
0,16571,11,一番くじハイキュー！！新・ゴミ捨て場の決戦！,483985,0.5742836360874884
0,13854,12,一番くじハイキュー！！新・ゴミ捨て場の決戦！,497839,0.5907224213687596
0,13466,13,一番くじハイキュー！！新・ゴミ捨て場の決戦！,511305,0.6067008162437126
0,11706,14,一番くじハイキュー！！新・ゴミ捨て場の決戦！,523011,0.6205908422652632
0,10309,15,一番くじハイキュー！！新・ゴミ捨て場の決戦！,533320,0.6328232255094255
0,9930,16,一番くじハイキュー！！新・ゴミ捨て場の決戦！,543250,0.644605897506179
0,10511,17,一番くじハイキュー！！新・ゴミ捨て場の決戦！,553761,0.6570779685391979
0,8938,18,一番くじハイキュー！！新・ゴミ捨て場の決戦！,562699,0.6676835599094882
0,7523,19,一番くじハイキュー！！新・ゴミ捨て場の決戦！,570222,0.6766101501845715
0,8133,20,一番くじハイキュー！！新・ゴミ捨て場の決戦！,578355,0.6862605501190726
0,7661,21,一番くじハイキュー！！新・ゴミ捨て場の決戦！,586016,0.695350887497434
0,6876,22,一番くじハイキュー！！新・ゴミ捨て場の決戦！,592892,0.7035097649042494
0,6946,23,一番くじハイキュー！！新・ゴミ捨て場の決戦！,599838,0.7117517024359161
0,7292,24,一番くじハイキュー！！新・ゴミ捨て場の決戦！,607130,0.7204041942989904
0,6117,25,一番くじハイキュー！！新・ゴミ捨て場の決戦！,613247,0.727662462637776
0,5368,26,一番くじハイキュー！！新・ゴミ捨て場の決戦！,618615,0.7340319876406535
0,4275,27,一番くじハイキュー！！新・ゴミ捨て場の決戦！,622890,0.7391045881226395
0,3827,28,一番くじハイキュー！！新・ゴミ捨て場の決戦！,626717,0.7436456038055776
0,3283,29,一番くじハイキュー！！新・ゴミ捨て場の決戦！,630000,0.7475411236611005
0,3673,30,一番くじハイキュー！！新・ゴミ捨て場の決戦！,633673,0.7518994070693659
0,4886,31,一番くじハイキュー！！新・ゴミ捨て場の決戦！,638559,0.757697003783982
0,3969,32,一番くじハイキュー！！新・ゴミ捨て場の決戦！,642528,0.762406512863047
0,2778,33,一番くじハイキュー！！新・ゴミ捨て場の決戦！,645306,0.7657028132464287
0,2489,34,一番くじハイキュー！！新・ゴミ捨て場の決戦！,647795,0.7686561939714961
0,2693,35,一番くじハイキュー！！新・ゴミ捨て場の決戦！,650488,0.7718516356318443
0,2513,36,一番くじハイキュー！！新・ゴミ捨て場の決戦！,653001,0.7748334941140036
0,3121,37,一番くじハイキュー！！新・ゴミ捨て場の決戦！,656122,0.7785367891091565
0,3992,38,一番くじハイキュー！！新・ゴミ捨て場の決戦！,660114,0.783273589372101
0,3581,39,一番くじハイキュー！！新・ゴミ捨て場の決戦！,663695,0.7875227080448477
0,2709,40,一番くじハイキュー！！新・ゴミ捨て場の決戦！,666404,0.7907371348765905
0,2479,41,一番くじハイキュー！！新・ゴミ捨て場の決戦！,668883,0.7936786498695363
0,2237,42,一番くじハイキュー！！新・ゴミ捨て場の決戦！,671120,0.7963330141451392
0,1990,43,一番くじハイキュー！！新・ゴミ捨て場の決戦！,673110,0.7986942948373386
0,2620,44,一番くじハイキュー！！新・ゴミ捨て場の決戦！,675730,0.801803116653199
0,3361,45,一番くじハイキュー！！新・ゴミ捨て場の決戦！,679091,0.8057911892192704
0,3219,46,一番くじハイキュー！！新・ゴミ捨て場の決戦！,682310,0.809610768389215
0,3167,47,一番くじハイキュー！！新・ゴミ捨て場の決戦！,685477,0.8133686457521272
0,2884,48,一番くじハイキュー！！新・ゴミ捨て場の決戦！,688361,0.8167907228959981
0,1994,49,一番くじハイキュー！！新・ゴミ捨て場の決戦！,690355,0.819156749881046
0,1495,50,一番くじハイキュー！！新・ゴミ捨て場の決戦！,691850,0.820930676833226
0,2065,51,一番くじハイキュー！！新・ゴミ捨て場の決戦！,693915,0.8233809505163373
0,2483,52,一番くじハイキュー！！新・ゴミ捨て場の決戦！,696398,0.8263272118021318
0,2455,53,一番くじハイキュー！！新・ゴミ捨て場の決戦！,698853,0.8292402490379858
0,1705,54,一番くじハイキュー！！新・ゴミ捨て場の決戦！,700558,0.8312633563647194
0,1576,55,一番くじハイキュー！！新・ゴミ捨て場の決戦！,702134,0.8331333957470843
0,1697,56,一番くじハイキュー！！新・ゴミ捨て場の決戦！,703831,0.8351470104881206
0,1478,57,一番くじハイキュー！！新・ゴミ捨て場の決戦！,705309,0.8369007656956938
0,1551,58,一番くじハイキュー！！新・ゴミ捨て場の決戦！,706860,0.8387411407477547
0,2102,59,一番くじハイキュー！！新・ゴミ捨て場の決戦！,708962,0.841235317639716
0,2536,0,一番くじモンスターストライクｖｏｌ．４,2536,0.005545799865728663
236240,34912,1,一番くじモンスターストライクｖｏｌ．４,37448,0.0818923948626999
221043,42645,2,一番くじモンスターストライクｖｏｌ．４,80093,0.17514974315686346
0,27821,3,一番くじモンスターストライクｖｏｌ．４,107914,0.23598952945987495
0,22469,4,一番くじモンスターストライクｖｏｌ．４,130383,0.2851254037434149
0,20382,5,一番くじモンスターストライクｖｏｌ．４,150765,0.329697364651649
0,18778,6,一番くじモンスターストライクｖｏｌ．４,169543,0.37076165088140167
0,16852,7,一番くじモンスターストライクｖｏｌ．４,186395,0.40761410330145664
0,20422,8,一番くじモンスターストライクｖｏｌ．４,206817,0.45227353739369275
0,16897,9,一番くじモンスターストライクｖｏｌ．４,223714,0.48922439714575
0,12245,10,一番くじモンスターストライクｖｏｌ．４,235959,0.5160021255983712
0,10111,11,一番くじモンスターストライクｖｏｌ．４,246070,0.5381131596844843
0,9370,12,一番くじモンスターストライクｖｏｌ．４,255440,0.5586037530369596
0,8734,13,一番くじモンスターストライクｖｏｌ．４,264174,0.5777035227638028
0,8489,14,一番くじモンスターストライクｖｏｌ．４,272663,0.5962675192386334
0,10902,15,一番くじモンスターストライクｖｏｌ．４,283565,0.6201083355383865
0,9268,16,一番くじモンスターストライクｖｏｌ．４,292833,0.6403758722716567
0,5304,17,一番くじモンスターストライクｖｏｌ．４,298137,0.6519748164703258
0,5118,18,一番くじモンスターストライクｖｏｌ．４,303255,0.6631670103633854
0,4674,19,一番くじモンスターストライクｖｏｌ．４,307929,0.6733882519140226
0,5587,20,一番くじモンスターストライクｖｏｌ．４,313516,0.685606068889506
0,6329,21,一番くじモンスターストライクｖｏｌ．４,319845,0.6994465134282272
0,6653,22,一番くじモンスターストライクｖｏｌ．４,326498,0.7139954907573647
0,6398,23,一番くじモンスターストライクｖｏｌ．４,332896,0.7279868265384893
0,5066,24,一番くじモンスターストライクｖｏｌ．４,337962,0.7390653052923463
0,4279,25,一番くじモンスターストライクｖｏｌ．４,342241,0.7484227491509634
0,4298,26,一番くじモンスターストライクｖｏｌ．４,346539,0.7578217427719814
0,3944,27,一番くじモンスターストライクｖｏｌ．４,350483,0.7664465987145815
0,4075,28,一番くじモンスターストライクｖｏｌ．４,354558,0.7753579293347883
0,3470,29,一番くじモンスターストライクｖｏｌ．４,358028,0.7829462280469643
0,3605,30,一番くじモンスターストライクｖｏｌ．４,361633,0.7908297487551472
0,2422,31,一番くじモンスターストライクｖｏｌ．４,364055,0.7961262500464701
0,1908,32,一番くじモンスターストライクｖｏｌ．４,365963,0.800298720923367
0,1916,33,一番くじモンスターストライクｖｏｌ．４,367879,0.8044886864370642
0,1979,34,一番くじモンスターストライクｖｏｌ．４,369858,0.8088164222155645
0,1869,35,一番くじモンスターストライクｖｏｌ．４,371727,0.8129036067380594
0,2429,36,一番くじモンスターストライクｖｏｌ．４,374156,0.8182154158365826
0,2490,37,一番くじモンスターストライクｖｏｌ．４,376646,0.823660621540709
0,1528,38,一番くじモンスターストライクｖｏｌ．４,378174,0.8270020971695865
0,1263,39,一番くじモンスターストライクｖｏｌ．４,379437,0.8297640629544505
0,1643,40,一番くじモンスターストライクｖｏｌ．４,381080,0.8333570239873339
0,1130,41,一番くじモンスターストライクｖｏｌ．４,382210,0.8358281414353912
0,1516,42,一番くじモンスターストライクｖｏｌ．４,383726,0.8391433751090681
0,1929,43,一番くじモンスターストライクｖｏｌ．４,385655,0.843361769407566
0,1545,44,一番くじモンスターストライクｖｏｌ．４,387200,0.8467404211396444
0,1240,45,一番くじモンスターストライクｖｏｌ．４,388440,0.8494520898437072
0,1049,46,一番くじモンスターストライクｖｏｌ．４,389489,0.8517460740941605
0,871,47,一番くじモンスターストライクｖｏｌ．４,390360,0.8536508026758047
0,988,48,一番くじモンスターストライクｖｏｌ．４,391348,0.8558113903206548
0,1426,49,一番くじモンスターストライクｖｏｌ．４,392774,0.8589298093303271
0,1697,50,一番くじモンスターストライクｖｏｌ．４,394471,0.8626408591616133
0,1187,51,一番くじモンスターストライクｖｏｌ．４,395658,0.8652366258968734
0,963,52,一番くじモンスターストライクｖｏｌ．４,396621,0.8673425428017223
0,646,53,一番くじモンスターストライクｖｏｌ．４,397267,0.8687552347233551
0,796,54,一番くじモンスターストライクｖｏｌ．４,398063,0.8704959510849956
0,860,55,一番くじモンスターストライクｖｏｌ．４,398923,0.8723766245410391
0,905,56,一番くじモンスターストライクｖｏｌ．４,399828,0.874355705329085
0,170,57,一番くじモンスターストライクｖｏｌ．４,399998,0.8747274663610937
0,142,58,一番くじモンスターストライクｖｏｌ．４,400140,0.8750379961643009
0,702,59,一番くじモンスターストライクｖｏｌ．４,400842,0.8765731505435365
0,1603,0,一番くじパズル＆ドラゴンズ,1603,0.011937742031575813
65640,14525,1,一番くじパズル＆ドラゴンズ,16128,0.12010723860589813
68640,42292,2,一番くじパズル＆ドラゴンズ,58420,0.4350610664283587
0,25554,3,一番くじパズル＆ドラゴンズ,83974,0.62536490914507
0,13026,4,一番くじパズル＆ドラゴンズ,97000,0.7223711647304141
0,9239,5,一番くじパズル＆ドラゴンズ,106239,0.7911751563896336
0,5865,6,一番くじパズル＆ドラゴンズ,112104,0.83485254691689
0,4713,7,一番くじパズル＆ドラゴンズ,116817,0.8699508489722967
0,3320,8,一番くじパズル＆ドラゴンズ,120137,0.8946753053321418
0,3165,9,一番くじパズル＆ドラゴンズ,123302,0.9182454572535002
0,1962,10,一番くじパズル＆ドラゴンズ,125264,0.9328567173071195
0,857,11,一番くじパズル＆ドラゴンズ,126121,0.9392389037831397
0,713,12,一番くじパズル＆ドラゴンズ,126834,0.9445487042001788
0,712,13,一番くじパズル＆ドラゴンズ,127546,0.9498510574918082
0,491,14,一番くじパズル＆ドラゴンズ,128037,0.9535075960679178
0,421,15,一番くじパズル＆ドラゴンズ,128458,0.9566428358653559
0,472,16,一番くじパズル＆ドラゴンズ,128930,0.9601578790586833
0,359,17,一番くじパズル＆ドラゴンズ,129289,0.9628313970807268
0,221,18,一番くじパズル＆ドラゴンズ,129510,0.9644772117962467
0,141,19,一番くじパズル＆ドラゴンズ,129651,0.9655272564789991
0,207,20,一番くじパズル＆ドラゴンズ,129858,0.9670688114387846
0,118,21,一番くじパズル＆ドラゴンズ,129976,0.9679475722371165
0,168,22,一番くじパズル＆ドラゴンズ,130144,0.9691986893059279
0,126,23,一番くじパズル＆ドラゴンズ,130270,0.9701370271075365
0,100,24,一番くじパズル＆ドラゴンズ,130370,0.9708817396484957
0,79,25,一番くじパズル＆ドラゴンズ,130449,0.9714700625558534
0,46,26,一番くじパズル＆ドラゴンズ,130495,0.9718126303246947
0,63,27,一番くじパズル＆ドラゴンズ,130558,0.972281799225499
0,29,28,一番くじパズル＆ドラゴンズ,130587,0.9724977658623771
0,40,29,一番くじパズル＆ドラゴンズ,130627,0.9727956508787609
0,46,30,一番くじパズル＆ドラゴンズ,130673,0.973138218647602
0,33,31,一番くじパズル＆ドラゴンズ,130706,0.9733839737861185
0,37,32,一番くじパズル＆ドラゴンズ,130743,0.9736595174262734
0,20,33,一番くじパズル＆ドラゴンズ,130763,0.9738084599344653
0,42,34,一番くじパズル＆ドラゴンズ,130805,0.9741212392016682
0,31,35,一番くじパズル＆ドラゴンズ,130836,0.9743521000893655
0,41,36,一番くじパズル＆ドラゴンズ,130877,0.9746574322311587
0,27,37,一番くじパズル＆ドラゴンズ,130904,0.9748585046172178
0,22,38,一番くじパズル＆ドラゴンズ,130926,0.9750223413762288
0,26,39,一番くじパズル＆ドラゴンズ,130952,0.9752159666368782
0,50,40,一番くじパズル＆ドラゴンズ,131002,0.9755883229073578
0,30,41,一番くじパズル＆ドラゴンズ,131032,0.9758117366696455
0,28,42,一番くじパズル＆ドラゴンズ,131060,0.9760202561811141
0,25,43,一番くじパズル＆ドラゴンズ,131085,0.9762064343163539
0,14,44,一番くじパズル＆ドラゴンズ,131099,0.9763106940720881
0,17,45,一番くじパズル＆ドラゴンズ,131116,0.9764372952040512
0,34,46,一番くじパズル＆ドラゴンズ,131150,0.9766904974679773
0,23,47,一番くじパズル＆ドラゴンズ,131173,0.976861781352398
0,30,48,一番くじパズル＆ドラゴンズ,131203,0.9770851951146857
0,16,49,一番くじパズル＆ドラゴンズ,131219,0.9772043491212392
0,38,50,一番くじパズル＆ドラゴンズ,131257,0.9774873398868037
0,12,51,一番くじパズル＆ドラゴンズ,131269,0.9775767053917188
0,12,52,一番くじパズル＆ドラゴンズ,131281,0.9776660708966339
0,46,53,一番くじパズル＆ドラゴンズ,131327,0.9780086386654752
0,8,54,一番くじパズル＆ドラゴンズ,131335,0.9780682156687519
0,16,55,一番くじパズル＆ドラゴンズ,131351,0.9781873696753053
0,4,56,一番くじパズル＆ドラゴンズ,131355,0.9782171581769437
0,9,57,一番くじパズル＆ドラゴンズ,131364,0.9782841823056301
0,19,58,一番くじパズル＆ドラゴンズ,131383,0.9784256776884123
0,8,59,一番くじパズル＆ドラゴンズ,131391,0.978485254691689
0,4817,0,一番くじワンピースドレスローザバトル編,4817,0.0040072208172501
599040,53875,1,一番くじワンピースドレスローザバトル編,58692,0.04882536935977639
602480,105156,2,一番くじワンピースドレスローザバトル編,163848,0.13630374018368163
400,93923,3,一番くじワンピースドレスローザバトル編,257771,0.21443747504325836
0,61340,4,一番くじワンピースドレスローザバトル編,319111,0.26546569279914817
0,56175,5,一番くじワンピースドレスローザバトル編,375286,0.31219719153467324
80,52410,6,一番くじワンピースドレスローザバトル編,427696,0.3557966191933981
0,45022,7,一番くじワンピースドレスローザバトル編,472718,0.39325003327565555
0,46423,8,一番くじワンピースドレスローザバトル編,519141,0.4318689271928657
0,55233,9,一番くじワンピースドレスローザバトル編,574374,0.47781678424064955
0,50767,10,一番くじワンピースドレスローザバトル編,625141,0.5200494143484626
0,32156,11,一番くじワンピースドレスローザバトル編,657297,0.5467997138293624
0,29369,12,一番くじワンピースドレスローザバトル編,686666,0.5712315320111806
0,27082,13,一番くじワンピースドレスローザバトル編,713748,0.5937608145880474
80,24057,14,一番くじワンピースドレスローザバトル編,737805,0.6137736257154266
0,25868,15,一番くじワンピースドレスローザバトル編,763673,0.6352929921469453
0,29170,16,一番くじワンピースドレスローザバトル編,792843,0.6595592639424996
0,24647,17,一番くじワンピースドレスローザバトル編,817490,0.6800628909889525
0,16028,18,一番くじワンピースドレスローザバトル編,833518,0.6933964461599893
0,14366,19,一番くじワンピースドレスローザバトル編,847884,0.7053473978437376
0,16691,20,一番くじワンピースドレスローザバトル編,864575,0.719232497005191
0,15323,21,一番くじワンピースドレスローザバトル編,879898,0.7319795687475044
0,14788,22,一番くじワンピースドレスローザバトル編,894686,0.7442815785970983
0,15382,23,一番くじワンピースドレスローザバトル編,910068,0.757077731931319
0,14470,24,一番くじワンピースドレスローザバトル編,924538,0.7691152003194462
0,11366,25,一番くじワンピースドレスローザバトル編,935904,0.7785704778384134
0,10729,26,一番くじワンピースドレスローザバトル編,946633,0.7874958405430587
0,9650,27,一番くじワンピースドレスローザバトル編,956283,0.7955235924397711
0,9248,28,一番くじワンピースドレスローザバトル編,965531,0.8032169239984027
0,8808,29,一番くじワンピースドレスローザバトル編,974339,0.8105442233461999
0,10108,30,一番くじワンピースドレスローザバトル編,984447,0.8189529814987355
0,9662,31,一番くじワンピースドレスローザバトル編,994109,0.8269907160921071
0,7051,32,一番くじワンピースドレスローザバトル編,1001160,0.8328563822707308
0,5816,33,一番くじワンピースドレスローザバトル編,1006976,0.8376946625848529
0,5246,34,一番くじワンピースドレスローザバトル編,1012222,0.8420587648076667
0,5602,35,一番くじワンピースドレスローザバトル編,1017824,0.8467190203647011
0,5445,36,一番くじワンピースドレスローザバトル編,1023269,0.8512486689737788
0,7420,37,一番くじワンピースドレスローザバトル編,1030689,0.8574213030746706
0,7112,38,一番くじワンピースドレスローザバトル編,1037801,0.8633377146279781
0,3669,39,一番くじワンピースドレスローザバトル編,1041470,0.8663899241315054
0,3647,40,一番くじワンピースドレスローザバトル編,1045117,0.8694238320244909
0,4518,41,一番くじワンピースドレスローザバトル編,1049635,0.8731823173166512
0,3855,42,一番くじワンピースドレスローザバトル編,1053490,0.8763892586183948
0,4052,43,一番くじワンピースドレスローザバトル編,1057542,0.8797600825236257
0,5152,44,一番くじワンピースドレスローザバトル編,1062694,0.884045986955943
0,4662,45,一番くじワンピースドレスローザバトル編,1067356,0.8879242646080128
0,2874,46,一番くじワンピースドレスローザバトル編,1070230,0.890315120457873
0,2763,47,一番くじワンピースドレスローザバトル編,1072993,0.8926136363636363
0,2546,48,一番くじワンピースドレスローザバトル編,1075539,0.8947316318381472
0,2677,49,一番くじワンピースドレスローザバトル編,1078216,0.8969586050845202
0,3118,50,一番くじワンピースドレスローザバトル編,1081334,0.8995524424331159
0,3704,51,一番くじワンピースドレスローザバトル編,1085038,0.9026337681352322
0,3636,52,一番くじワンピースドレスローザバトル編,1088674,0.9056585252229469
0,2421,53,一番くじワンピースドレスローザバトル編,1091095,0.9076725342739252
0,2111,54,一番くじワンピースドレスローザバトル編,1093206,0.9094286569945428
0,2700,55,一番くじワンピースドレスローザバトル編,1095906,0.9116747637428457
0,2034,56,一番くじワンピースドレスローザバトル編,1097940,0.9133668308265673
0,2307,57,一番くじワンピースドレスローザバトル編,1100247,0.9152860042592839
0,2439,58,一番くじワンピースドレスローザバトル編,1102686,0.9173149873552509
0,2740,59,一番くじワンピースドレスローザバトル編,1105426,0.9195943697590843
198,4145,0,一番くじディズニープリンセスシャイニング,4145,0.006787304383992769
298255,87397,1,一番くじディズニープリンセスシャイニング,91542,0.14989708514341762
312048,123257,2,一番くじディズニープリンセスシャイニング,214799,0.3517264642647196
0,80299,3,一番くじディズニープリンセスシャイニング,295098,0.48321349797527097
132,69401,4,一番くじディズニープリンセスシャイニング,364499,0.5968554066733366
0,49105,5,一番くじディズニープリンセスシャイニング,413604,0.6772632671741725
0,28438,6,一番くじディズニープリンセスシャイニング,442042,0.723829578892384
0,21094,7,一番くじディズニープリンセスシャイニング,463136,0.7583703264619722
0,17807,8,一番くじディズニープリンセスシャイニング,480943,0.7875287170930361
0,13277,9,一番くじディズニープリンセスシャイニング,494220,0.80926937820432
0,11389,10,一番くじディズニープリンセスシャイニング,505609,0.8279184999484198
0,12836,11,一番くじディズニープリンセスシャイニング,518445,0.8489370377223476
0,10213,12,一番くじディズニープリンセスシャイニング,528658,0.865660497233498
0,5733,13,一番くじディズニープリンセスシャイニング,534391,0.8750481006191266
0,5376,14,一番くじディズニープリンセスシャイニング,539767,0.8838511279697527
0,4377,15,一番くじディズニープリンセスシャイニング,544144,0.8910183249031028
66,4165,16,一番くじディズニープリンセスシャイニング,548309,0.8978383786447989
0,4292,17,一番くじディズニープリンセスシャイニング,552601,0.9048663908079103
0,4898,18,一番くじディズニープリンセスシャイニング,557499,0.9128867085094293
0,4280,19,一番くじディズニープリンセスシャイニング,561779,0.9198950710579189
0,2343,20,一番くじディズニープリンセスシャイニング,564122,0.9237316583128513
0,2263,21,一番くじディズニープリンセスシャイニング,566385,0.9274372481369709
0,2267,22,一番くじディズニープリンセスシャイニング,568652,0.9311493878326311
0,1775,23,一番くじディズニープリンセスシャイニング,570427,0.9340558933287921
0,1961,24,一番くじディズニープリンセスシャイニング,572388,0.937266967851593
0,2082,25,一番くじディズニープリンセスシャイニング,574470,0.9406761759884984
0,2151,26,一番くじディズニープリンセスシャイニング,576621,0.94419836940948
0,1592,27,一番くじディズニープリンセスシャイニング,578213,0.9468052182826564
0,1032,28,一番くじディズニープリンセスシャイニング,579245,0.9484950851401427
0,970,29,一番くじディズニープリンセスシャイニング,580215,0.950083428988749
0,1196,30,一番くじディズニープリンセスシャイニング,581411,0.9520418405794017
0,1055,31,一番くじディズニープリンセスシャイニング,582466,0.9537693691982466
0,1280,32,一番くじディズニープリンセスシャイニング,583746,0.9558653280912528
0,1230,33,一番くじディズニープリンセスシャイニング,584976,0.957879413590001
0,768,34,一番くじディズニープリンセスシャイニング,585744,0.9591369889258047
0,682,35,一番くじディズニープリンセスシャイニング,586426,0.9602537420234846
0,776,36,一番くじディズニープリンセスシャイニング,587202,0.9615244171023696
0,545,37,一番くじディズニープリンセスシャイニング,587747,0.9624168370997824
0,567,38,一番くじディズニープリンセスシャイニング,588314,0.9633452813906688
0,720,39,一番くじディズニープリンセスシャイニング,589034,0.9645242582679847
0,695,40,一番くじディズニープリンセスシャイニング,589729,0.9656622984481716
0,494,41,一番くじディズニープリンセスシャイニング,590223,0.9664712075834413
0,426,42,一番くじディズニープリンセスシャイニング,590649,0.9671687689025199
0,417,43,一番くじディズニープリンセスシャイニング,591066,0.9678515930106321
0,394,44,一番くじディズニープリンセスシャイニング,591460,0.9684967553573856
0,435,45,一番くじディズニープリンセスシャイニング,591895,0.9692090538874306
0,584,46,一番くじディズニープリンセスシャイニング,592479,0.9701653351323647
0,585,47,一番くじディズニープリンセスシャイニング,593064,0.9711232538451839
0,329,48,一番くじディズニープリンセスシャイニング,593393,0.9716619807794019
0,246,49,一番くじディズニープリンセスシャイニング,593639,0.9720647978791516
0,312,50,一番くじディズニープリンセスシャイニング,593951,0.9725756878593219
0,362,51,一番くじディズニープリンセスシャイニング,594313,0.9731684512337502
0,309,52,一番くじディズニープリンセスシャイニング,594622,0.973674428810265
0,357,53,一番くじディズニープリンセスシャイニング,594979,0.9742590048452675
0,287,54,一番くじディズニープリンセスシャイニング,595266,0.9747289581283087
0,217,55,一番くじディズニープリンセスシャイニング,595483,0.9750842886593887
0,142,56,一番くじディズニープリンセスシャイニング,595625,0.9753168090990816
0,149,57,一番くじディズニープリンセスシャイニング,595774,0.9755607918139706
0,178,58,一番くじディズニープリンセスシャイニング,595952,0.9758522610975292
0,253,59,一番くじディズニープリンセスシャイニング,596205,0.976266540472475
0,2597,0,一番くじファインディングドリー,2597,0.004231709304220303
305850,29604,1,一番くじファインディングドリー,32201,0.05247026234316441
307750,60881,2,一番くじファインディングドリー,93082,0.15167345608603552
0,55359,3,一番くじファインディングドリー,148441,0.24187876812774972
0,46791,4,一番くじファインディングドリー,195232,0.3181228613328988
0,38050,5,一番くじファインディングドリー,233282,0.3801238390092879
50,35292,6,一番くじファインディングドリー,268574,0.43763076421704417
0,31034,7,一番くじファインディングドリー,299608,0.4881994459833795
0,29951,8,一番くじファインディングドリー,329559,0.5370034218673619
0,30650,9,一番くじファインディングドリー,360209,0.5869463907446635
0,27099,10,一番くじファインディングドリー,387308,0.6311031448590516
0,18763,11,一番くじファインディングドリー,406071,0.6616767150073326
0,15949,12,一番くじファインディングドリー,422020,0.6876649828906632
50,14219,13,一番くじファインディングドリー,436239,0.710834283852045
0,13290,14,一番くじファインディングドリー,449529,0.7324898158709467
0,11919,15,一番くじファインディングドリー,461448,0.7519113573407202
0,12588,16,一番くじファインディングドリー,474036,0.7724230079843571
0,10810,17,一番くじファインディングドリー,484846,0.790037477594916
0,7629,18,一番くじファインディングドリー,492475,0.8024686328825159
0,6656,19,一番くじファインディングドリー,499131,0.8133143229591006
0,7500,20,一番くじファインディングドリー,506631,0.8255352778230406
0,7497,21,一番くじファインディングドリー,514128,0.8377513443050351
0,6409,22,一番くじファインディングドリー,520537,0.8481945576014339
0,6678,23,一番くじファインディングドリー,527215,0.8590760958122862
0,5537,24,一番くじファインディングドリー,532752,0.8680984194231709
0,5208,25,一番くじファインディングドリー,537960,0.8765846504806909
0,3906,26,一番くじファインディングドリー,541866,0.8829493237738308
0,3243,27,一番くじファインディングドリー,545109,0.8882336646569985
0,2812,28,一番くじファインディングドリー,547921,0.8928157080006518
0,2773,29,一番くじファインディングドリー,550694,0.8973342023790125
0,2973,30,一番くじファインディングドリー,553667,0.9021785888870784
0,2905,31,一番くじファインディングドリー,556572,0.9069121720710445
0,1741,32,一番くじファインディングドリー,558313,0.9097490630601271
0,2045,33,一番くじファインディングドリー,560358,0.9130813100863614
0,1881,34,一番くじファインディングドリー,562239,0.9161463255662375
0,2064,35,一番くじファインディングドリー,564303,0.9195095323447938
0,1745,36,一番くじファインディングドリー,566048,0.9223529411764706
0,2110,37,一番くじファインディングドリー,568158,0.925791103144859
0,1612,38,一番くじファインディングドリー,569770,0.9284177937102819
0,1124,39,一番くじファインディングドリー,570894,0.9302493074792244
0,1164,40,一番くじファインディングドリー,572058,0.9321459996741078
0,1024,41,一番くじファインディングドリー,573082,0.9338145673781978
0,919,42,一番くじファインディングドリー,574001,0.9353120417141926
0,847,43,一番くじファインディングドリー,574848,0.9366921948834935
0,1160,44,一番くじファインディングドリー,576008,0.938582369235783
0,1003,45,一番くじファインディングドリー,577011,0.9402167182662539
0,775,46,一番くじファインディングドリー,577786,0.941479550268861
0,725,47,一番くじファインディングドリー,578511,0.9426609092390419
0,567,48,一番くじファインディングドリー,579078,0.9435848134267557
0,707,49,一番くじファインディングドリー,579785,0.9447368421052632
0,807,50,一番くじファインディングドリー,580592,0.946051816848623
0,955,51,一番くじファインディングドリー,581547,0.9476079517679648
0,899,52,一番くじファインディングドリー,582446,0.9490728368909891
0,573,53,一番くじファインディングドリー,583019,0.9500065178425942
0,459,54,一番くじファインディングドリー,583478,0.9507544402802672
0,521,55,一番くじファインディングドリー,583999,0.9516033892781489
0,502,56,一番くじファインディングドリー,584501,0.9524213785237087
0,507,57,一番くじファインディングドリー,585008,0.953247515072511
0,635,58,一番くじファインディングドリー,585643,0.9542822225843246
0,514,59,一番くじファインディングドリー,586157,0.9551197653576666
1440,4279,0,一番くじトイストーリートリックオアトイズ,4279,0.0034904369857437795
599281,57760,1,一番くじトイストーリートリックオアトイズ,62039,0.05060603415717652
621920,124010,2,一番くじトイストーリートリックオアトイズ,186049,0.15176263397070447
240,112457,3,一番くじトイストーリートリックオアトイズ,298506,0.24349529863669844
0,75672,4,一番くじトイストーリートリックオアトイズ,374178,0.3052219514960589
0,66511,5,一番くじトイストーリートリックオアトイズ,440689,0.3594758552957328
0,57812,6,一番くじトイストーリートリックオアトイズ,498501,0.40663386955603176
80,55238,7,一番くじトイストーリートリックオアトイズ,553739,0.45169223791745144
0,51752,8,一番くじトイストーリートリックオアトイズ,605491,0.4939070298983377
0,57288,9,一番くじトイストーリートリックオアトイズ,662779,0.5406376104169844
0,50566,10,一番くじトイストーリートリックオアトイズ,713345,0.5818849664864212
0,38239,11,一番くじトイストーリートリックオアトイズ,751584,0.6130770253548149
0,24767,12,一番くじトイストーリートリックオアトイズ,776351,0.6332797953538605
0,24610,13,一番くじトイストーリートリックオアトイズ,800961,0.6533544983730599
80,22558,14,一番くじトイストーリートリックオアトイズ,823519,0.6717553578085375
160,21039,15,一番くじトイストーリートリックオアトイズ,844558,0.688917148821172
2000,24128,16,一番くじトイストーリートリックオアトイズ,868686,0.7085986780551112
720,18990,17,一番くじトイストーリートリックオアトイズ,887676,0.7240890726237661
0,14059,18,一番くじトイストーリートリックオアトイズ,901735,0.7355571851693543
0,12470,19,一番くじトイストーリートリックオアトイズ,914205,0.7457291293647796
0,11996,20,一番くじトイストーリートリックオアトイズ,926201,0.7555144254809242
0,10226,21,一番くじトイストーリートリックオアトイズ,936427,0.7638559091491214
0,12446,22,一番くじトイストーリートリックオアトイズ,948873,0.7740082762266084
0,14497,23,一番くじトイストーリートリックオアトイズ,963370,0.7858336711745699
0,13977,24,一番くじトイストーリートリックオアトイズ,977347,0.797234895233869
0,9200,25,一番くじトイストーリートリックオアトイズ,986547,0.8047394571102053
0,8328,26,一番くじトイストーリートリックオアトイズ,994875,0.8115327170347845
0,8777,27,一番くじトイストーリートリックオアトイズ,1003652,0.8186922322074587
0,9671,28,一番くじトイストーリートリックオアトイズ,1013323,0.8265809950233335
0,7968,29,一番くじトイストーリートリックオアトイズ,1021291,0.8330805981788386
0,7778,30,一番くじトイストーリートリックオアトイズ,1029069,0.8394252158173324
0,7522,31,一番くじトイストーリートリックオアトイズ,1036591,0.8455610108644848
0,5673,32,一番くじトイストーリートリックオアトイズ,1042264,0.850188552117143
0,4084,33,一番くじトイストーリートリックオアトイズ,1046348,0.8535199250196382
0,3714,34,一番くじトイストーリートリックオアトイズ,1050062,0.8565494840205854
0,3493,35,一番くじトイストーリートリックオアトイズ,1053555,0.8593987703938508
0,3890,36,一番くじトイストーリートリックオアトイズ,1057445,0.8625718949263451
0,4638,37,一番くじトイストーリートリックオアトイズ,1062083,0.8663551729679155
0,4503,38,一番くじトイストーリートリックオアトイズ,1066586,0.8700283297210831
0,2724,39,一番くじトイストーリートリックオアトイズ,1069310,0.8722503326070766
0,2684,40,一番くじトイストーリートリックオアトイズ,1071994,0.874439706963173
0,2547,41,一番くじトイストーリートリックオアトイズ,1074541,0.8765173286043717
0,2537,42,一番くじトイストーリートリックオアトイズ,1077078,0.8785867931130962
0,2717,43,一番くじトイストーリートリックオアトイズ,1079795,0.8808030860063577
0,3061,44,一番くじトイストーリートリックオアトイズ,1082856,0.8832999842567343
0,2548,45,一番くじトイストーリートリックオアトイズ,1085404,0.8853784216111805
0,1665,46,一番くじトイストーリートリックオアトイズ,1087069,0.8867365841681478
0,1500,47,一番くじトイストーリートリックオアトイズ,1088569,0.8879601540392896
0,1592,48,一番くじトイストーリートリックオアトイズ,1090161,0.8892587695291948
0,1315,49,一番くじトイストーリートリックオアトイズ,1091476,0.8903314324495624
0,1293,50,一番くじトイストーリートリックオアトイズ,1092769,0.8913861496784866
0,1949,51,一番くじトイストーリートリックオアトイズ,1094718,0.8929759747977235
0,1796,52,一番くじトイストーリートリックオアトイズ,1096514,0.8944409957901039
0,1364,53,一番くじトイストーリートリックオアトイズ,1097878,0.8955536286595955
0,1235,54,一番くじトイストーリートリックオアトイズ,1099113,0.8965610345201689
0,1267,55,一番くじトイストーリートリックオアトイズ,1100380,0.89759454320466
0,1313,56,一番くじトイストーリートリックオアトイズ,1101693,0.8986655746985328
0,1222,57,一番くじトイストーリートリックオアトイズ,1102915,0.8996623762868896
0,1651,58,一番くじトイストーリートリックオアトイズ,1104566,0.901009118858393
0,1628,59,一番くじトイストーリートリックオアトイズ,1106194,0.9023371000252055
0,2197,0,一番くじカードキャプターさくらスイート,2197,0.010935571218094214
92400,28696,1,一番くじカードキャプターさくらスイート,30893,0.15376995978178631
108372,24264,2,一番くじカードキャプターさくらスイート,55157,0.2745440608449807
0,15114,3,一番くじカードキャプターさくらスイート,70271,0.34977402142316727
0,12332,4,一番くじカードキャプターさくらスイート,82603,0.4111565722932346
0,8378,5,一番くじカードキャプターさくらスイート,90981,0.4528580814717477
0,7325,6,一番くじカードキャプターさくらスイート,98306,0.48931828136821565
0,5950,7,一番くじカードキャプターさくらスイート,104256,0.5189344164377016
0,4823,8,一番くじカードキャプターさくらスイート,109079,0.5429409070999084
66,4827,9,一番くじカードキャプターさくらスイート,113906,0.5669673077688846
0,7038,10,一番くじカードキャプターさくらスイート,120944,0.601998964679648
0,6027,11,一番くじカードキャプターさくらスイート,126971,0.6319983673794449
66,3873,12,一番くじカードキャプターさくらスイート,130844,0.6512762314339187
0,3333,13,一番くじカードキャプターさくらスイート,134177,0.6678662445745231
0,2718,14,一番くじカードキャプターさくらスイート,136895,0.681395094174332
0,2797,15,一番くじカードキャプターさくらスイート,139692,0.6953171664078366
0,2790,16,一番くじカードキャプターさくらスイート,142482,0.7092043961294947
0,2871,17,一番くじカードキャプターさくらスイート,145353,0.7234948034882331
0,2753,18,一番くじカードキャプターさくらスイート,148106,0.7371978656472743
0,2420,19,一番くじカードキャプターさくらスイート,150526,0.7492434197427628
0,1881,20,一番くじカードキャプターさくらスイート,152407,0.7586061004260741
0,1977,21,一番くじカードキャプターさくらスイート,154384,0.7684466212718513
0,1761,22,一番くじカードキャプターさくらスイート,156145,0.7772120017520806
0,1745,23,一番くじカードキャプターさくらスイート,157890,0.7858977422052323
0,1624,24,一番くじカードキャプターさくらスイート,159514,0.7939812049536097
0,1894,25,一番くじカードキャプターさくらスイート,161408,0.8034085931589217
0,1739,26,一番くじカードキャプターさくらスイート,163147,0.8120644686019193
0,1285,27,一番くじカードキャプターさくらスイート,164432,0.8184605582765898
0,1457,28,一番くじカードキャプターさくらスイート,165889,0.8257127782423446
0,1241,29,一番くじカードキャプターさくらスイート,167130,0.8318898578425516
0,1080,30,一番くじカードキャプターさくらスイート,168210,0.8372655596702903
0,1361,31,一番くじカードキャプターさくらスイート,169571,0.8440399394735795
0,1259,32,一番くじカードキャプターさくらスイート,170830,0.8503066141042488
0,1117,33,一番くじカードキャプターさくらスイート,171947,0.8558664834946044
0,921,34,一番くじカードキャプターさくらスイート,172868,0.8604507625532593
0,774,35,一番くじカードキャプターさくらスイート,173642,0.8643033488631386
0,877,36,一番くじカードキャプターさくらスイート,174519,0.8686686178473301
0,721,37,一番くじカードキャプターさくらスイート,175240,0.8722573965675149
0,786,38,一番くじカードキャプターさくらスイート,176026,0.8761697128977024
0,955,39,一番くじカードキャプターさくらスイート,176981,0.8809232270138971
0,901,40,一番くじカードキャプターさくらスイート,177882,0.885407956038705
0,519,41,一番くじカードキャプターさくらスイート,178401,0.887991279417035
0,460,42,一番くじカードキャプターさくらスイート,178861,0.8902809301955162
0,592,43,一番くじカードキャプターさくらスイート,179453,0.8932276111973878
0,581,44,一番くじカードキャプターさくらスイート,180034,0.8961195396806435
0,617,45,一番くじカードキャプターさくらスイート,180651,0.8991906582248238
0,682,46,一番くじカードキャプターさくらスイート,181333,0.9025853143790069
0,418,47,一番くじカードキャプターさくらスイート,181751,0.9046659100864094
0,399,48,一番くじカードキャプターさくらスイート,182150,0.9066519332616573
0,419,49,一番くじカードキャプターさくらスイート,182569,0.9087375064707522
0,525,50,一番くじカードキャプターさくらスイート,183094,0.9113506948592363
0,423,51,一番くじカードキャプターさくらスイート,183517,0.9134561780751006
0,395,52,一番くじカードキャプターさくらスイート,183912,0.915422291243579
0,534,53,一番くじカードキャプターさくらスイート,184446,0.9180802771472942
0,450,54,一番くじカードキャプターさくらスイート,184896,0.9203201529088519
0,408,55,一番くじカードキャプターさくらスイート,185304,0.922350973599331
0,360,56,一番くじカードキャプターさくらスイート,185664,0.9241428742085772
0,351,57,一番くじカードキャプターさくらスイート,186015,0.9258899773025923
0,388,58,一番くじカードキャプターさくらスイート,186403,0.9278212479592243
0,419,59,一番くじカードキャプターさくらスイート,186822,0.9299068211683192
66,16926,0,一番くじワンピースジェネレーション,16926,0.01740444828330814
481998,156045,1,一番くじワンピースジェネレーション,172971,0.17786038189838665
490380,242531,2,一番くじワンピースジェネレーション,415502,0.42724702059618924
0,167343,3,一番くじワンピースジェネレーション,582845,0.5993203154723344
0,88141,4,一番くじワンピースジェネレーション,670986,0.6899528025418762
0,59804,5,一番くじワンピースジェネレーション,730790,0.7514472858890912
0,46264,6,一番くじワンピースジェネレーション,777054,0.7990190332233088
0,31278,7,一番くじワンピースジェネレーション,808332,0.8311811703735694
0,24958,8,一番くじワンピースジェネレーション,833290,0.856844659695016
0,23590,9,一番くじワンピースジェネレーション,856880,0.8811014796763015
0,16496,10,一番くじワンピースジェネレーション,873376,0.8980637731231556
0,8806,11,一番くじワンピースジェネレーション,882182,0.9071186928669114
0,7807,12,一番くじワンピースジェネレーション,889989,0.9151463738162076
0,6546,13,一番くじワンピースジェネレーション,896535,0.9218774100009255
66,5213,14,一番くじワンピースジェネレーション,901748,0.9272377661926355
0,6785,15,一番くじワンピースジェネレーション,908533,0.934214558205057
0,5598,16,一番くじワンピースジェネレーション,914131,0.9399707972154528
0,3951,17,一番くじワンピースジェネレーション,918082,0.9440334803755231
0,2871,18,一番くじワンピースジェネレーション,920953,0.9469856351091506
0,2042,19,一番くじワンピースジェネレーション,922995,0.9490853564487769
0,2191,20,一番くじワンピースジェネレーション,925186,0.9513382895805699
0,2055,21,一番くじワンピースジェネレーション,927241,0.953451378391996
0,1932,22,一番くじワンピースジェネレーション,929173,0.955437990354855
0,1789,23,一番くじワンピースジェネレーション,930962,0.9572775601279164
0,1832,24,一番くじワンピースジェネレーション,932794,0.9591613453846233
0,1065,25,一番くじワンピースジェネレーション,933859,0.9602564498051434
0,972,26,一番くじワンピースジェネレーション,934831,0.961255925388942
0,915,27,一番くじワンピースジェネレーション,935746,0.9621967897502339
0,793,28,一番くじワンピースジェネレーション,936539,0.9630122055300202
0,948,29,一番くじワンピースジェネレーション,937487,0.9639870027043423
0,1004,30,一番くじワンピースジェネレーション,938491,0.9650193828341097
0,959,31,一番くじワンピースジェネレーション,939450,0.9660054909461085
0,753,32,一番くじワンピースジェネレーション,940203,0.966779776043434
0,667,33,一番くじワンピースジェネレーション,940870,0.9674656301734686
0,567,34,一番くじワンピースジェネレーション,941437,0.9680486575973511
0,446,35,一番くじワンピースジェネレーション,941883,0.9685072647067896
0,636,36,一番くじワンピースジェネレーション,942519,0.9691612425579171
0,684,37,一番くじワンピースジェネレーション,943203,0.9698645772279977
0,445,38,一番くじワンピースジェネレーション,943648,0.9703221560703746
0,312,39,一番くじワンピースジェネレーション,943960,0.9706429753935693
0,371,40,一番くじワンピースジェネレーション,944331,0.9710244624733936
0,363,41,一番くじワンピースジェネレーション,944694,0.9713977234167258
0,252,42,一番くじワンピースジェネレーション,944946,0.9716568467162291
0,426,43,一番くじワンピースジェネレーション,945372,0.9720948884844371
0,417,44,一番くじワンピースジェネレーション,945789,0.9725236758490915
0,364,45,一番くじワンピースジェネレーション,946153,0.9728979650594852
0,347,46,一番くじワンピースジェネレーション,946500,0.9732547737298332
0,308,47,一番くじワンピースジェネレーション,946808,0.9735714799847817
0,221,48,一番くじワンピースジェネレーション,947029,0.9737987270053778
0,316,49,一番くじワンピースジェネレーション,947345,0.9741236593968186
0,215,50,一番くじワンピースジェネレーション,947560,0.9743447368150456
0,352,51,一番くじワンピースジェネレーション,947912,0.974706686820701
0,296,52,一番くじワンピースジェネレーション,948208,0.9750110538709114
0,149,53,一番くじワンピースジェネレーション,948357,0.975164265663078
0,213,54,一番くじワンピースジェネレーション,948570,0.975383286547182
0,246,55,一番くじワンピースジェネレーション,948816,0.9756362402443163
0,162,56,一番くじワンピースジェネレーション,948978,0.9758028195082827
0,103,57,一番くじワンピースジェネレーション,949081,0.9759087310156194
0,194,58,一番くじワンピースジェネレーション,949275,0.9761082148255545
0,153,59,一番くじワンピースジェネレーション,949428,0.9762655396859672
560,2,0,一番くじラブライブ！第５弾※,2,0.0035714285714285713
0,10,1,一番くじラブライブ！第５弾※,12,0.02142857142857143
0,52,2,一番くじラブライブ！第５弾※,64,0.11428571428571428
0,98,3,一番くじラブライブ！第５弾※,162,0.2892857142857143
0,63,4,一番くじラブライブ！第５弾※,225,0.4017857142857143
0,11,5,一番くじラブライブ！第５弾※,236,0.42142857142857143
0,2,6,一番くじラブライブ！第５弾※,238,0.425
0,4,7,一番くじラブライブ！第５弾※,242,0.43214285714285716
0,15,8,一番くじラブライブ！第５弾※,257,0.4589285714285714
0,6,9,一番くじラブライブ！第５弾※,263,0.46964285714285714
0,9,10,一番くじラブライブ！第５弾※,272,0.4857142857142857
0,10,11,一番くじラブライブ！第５弾※,282,0.5035714285714286
0,10,12,一番くじラブライブ！第５弾※,292,0.5214285714285715
0,2,13,一番くじラブライブ！第５弾※,294,0.525
0,5,14,一番くじラブライブ！第５弾※,299,0.5339285714285714
0,5,15,一番くじラブライブ！第５弾※,304,0.5428571428571428
0,1,16,一番くじラブライブ！第５弾※,305,0.5446428571428571
0,5,17,一番くじラブライブ！第５弾※,310,0.5535714285714286
0,11,18,一番くじラブライブ！第５弾※,321,0.5732142857142857
0,0,19,一番くじラブライブ！第５弾※,321,0.5732142857142857
0,0,20,一番くじラブライブ！第５弾※,321,0.5732142857142857
0,3,21,一番くじラブライブ！第５弾※,324,0.5785714285714286
0,0,22,一番くじラブライブ！第５弾※,324,0.5785714285714286
0,1,23,一番くじラブライブ！第５弾※,325,0.5803571428571429
0,0,24,一番くじラブライブ！第５弾※,325,0.5803571428571429
0,0,25,一番くじラブライブ！第５弾※,325,0.5803571428571429
0,3,26,一番くじラブライブ！第５弾※,328,0.5857142857142857
0,0,27,一番くじラブライブ！第５弾※,328,0.5857142857142857
0,0,28,一番くじラブライブ！第５弾※,328,0.5857142857142857
0,1,29,一番くじラブライブ！第５弾※,329,0.5875
0,0,30,一番くじラブライブ！第５弾※,329,0.5875
0,1,31,一番くじラブライブ！第５弾※,330,0.5892857142857143
0,0,32,一番くじラブライブ！第５弾※,330,0.5892857142857143
0,6,33,一番くじラブライブ！第５弾※,336,0.6
0,2,34,一番くじラブライブ！第５弾※,338,0.6035714285714285
0,2,35,一番くじラブライブ！第５弾※,340,0.6071428571428571
0,6,36,一番くじラブライブ！第５弾※,346,0.6178571428571429
0,5,37,一番くじラブライブ！第５弾※,351,0.6267857142857143
0,2,38,一番くじラブライブ！第５弾※,353,0.6303571428571428
0,3,39,一番くじラブライブ！第５弾※,356,0.6357142857142857
0,0,40,一番くじラブライブ！第５弾※,356,0.6357142857142857
0,7,41,一番くじラブライブ！第５弾※,363,0.6482142857142857
0,4,42,一番くじラブライブ！第５弾※,367,0.6553571428571429
0,4,43,一番くじラブライブ！第５弾※,371,0.6625
0,3,44,一番くじラブライブ！第５弾※,374,0.6678571428571428
0,1,45,一番くじラブライブ！第５弾※,375,0.6696428571428571
0,0,46,一番くじラブライブ！第５弾※,375,0.6696428571428571
0,0,47,一番くじラブライブ！第５弾※,375,0.6696428571428571
0,0,48,一番くじラブライブ！第５弾※,375,0.6696428571428571
0,1,49,一番くじラブライブ！第５弾※,376,0.6714285714285714
0,0,50,一番くじラブライブ！第５弾※,376,0.6714285714285714
0,0,51,一番くじラブライブ！第５弾※,376,0.6714285714285714
0,0,52,一番くじラブライブ！第５弾※,376,0.6714285714285714
0,1,53,一番くじラブライブ！第５弾※,377,0.6732142857142858
0,3,54,一番くじラブライブ！第５弾※,380,0.6785714285714286
0,0,55,一番くじラブライブ！第５弾※,380,0.6785714285714286
0,2,56,一番くじラブライブ！第５弾※,382,0.6821428571428572
0,0,57,一番くじラブライブ！第５弾※,382,0.6821428571428572
0,0,58,一番くじラブライブ！第５弾※,382,0.6821428571428572
0,1,59,一番くじラブライブ！第５弾※,383,0.6839285714285714
0,1960,0,一番くじディズニーガールズプロジェクト,1960,0.005044642512437875
196381,23876,1,一番くじディズニーガールズプロジェクト,25836,0.06649662446497191
192120,46199,2,一番くじディズニーガールズプロジェクト,72035,0.18540348131809303
0,38916,3,一番くじディズニーガールズプロジェクト,110951,0.2855653731619871
0,27325,4,一番くじディズニーガールズプロジェクト,138276,0.3558943816580916
0,23460,5,一番くじディズニーガールズプロジェクト,161736,0.4162756639753327
30,20432,6,一番くじディズニーガールズプロジェクト,182168,0.46886348837029734
0,16469,7,一番くじディズニーガールズプロジェクト,198637,0.5112513544607766
0,14571,8,一番くじディズニーガールズプロジェクト,213208,0.5487541534652318
0,15483,9,一番くじディズニーガールズプロジェクト,228691,0.5886042555162908
0,11756,10,一番くじディズニーガールズプロジェクト,240447,0.6188618154021172
0,8615,11,一番くじディズニーガールズプロジェクト,249062,0.6410350782820419
0,7777,12,一番くじディズニーガールズプロジェクト,256839,0.6610514991081793
0,7259,13,一番くじディズニーガールズプロジェクト,264098,0.679734692984601
0,8950,14,一番くじディズニーガールズプロジェクト,273048,0.7027701779266005
0,7702,15,一番くじディズニーガールズプロジェクト,280750,0.7225935639627211
0,6827,16,一番くじディズニーガールズプロジェクト,287577,0.7401648774486463
0,5495,17,一番くじディズニーガールズプロジェクト,293072,0.7543078930638739
0,3802,18,一番くじディズニーガールズプロジェクト,296874,0.7640934700191233
0,3662,19,一番くじディズニーガールズプロジェクト,300536,0.7735187153663414
0,3734,20,一番くじディズニーガールズプロジェクト,304270,0.7831292741119756
0,2864,21,一番くじディズニーガールズプロジェクト,307134,0.7905006292934155
0,3081,22,一番くじディズニーガールズプロジェクト,310215,0.7984304984673037
0,3342,23,一番くじディズニーガールズプロジェクト,313557,0.8070321287104504
0,3019,24,一番くじディズニーガールズプロジェクト,316576,0.8148024224579249
0,2756,25,一番くじディズニーガールズプロジェクト,319332,0.8218958075417405
0,2560,26,一番くじディズニーガールズプロジェクト,321892,0.8284847283743125
0,2053,27,一番くじディズニーガールズプロジェクト,323945,0.8337687340263711
0,2030,28,一番くじディズニーガールズプロジェクト,325975,0.8389935423428246
0,2252,29,一番くじディズニーガールズプロジェクト,328227,0.8447897336377278
0,2153,30,一番くじディズニーガールズプロジェクト,330380,0.8503311190098087
0,2028,31,一番くじディズニーガールズプロジェクト,332408,0.8555507797318618
0,1782,32,一番くじディズニーガールズプロジェクト,334190,0.86013728634266
0,1466,33,一番くじディズニーガールズプロジェクト,335656,0.8639104730381875
0,1447,34,一番くじディズニーガールズプロジェクト,337103,0.8676347575869107
0,1361,35,一番くじディズニーガールズプロジェクト,338464,0.8711376955764147
0,1401,36,一番くじディズニーガールズプロジェクト,339865,0.8747435854539277
0,1259,37,一番くじディズニーガールズプロジェクト,341124,0.877983996129009
0,1206,38,一番くじディズニーガールズプロジェクト,342330,0.8810879955524784
0,879,39,一番くじディズニーガールズプロジェクト,343209,0.8833503632914748
0,814,40,一番くじディズニーガールズプロジェクト,344023,0.8854454342124567
0,778,41,一番くじディズニーガールズプロジェクト,344801,0.8874478484342305
0,817,42,一番くじディズニーガールズプロジェクト,345618,0.889550640746813
0,788,43,一番くじディズニーガールズプロジェクト,346406,0.8915787929405891
0,1024,44,一番くじディズニーガールズプロジェクト,347430,0.8942143612736178
0,1018,45,一番くじディズニーガールズプロジェクト,348448,0.8968344868234452
0,734,46,一番くじディズニーガールズプロジェクト,349182,0.8987236539684093
0,617,47,一番くじディズニーガールズプロジェクト,349799,0.9003116868409471
0,677,48,一番くじディズニーガールズプロジェクト,350476,0.9020541475454983
0,545,49,一番くじディズニーガールズプロジェクト,351021,0.90345686701962
0,732,50,一番くじディズニーガールズプロジェクト,351753,0.9053408865701836
0,737,51,一番くじディズニーガールズプロジェクト,352490,0.9072377751067482
0,580,52,一番くじディズニーガールズプロジェクト,353070,0.9087305774828778
0,441,53,一番くじディズニーガールズプロジェクト,353511,0.9098656220481763
0,390,54,一番くじディズニーガールズプロジェクト,353901,0.9108694029562635
0,342,55,一番くじディズニーガールズプロジェクト,354243,0.9117496415987398
0,498,56,一番くじディズニーガールズプロジェクト,354741,0.9130313926044511
0,365,57,一番くじディズニーガールズプロジェクト,355106,0.9139708285825326
0,475,58,一番くじディズニーガールズプロジェクト,355581,0.9151933822526388
0,450,59,一番くじディズニーガールズプロジェクト,356031,0.9163515909927393
0,2217,0,一番くじヱヴァンゲリヲン新劇場版リフトオフ,2217,0.002124662181588178
1042734,29207,1,一番くじヱヴァンゲリヲン新劇場版リフトオフ,31424,0.03011519368255611
0,113381,2,一番くじヱヴァンゲリヲン新劇場版リフトオフ,144805,0.13877388687635367
0,107674,3,一番くじヱヴァンゲリヲン新劇場版リフトオフ,252479,0.2419632760239971
0,87488,4,一番くじヱヴァンゲリヲン新劇場版リフトオフ,339967,0.32580740996300767
66,61402,5,一番くじヱヴァンゲリヲン新劇場版リフトオフ,401369,0.3846520230770705
0,52102,6,一番くじヱヴァンゲリヲン新劇場版リフトオフ,453471,0.43458398021965383
66,46150,7,一番くじヱヴァンゲリヲン新劇場版リフトオフ,499621,0.4788118375404903
396,39354,8,一番くじヱヴァンゲリヲン新劇場版リフトオフ,538975,0.5165267475514155
0,37772,9,一番くじヱヴァンゲリヲン新劇場版リフトオフ,576747,0.5527255476970847
66,39738,10,一番くじヱヴァンゲリヲン新劇場版リフトオフ,616485,0.5908084641481226
0,34457,11,一番くじヱヴァンゲリヲン新劇場版リフトオフ,650942,0.6238303336975064
0,26582,12,一番くじヱヴァンゲリヲン新劇場版リフトオフ,677524,0.6493051961742664
0,22817,13,一番くじヱヴァンゲリヲン新劇場版リフトオフ,700341,0.6711718705077339
66,19960,14,一番くじヱヴァンゲリヲン新劇場版リフトオフ,720301,0.6903005385927588
0,18268,15,一番くじヱヴァンゲリヲン新劇場版リフトオフ,738569,0.707807678301037
0,18720,16,一番くじヱヴァンゲリヲン新劇場版リフトオフ,757289,0.7257479922565312
0,19569,17,一番くじヱヴァンゲリヲン新劇場版リフトオフ,776858,0.744501945450712
0,16785,18,一番くじヱヴァンゲリヲン新劇場版リフトオフ,793643,0.7605878519540759
66,11351,19,一番くじヱヴァンゲリヲン新劇場版リフトオフ,804994,0.7714660839898032
0,9602,20,一番くじヱヴァンゲリヲン新劇場版リフトオフ,814596,0.7806681616928296
0,8940,21,一番くじヱヴァンゲリヲン新劇場版リフトオフ,823536,0.7892358116267034
0,7208,22,一番くじヱヴァンゲリヲン新劇場版リフトオフ,830744,0.7961435991796523
0,8048,23,一番くじヱヴァンゲリヲン新劇場版リフトオフ,838792,0.8038564008203477
0,8433,24,一番くじヱヴァンゲリヲン新劇場版リフトオフ,847225,0.8119381672512602
0,7845,25,一番くじヱヴァンゲリヲン新劇場版リフトオフ,855070,0.8194564238207502
0,5311,26,一番くじヱヴァンゲリヲン新劇場版リフトオフ,860381,0.8245462212255381
0,4384,27,一番くじヱヴァンゲリヲン新劇場版リフトオフ,864765,0.8287476280834914
0,5525,28,一番くじヱヴァンゲリヲン新劇場版リフトオフ,870290,0.8340425124106339
0,4901,29,一番くじヱヴァンゲリヲン新劇場版リフトオフ,875191,0.8387393862725931
0,5056,30,一番くじヱヴァンゲリヲン新劇場版リフトオフ,880247,0.8435848044007437
0,5868,31,一番くじヱヴァンゲリヲン新劇場版リフトオフ,886115,0.8492084028137159
0,4777,32,一番くじヱヴァンゲリヲン新劇場版リフトオフ,890892,0.8537864412627221
0,3990,33,一番くじヱヴァンゲリヲン新劇場版リフトオフ,894882,0.8576102581795182
0,3183,34,一番くじヱヴァンゲリヲン新劇場版リフトオフ,898065,0.8606606865620149
0,3208,35,一番くじヱヴァンゲリヲン新劇場版リフトオフ,901273,0.863735073697123
0,3068,36,一番くじヱヴァンゲリヲン新劇場版リフトオフ,904341,0.8666752918176068
0,3060,37,一番くじヱヴァンゲリヲン新劇場版リフトオフ,907401,0.8696078431372549
0,2715,38,一番くじヱヴァンゲリヲン新劇場版リフトオフ,910116,0.8722097636708642
0,2897,39,一番くじヱヴァンゲリヲン新劇場版リフトオフ,913013,0.8749861039234853
0,2340,40,一番くじヱヴァンゲリヲン新劇場版リフトオフ,915353,0.8772286431679222
0,2365,41,一番くじヱヴァンゲリヲン新劇場版リフトオフ,917718,0.8794951411649704
0,2043,42,一番くじヱヴァンゲリヲン新劇場版リフトオフ,919761,0.8814530504283825
0,2379,43,一番くじヱヴァンゲリヲン新劇場版リフトオフ,922140,0.8837329653268933
0,2539,44,一番くじヱヴァンゲリヲン新劇場版リフトオフ,924679,0.8861662162421176
0,2185,45,一番くじヱヴァンゲリヲン新劇場版リフトオフ,926864,0.888260211220363
0,2289,46,一番くじヱヴァンゲリヲン新劇場版リフトオフ,929153,0.8904538746094723
0,2089,47,一番くじヱヴァンゲリヲン新劇場版リフトオフ,931242,0.8924558679776896
0,2160,48,一番くじヱヴァンゲリヲン新劇場版リフトオフ,933402,0.8945259042033236
0,1873,49,一番くじヱヴァンゲリヲン新劇場版リフトオフ,935275,0.8963208939489774
0,2203,50,一番くじヱヴァンゲリヲン新劇場版リフトオフ,937478,0.8984321392291031
0,1911,51,一番くじヱヴァンゲリヲン新劇場版リフトオフ,939389,0.9002635462787265
0,1843,52,一番くじヱヴァンゲリヲン新劇場版リフトオフ,941232,0.9020297855212466
0,1397,53,一番くじヱヴァンゲリヲン新劇場版リフトオフ,942629,0.9033686006171775
0,1485,54,一番くじヱヴァンゲリヲン新劇場版リフトオフ,944114,0.9047917505223008
0,1334,55,一番くじヱヴァンゲリヲン新劇場版リフトオフ,945448,0.9060701895616506
0,1129,56,一番くじヱヴァンゲリヲン新劇場版リフトオフ,946577,0.9071521668295862
0,961,57,一番くじヱヴァンゲリヲン新劇場版リフトオフ,947538,0.9080731412799724
0,1144,58,一番くじヱヴァンゲリヲン新劇場版リフトオフ,948682,0.9091694937994749
0,1681,59,一番くじヱヴァンゲリヲン新劇場版リフトオフ,950363,0.9107804803250723
80,7383,0,一番くじ機動戦士ガンダムガンプラ４０周年,7383,0.007390087093522688
480241,118754,1,一番くじ機動戦士ガンダムガンプラ４０周年,126137,0.12625808150015866
518640,173574,2,一番くじ機動戦士ガンダムガンプラ４０周年,299711,0.2999986987521033
0,148744,3,一番くじ機動戦士ガンダムガンプラ４０周年,448455,0.4488854811764482
0,134609,4,一番くじ機動戦士ガンダムガンプラ４０周年,583064,0.5836236951236236
80,93307,5,一番くじ機動戦士ガンダムガンプラ４０周年,676371,0.677020262431672
0,63819,6,一番くじ機動戦士ガンダムガンプラ４０周年,740190,0.7409005236021344
0,41032,7,一番くじ機動戦士ガンダムガンプラ４０周年,781222,0.7819719110627091
0,37911,8,一番くじ機動戦士ガンダムガンプラ４０周年,819133,0.8199193026112042
0,27239,9,一番くじ機動戦士ガンダムガンプラ４０周年,846372,0.847184449887442
0,21764,10,一番くじ機動戦士ガンダムガンプラ４０周年,868136,0.8689693415985931
0,22515,11,一番くじ機動戦士ガンダムガンプラ４０周年,890651,0.8915059542100875
0,14730,12,一番くじ機動戦士ガンダムガンプラ４０周年,905381,0.9062500938399926
0,8737,13,一番くじ機動戦士ガンダムガンプラ４０周年,914118,0.9149954806659587
0,7076,14,一番くじ機動戦士ガンダムガンプラ４０周年,921194,0.9220782730638682
0,6189,15,一番くじ機動戦士ガンダムガンプラ４０周年,927383,0.9282732140122377
0,4672,16,一番くじ機動戦士ガンダムガンプラ４０周年,932055,0.9329496987611119
0,5052,17,一番くじ機動戦士ガンダムガンプラ４０周年,937107,0.9380065482798003
0,5257,18,一番くじ機動戦士ガンダムガンプラ４０周年,942364,0.9432685945822044
0,4559,19,一番くじ機動戦士ガンダムガンプラ４０周年,946923,0.9478319708600548
0,3097,20,一番くじ機動戦士ガンダムガンプラ４０周年,950020,0.950931943734041
0,2716,21,一番くじ機動戦士ガンダムガンプラ４０周年,952736,0.9536505508782923
0,2466,22,一番くじ機動戦士ガンダムガンプラ４０周年,955202,0.9561189180424027
0,2280,23,一番くじ機動戦士ガンダムガンプラ４０周年,957482,0.9584011066612882
0,2214,24,一番くじ機動戦士ガンダムガンプラ４０周年,959696,0.9606172319254165
0,2026,25,一番くじ機動戦士ガンダムガンプラ４０周年,961722,0.9626451767244788
0,1861,26,一番くじ機動戦士ガンダムガンプラ４０周年,963583,0.964507963136648
0,1132,27,一番くじ機動戦士ガンダムガンプラ４０周年,964715,0.9656410497667263
0,1191,28,一番くじ機動戦士ガンダムガンプラ４０周年,965906,0.9668331930321178
0,854,29,一番くじ機動戦士ガンダムガンプラ４０周年,966760,0.9676880128042793
0,850,30,一番くじ機動戦士ガンダムガンプラ４０周年,967610,0.9685388287367586
0,1092,31,一番くじ機動戦士ガンダムガンプラ４０周年,968702,0.9696318769700143
0,1121,32,一番くじ機動戦士ガンダムガンプラ４０周年,969823,0.9707539530409662
0,987,33,一番くじ機動戦士ガンダムガンプラ４０周年,970810,0.9717419004825628
0,658,34,一番くじ機動戦士ガンダムガンプラ４０周年,971468,0.9724005321102938
0,567,35,一番くじ機動戦士ガンダムガンプラ４０周年,972035,0.9729680763852535
0,581,36,一番くじ機動戦士ガンダムガンプラ４０周年,972616,0.973549634099101
0,490,37,一番くじ機動戦士ガンダムガンプラ４０周年,973106,0.9740401044601773
0,554,38,一番くじ機動戦士ガンダムガンプラ４０周年,973660,0.9745946362561697
0,701,39,一番くじ機動戦士ガンダムガンプラ４０周年,974361,0.9752963091604849
0,524,40,一番くじ機動戦士ガンダムガンプラ４０周年,974885,0.9758208121588603
0,0,41,一番くじ機動戦士ガンダムガンプラ４０周年,974885,0.9758208121588603
0,0,42,一番くじ機動戦士ガンダムガンプラ４０周年,974885,0.9758208121588603
0,0,43,一番くじ機動戦士ガンダムガンプラ４０周年,974885,0.9758208121588603
0,0,44,一番くじ機動戦士ガンダムガンプラ４０周年,974885,0.9758208121588603
0,0,45,一番くじ機動戦士ガンダムガンプラ４０周年,974885,0.9758208121588603
0,401,46,一番くじ機動戦士ガンダムガンプラ４０周年,975286,0.9762221970870064
0,348,47,一番くじ機動戦士ガンダムガンプラ４０周年,975634,0.9765705311393627
0,255,48,一番くじ機動戦士ガンダムガンプラ４０周年,975889,0.9768257759191065
0,193,49,一番くじ機動戦士ガンダムガンプラ４０周年,976082,0.9770189611837753
0,240,50,一番くじ機動戦士ガンダムガンプラ４０周年,976322,0.9772591915647105
0,312,51,一番くじ機動戦士ガンダムガンプラ４０周年,976634,0.9775714910599265
0,363,52,一番くじ機動戦士ガンダムガンプラ４０周年,976997,0.9779348395110912
0,376,53,一番くじ機動戦士ガンダムガンプラ４０周年,977373,0.9783112004412231
0,231,54,一番くじ機動戦士ガンダムガンプラ４０周年,977604,0.9785424221828734
0,213,55,一番くじ機動戦士ガンダムガンプラ４０周年,977817,0.9787556266459535
0,177,56,一番くじ機動戦士ガンダムガンプラ４０周年,977994,0.9789327965518932
0,169,57,一番くじ機動戦士ガンダムガンプラ４０周年,978163,0.9791019587784685
0,180,58,一番くじ機動戦士ガンダムガンプラ４０周年,978343,0.97928213156417
0,233,59,一番くじ機動戦士ガンダムガンプラ４０周年,978576,0.9795153552256614
80,6869,0,一番くじワンピースベストエディション,6869,0.005667491749174918
621680,100572,1,一番くじワンピースベストエディション,107441,0.0886476897689769
589920,157553,2,一番くじワンピースベストエディション,264994,0.21864191419141915
80,119115,3,一番くじワンピースベストエディション,384109,0.3169216171617162
80,103084,4,一番くじワンピースベストエディション,487193,0.40197442244224424
80,104214,5,一番くじワンピースベストエディション,591407,0.4879595709570957
80,86507,6,一番くじワンピースベストエディション,677914,0.5593349834983499
0,78949,7,一番くじワンピースベストエディション,756863,0.6244744224422443
0,71365,8,一番くじワンピースベストエディション,828228,0.6833564356435644
0,58716,9,一番くじワンピースベストエディション,886944,0.7318019801980198
0,37909,10,一番くじワンピースベストエディション,924853,0.7630800330033003
0,34284,11,一番くじワンピースベストエディション,959137,0.7913671617161716
0,28355,12,一番くじワンピースベストエディション,987492,0.8147623762376237
0,21329,13,一番くじワンピースベストエディション,1008821,0.8323605610561056
0,20901,14,一番くじワンピースベストエディション,1029722,0.8496056105610561
0,19083,15,一番くじワンピースベストエディション,1048805,0.8653506600660066
0,16103,16,一番くじワンピースベストエディション,1064908,0.8786369636963697
0,10642,17,一番くじワンピースベストエディション,1075550,0.887417491749175
0,9304,18,一番くじワンピースベストエディション,1084854,0.8950940594059406
0,7999,19,一番くじワンピースベストエディション,1092853,0.9016938943894389
0,7469,20,一番くじワンピースベストエディション,1100322,0.9078564356435643
0,6990,21,一番くじワンピースベストエディション,1107312,0.9136237623762377
0,7517,22,一番くじワンピースベストエディション,1114829,0.9198259075907591
0,6598,23,一番くじワンピースベストエディション,1121427,0.925269801980198
0,5837,24,一番くじワンピースベストエディション,1127264,0.9300858085808581
0,5155,25,一番くじワンピースベストエディション,1132419,0.9343391089108911
0,5170,26,一番くじワンピースベストエディション,1137589,0.9386047854785479
0,3877,27,一番くじワンピースベストエディション,1141466,0.9418036303630363
0,3320,28,一番くじワンピースベストエディション,1144786,0.9445429042904291
0,3231,29,一番くじワンピースベストエディション,1148017,0.9472087458745875
0,2949,30,一番くじワンピースベストエディション,1150966,0.9496419141914192
0,2095,31,一番くじワンピースベストエディション,1153061,0.9513704620462046
0,2051,32,一番くじワンピースベストエディション,1155112,0.9530627062706271
0,2046,33,一番くじワンピースベストエディション,1157158,0.9547508250825083
0,1720,34,一番くじワンピースベストエディション,1158878,0.9561699669966996
0,2169,35,一番くじワンピースベストエディション,1161047,0.9579595709570957
0,2307,36,一番くじワンピースベストエディション,1163354,0.9598630363036303
0,2060,37,一番くじワンピースベストエディション,1165414,0.961562706270627
0,1312,38,一番くじワンピースベストエディション,1166726,0.9626452145214521
0,1433,39,一番くじワンピースベストエディション,1168159,0.9638275577557756
0,1553,40,一番くじワンピースベストエディション,1169712,0.9651089108910891
0,1199,41,一番くじワンピースベストエディション,1170911,0.9660981848184819
0,1151,42,一番くじワンピースベストエディション,1172062,0.9670478547854785
0,1185,43,一番くじワンピースベストエディション,1173247,0.9680255775577558
0,1034,44,一番くじワンピースベストエディション,1174281,0.9688787128712871
0,635,45,一番くじワンピースベストエディション,1174916,0.9694026402640264
0,700,46,一番くじワンピースベストエディション,1175616,0.969980198019802
0,647,47,一番くじワンピースベストエディション,1176263,0.9705140264026403
0,545,48,一番くじワンピースベストエディション,1176808,0.970963696369637
0,591,49,一番くじワンピースベストエディション,1177399,0.9714513201320132
0,694,50,一番くじワンピースベストエディション,1178093,0.9720239273927392
0,809,51,一番くじワンピースベストエディション,1178902,0.9726914191419141
0,358,52,一番くじワンピースベストエディション,1179260,0.972986798679868
0,410,53,一番くじワンピースベストエディション,1179670,0.9733250825082508
0,445,54,一番くじワンピースベストエディション,1180115,0.9736922442244225
0,328,55,一番くじワンピースベストエディション,1180443,0.9739628712871287
0,383,56,一番くじワンピースベストエディション,1180826,0.9742788778877888
0,427,57,一番くじワンピースベストエディション,1181253,0.9746311881188119
0,391,58,一番くじワンピースベストエディション,1181644,0.974953795379538
0,330,59,一番くじワンピースベストエディション,1181974,0.9752260726072607
0,34,0,一番くじ鋼の錬金術師＊,34,0.0028333333333333335
4000,195,1,一番くじ鋼の錬金術師＊,229,0.019083333333333334
8000,485,2,一番くじ鋼の錬金術師＊,714,0.0595
0,688,3,一番くじ鋼の錬金術師＊,1402,0.11683333333333333
0,745,4,一番くじ鋼の錬金術師＊,2147,0.17891666666666667
0,485,5,一番くじ鋼の錬金術師＊,2632,0.21933333333333332
0,531,6,一番くじ鋼の錬金術師＊,3163,0.26358333333333334
0,364,7,一番くじ鋼の錬金術師＊,3527,0.29391666666666666
0,291,8,一番くじ鋼の錬金術師＊,3818,0.31816666666666665
0,259,9,一番くじ鋼の錬金術師＊,4077,0.33975
0,270,10,一番くじ鋼の錬金術師＊,4347,0.36225
0,317,11,一番くじ鋼の錬金術師＊,4664,0.38866666666666666
0,371,12,一番くじ鋼の錬金術師＊,5035,0.4195833333333333
0,234,13,一番くじ鋼の錬金術師＊,5269,0.4390833333333333
0,237,14,一番くじ鋼の錬金術師＊,5506,0.4588333333333333
0,204,15,一番くじ鋼の錬金術師＊,5710,0.47583333333333333
0,188,16,一番くじ鋼の錬金術師＊,5898,0.4915
0,177,17,一番くじ鋼の錬金術師＊,6075,0.50625
0,159,18,一番くじ鋼の錬金術師＊,6234,0.5195
0,175,19,一番くじ鋼の錬金術師＊,6409,0.5340833333333334
0,178,20,一番くじ鋼の錬金術師＊,6587,0.5489166666666667
0,171,21,一番くじ鋼の錬金術師＊,6758,0.5631666666666667
0,119,22,一番くじ鋼の錬金術師＊,6877,0.5730833333333333
0,123,23,一番くじ鋼の錬金術師＊,7000,0.5833333333333334
0,95,24,一番くじ鋼の錬金術師＊,7095,0.59125
0,111,25,一番くじ鋼の錬金術師＊,7206,0.6005
0,123,26,一番くじ鋼の錬金術師＊,7329,0.61075
0,61,27,一番くじ鋼の錬金術師＊,7390,0.6158333333333333
0,96,28,一番くじ鋼の錬金術師＊,7486,0.6238333333333334
0,47,29,一番くじ鋼の錬金術師＊,7533,0.62775
0,74,30,一番くじ鋼の錬金術師＊,7607,0.6339166666666667
0,66,31,一番くじ鋼の錬金術師＊,7673,0.6394166666666666
0,47,32,一番くじ鋼の錬金術師＊,7720,0.6433333333333333
0,75,33,一番くじ鋼の錬金術師＊,7795,0.6495833333333333
0,95,34,一番くじ鋼の錬金術師＊,7890,0.6575
0,38,35,一番くじ鋼の錬金術師＊,7928,0.6606666666666666
0,49,36,一番くじ鋼の錬金術師＊,7977,0.66475
0,57,37,一番くじ鋼の錬金術師＊,8034,0.6695
0,32,38,一番くじ鋼の錬金術師＊,8066,0.6721666666666667
0,24,39,一番くじ鋼の錬金術師＊,8090,0.6741666666666667
0,14,40,一番くじ鋼の錬金術師＊,8104,0.6753333333333333
0,11,41,一番くじ鋼の錬金術師＊,8115,0.67625
0,4,42,一番くじ鋼の錬金術師＊,8119,0.6765833333333333
0,10,43,一番くじ鋼の錬金術師＊,8129,0.6774166666666667
0,10,44,一番くじ鋼の錬金術師＊,8139,0.67825
0,1,45,一番くじ鋼の錬金術師＊,8140,0.6783333333333333
0,4,46,一番くじ鋼の錬金術師＊,8144,0.6786666666666666
0,11,47,一番くじ鋼の錬金術師＊,8155,0.6795833333333333
0,23,48,一番くじ鋼の錬金術師＊,8178,0.6815
0,6,49,一番くじ鋼の錬金術師＊,8184,0.682
0,6,50,一番くじ鋼の錬金術師＊,8190,0.6825
0,14,51,一番くじ鋼の錬金術師＊,8204,0.6836666666666666
0,5,52,一番くじ鋼の錬金術師＊,8209,0.6840833333333334
0,0,53,一番くじ鋼の錬金術師＊,8209,0.6840833333333334
0,6,54,一番くじ鋼の錬金術師＊,8215,0.6845833333333333
0,3,55,一番くじ鋼の錬金術師＊,8218,0.6848333333333333
0,0,56,一番くじ鋼の錬金術師＊,8218,0.6848333333333333
0,6,57,一番くじ鋼の錬金術師＊,8224,0.6853333333333333
0,6,58,一番くじ鋼の錬金術師＊,8230,0.6858333333333333
0,2,59,一番くじ鋼の錬金術師＊,8232,0.686
0,5075,0,一番くじ夏目友人帳時の記憶,5075,0.010515083706282116
236640,55502,1,一番くじ夏目友人帳時の記憶,60577,0.12551176860600033
239760,79467,2,一番くじ夏目友人帳時の記憶,140044,0.2901624399138074
0,59768,3,一番くじ夏目友人帳時の記憶,199812,0.4139980109398309
0,48131,4,一番くじ夏目友人帳時の記憶,247943,0.5137224432289077
0,40083,5,一番くじ夏目友人帳時の記憶,288026,0.5967719211006133
0,32220,6,一番くじ夏目友人帳時の記憶,320246,0.663529753025029
60,26330,7,一番くじ夏目友人帳時の記憶,346576,0.7180838720371291
0,24016,8,一番くじ夏目友人帳時の記憶,370592,0.7678435272666998
6000,17940,9,一番くじ夏目友人帳時の記憶,388532,0.8050140891761975
60,11046,10,一番くじ夏目友人帳時の記憶,399578,0.8279007127465606
60,11685,11,一番くじ夏目友人帳時の記憶,411263,0.8521113044919609
0,8124,12,一番くじ夏目友人帳時の記憶,419387,0.8689437261727168
0,6591,13,一番くじ夏目友人帳時の記憶,425978,0.8825998673959887
0,6534,14,一番くじ夏目友人帳時の記憶,432512,0.8961379081717222
0,5592,15,一番くじ夏目友人帳時の記憶,438104,0.9077241836565556
60,4047,16,一番くじ夏目友人帳時の記憶,442151,0.9161093154317919
0,2933,17,一番くじ夏目友人帳時の記憶,445084,0.9221863086358363
0,2115,18,一番くじ夏目友人帳時の記憶,447199,0.9265684568208188
0,1637,19,一番くじ夏目友人帳時の記憶,448836,0.9299602187966186
0,1414,20,一番くじ夏目友人帳時の記憶,450250,0.9328899386706447
0,1650,21,一番くじ夏目友人帳時の記憶,451900,0.936308635836234
0,1834,22,一番くじ夏目友人帳時の記憶,453734,0.9401085695342284
0,1364,23,一番くじ夏目友人帳時の記憶,455098,0.9429346925244488
0,961,24,一番くじ夏目友人帳時の記憶,456059,0.9449258246311951
0,1016,25,一番くじ夏目友人帳時の記憶,457075,0.9470309133101277
0,856,26,一番くじ夏目友人帳時の記憶,457931,0.9488044919608818
0,636,27,一番くじ夏目友人帳時の記憶,458567,0.9501222443228907
0,792,28,一番くじ夏目友人帳時の記憶,459359,0.9517632189623736
0,1041,29,一番くじ夏目友人帳時の記憶,460400,0.953920106083209
0,738,30,一番くじ夏目友人帳時の記憶,461138,0.9554491960881817
0,481,31,一番くじ夏目友人帳時の記憶,461619,0.9564457981103929
0,452,32,一番くじ夏目友人帳時の記憶,462071,0.9573823139399967
0,396,33,一番くじ夏目友人帳時の記憶,462467,0.9582028012597381
0,406,34,一番くじ夏目友人帳時の記憶,462873,0.9590440079562407
0,479,35,一番くじ夏目友人帳時の記憶,463352,0.9600364661030997
0,481,36,一番くじ夏目友人帳時の記憶,463833,0.9610330681253108
0,350,37,一番くじ夏目友人帳時の記憶,464183,0.961758246311951
0,288,38,一番くじ夏目友人帳時の記憶,464471,0.962354964362672
0,285,39,一番くじ夏目友人帳時の記憶,464756,0.9629454666003646
0,328,40,一番くじ夏目友人帳時の記憶,465084,0.9636250621581303
0,360,41,一番くじ夏目友人帳時の記憶,465444,0.9643709597215315
0,269,42,一番くじ夏目友人帳時の記憶,465713,0.9649283109564064
0,367,43,一番くじ夏目友人帳時の記憶,466080,0.9656887120835406
0,244,44,一番くじ夏目友人帳時の記憶,466324,0.9661942648765125
0,238,45,一番くじ夏目友人帳時の記憶,466562,0.9666873860434279
0,138,46,一番くじ夏目友人帳時の記憶,466700,0.9669733134427316
0,118,47,一番くじ夏目友人帳時の記憶,466818,0.9672178020885132
0,73,48,一番くじ夏目友人帳時の記憶,466891,0.9673690535388696
0,127,49,一番くじ夏目友人帳時の記憶,467018,0.9676321896237361
0,175,50,一番くじ夏目友人帳時の記憶,467193,0.9679947787170562
0,142,51,一番くじ夏目友人帳時の記憶,467335,0.9682889938670645
0,144,52,一番くじ夏目友人帳時の記憶,467479,0.968587352892425
0,73,53,一番くじ夏目友人帳時の記憶,467552,0.9687386043427814
0,67,54,一番くじ夏目友人帳時の記憶,467619,0.968877424167081
0,69,55,一番くじ夏目友人帳時の記憶,467688,0.969020387866733
0,60,56,一番くじ夏目友人帳時の記憶,467748,0.9691447041272998
0,85,57,一番くじ夏目友人帳時の記憶,467833,0.9693208188297696
0,91,58,一番くじ夏目友人帳時の記憶,467924,0.969509365158296
0,34,59,一番くじ夏目友人帳時の記憶,467958,0.9695798110392839
0,6814,0,一番くじワンピース匠ノ系譜,6814,0.004971690403922484
660960,80867,1,一番くじワンピース匠ノ系譜,87681,0.06397457973383143
709280,111242,2,一番くじワンピース匠ノ系譜,198923,0.14513994279710482
160,102321,3,一番くじワンピース匠ノ系譜,301244,0.21979628764884426
160,110420,4,一番くじワンピース匠ノ系譜,411664,0.30036189586738266
0,99517,5,一番くじワンピース匠ノ系譜,511181,0.3729723616623862
0,60621,6,一番くじワンピース匠ノ系譜,571802,0.417203187018445
0,61959,7,一番くじワンピース匠ノ系譜,633761,0.46241025566191923
0,58603,8,一番くじワンピース匠ノ系譜,692364,0.5051686901704413
0,47808,9,一番くじワンピース匠ノ系譜,740172,0.540050782162036
0,48691,10,一番くじワンピース匠ノ系譜,788863,0.5755771363530235
0,56205,11,一番くじワンピース匠ノ系譜,845068,0.6165859210833528
0,49888,12,一番くじワンピース匠ノ系譜,894956,0.652985640905907
0,30037,13,一番くじワンピース匠ノ系譜,924993,0.6749015001167405
0,25289,14,一番くじワンピース匠ノ系譜,950282,0.6933530819519028
0,23290,15,一番くじワンピース匠ノ系譜,973572,0.7103461358860612
0,21328,16,一番くじワンピース匠ノ系譜,994900,0.7259076581835162
0,21950,17,一番くじワンピース匠ノ系譜,1016850,0.7419230095727294
0,25042,18,一番くじワンピース匠ノ系譜,1041892,0.7601943731029652
0,21155,19,一番くじワンピース匠ノ系譜,1063047,0.7756296696240953
0,13281,20,一番くじワンピース匠ノ系譜,1076328,0.7853198692505253
0,13884,21,一番くじワンピース匠ノ系譜,1090212,0.7954500350221807
0,14469,22,一番くじワンピース匠ノ系譜,1104681,0.8060070336212934
0,14089,23,一番くじワンピース匠ノ系譜,1118770,0.8162867732897502
0,13080,24,一番くじワンピース匠ノ系譜,1131850,0.8258303175344385
0,19728,25,一番くじワンピース匠ノ系譜,1151578,0.8402244338080784
0,16771,26,一番くじワンピース匠ノ系譜,1168349,0.8524610378239552
0,11452,27,一番くじワンピース匠ノ系譜,1179801,0.8608167464394116
0,22416,28,一番くじワンピース匠ノ系譜,1202217,0.877172104833061
0,13840,29,一番くじワンピース匠ノ系譜,1216057,0.8872701669390614
0,10548,30,一番くじワンピース匠ノ系譜,1226605,0.8949662911510623
0,9058,31,一番くじワンピース匠ノ系譜,1235663,0.9015752685033854
0,7634,32,一番くじワンピース匠ノ系譜,1243297,0.9071452544945132
0,6102,33,一番くじワンピース匠ノ系譜,1249399,0.9115974492178379
0,4577,34,一番くじワンピース匠ノ系譜,1253976,0.914936960074714
0,4077,35,一番くじワンピース匠ノ系譜,1258053,0.9179116565491477
0,3636,36,一番くじワンピース匠ノ系譜,1261689,0.9205645867382676
0,3530,37,一番くじワンピース匠ノ系譜,1265219,0.9231401762783096
0,3922,38,一番くじワンピース匠ノ系譜,1269141,0.9260017802941863
0,5363,39,一番くじワンピース匠ノ系譜,1274504,0.9299147793602615
0,4705,40,一番くじワンピース匠ノ系譜,1279209,0.9333476826990428
0,3886,41,一番くじワンピース匠ノ系譜,1283095,0.9361830200793836
0,2151,42,一番くじワンピース匠ノ系譜,1285246,0.93775245155265
0,2071,43,一番くじワンピース匠ノ系譜,1287317,0.9392635127247256
0,2036,44,一番くじワンピース匠ノ系譜,1289353,0.9407490368900303
0,2270,45,一番くじワンピース匠ノ系譜,1291623,0.942405294186318
0,4222,46,一番くじワンピース匠ノ系譜,1295845,0.9454857868316601
0,2610,47,一番くじワンピース匠ノ系譜,1298455,0.9473901179080084
0,1649,48,一番くじワンピース匠ノ系譜,1300104,0.9485932757413028
0,1558,49,一番くじワンピース匠ノ系譜,1301662,0.9497300373569928
0,1394,50,一番くじワンピース匠ノ系譜,1303056,0.9507471398552416
0,1242,51,一番くじワンピース匠ノ系譜,1304298,0.9516533387812282
0,1515,52,一番くじワンピース匠ノ系譜,1305813,0.952758726360028
0,1957,53,一番くじワンピース匠ノ系譜,1307770,0.9541866098529068
0,1545,54,一番くじワンピース匠ノ系譜,1309315,0.9553138862946533
0,1098,55,一番くじワンピース匠ノ系譜,1310413,0.9561150186784964
0,991,56,一番くじワンピース匠ノ系譜,1311404,0.9568380807844968
0,2272,57,一番くじワンピース匠ノ系譜,1313676,0.9584957973383142
0,886,58,一番くじワンピース匠ノ系譜,1314562,0.9591422484240019
0,1062,59,一番くじワンピース匠ノ系譜,1315624,0.9599171141723092
60,10195,0,一番くじワンピースヒストリーオブゾロ,10195,0.011367184015698866
451560,114760,1,一番くじワンピースヒストリーオブゾロ,124955,0.13932187137632682
445020,168731,2,一番くじワンピースヒストリーオブゾロ,293686,0.32745294799750246
60,112402,3,一番くじワンピースヒストリーオブゾロ,406088,0.45277852109535277
0,81853,4,一番くじワンピースヒストリーオブゾロ,487941,0.5440426812951565
0,65236,5,一番くじワンピースヒストリーオブゾロ,553177,0.6167792792792792
60,52306,6,一番くじワンピースヒストリーオブゾロ,605483,0.6750992328962626
120,44595,7,一番くじワンピースヒストリーオブゾロ,650078,0.7248216037819998
0,35298,8,一番くじワンピースヒストリーオブゾロ,685376,0.7641780394255642
0,28794,9,一番くじワンピースヒストリーオブゾロ,714170,0.7962826688074213
0,20960,10,一番くじワンピースヒストリーオブゾロ,735130,0.8196525733654446
0,21030,11,一番くじワンピースヒストリーオブゾロ,756160,0.8431005262688431
0,12807,12,一番くじワンピースヒストリーオブゾロ,768967,0.8573800285433949
0,10627,13,一番くじワンピースヒストリーオブゾロ,779594,0.8692288823476942
0,9157,14,一番くじワンピースヒストリーオブゾロ,788751,0.8794387208991169
0,9243,15,一番くじワンピースヒストリーオブゾロ,797994,0.8897444474177147
0,10306,16,一番くじワンピースヒストリーオブゾロ,808300,0.9012353938096512
0,6433,17,一番くじワンピースヒストリーオブゾロ,814733,0.9084080367496209
0,5399,18,一番くじワンピースヒストリーオブゾロ,820132,0.9144277941307645
0,5051,19,一番くじワンピースヒストリーオブゾロ,825183,0.9200595397377576
0,4694,20,一番くじワンピースヒストリーオブゾロ,829877,0.9252932387833378
0,4536,21,一番くじワンピースヒストリーオブゾロ,834413,0.9303507715636429
0,5016,22,一番くじワンピースヒストリーオブゾロ,839429,0.9359434929979484
0,4164,23,一番くじワンピースヒストリーオブゾロ,843593,0.9405862545714031
0,2846,24,一番くじワンピースヒストリーオブゾロ,846439,0.9437594772990813
0,2819,25,一番くじワンピースヒストリーオブゾロ,849258,0.9469025956649719
0,2387,26,一番くじワンピースヒストリーオブゾロ,851645,0.949564044242262
0,2037,27,一番くじワンピースヒストリーオブゾロ,853682,0.9518352510926769
0,2014,28,一番くじワンピースヒストリーオブゾロ,855696,0.9540808134867541
0,1792,29,一番くじワンピースヒストリーオブゾロ,857488,0.9560788511283561
0,1546,30,一番くじワンピースヒストリーオブゾロ,859034,0.9578026045847828
0,1312,31,一番くじワンピースヒストリーオブゾロ,860346,0.9592654535723842
0,885,32,一番くじワンピースヒストリーオブゾロ,861231,0.9602522076531977
0,805,33,一番くじワンピースヒストリーオブゾロ,862036,0.9611497636250111
0,711,34,一番くじワンピースヒストリーオブゾロ,862747,0.9619425118187495
0,861,35,一番くじワンピースヒストリーオブゾロ,863608,0.9629025064668629
0,1058,36,一番くじワンピースヒストリーオブゾロ,864666,0.964082151458389
0,823,37,一番くじワンピースヒストリーオブゾロ,865489,0.9649997770047275
0,463,38,一番くじワンピースヒストリーオブゾロ,865952,0.9655160110605655
0,535,39,一番くじワンピースヒストリーオブゾロ,866487,0.9661125234145036
0,426,40,一番くじワンピースヒストリーオブゾロ,866913,0.966587503344929
0,665,41,一番くじワンピースヒストリーオブゾロ,867578,0.9673289626259923
0,493,42,一番くじワンピースヒストリーオブゾロ,868071,0.9678786459727053
0,613,43,一番くじワンピースヒストリーオブゾロ,868684,0.9685621264829186
0,766,44,一番くじワンピースヒストリーオブゾロ,869450,0.9694161983765944
0,379,45,一番くじワンピースヒストリーオブゾロ,869829,0.9698387744179824
0,366,46,一番くじワンピースヒストリーオブゾロ,870195,0.9702468557666577
0,338,47,一番くじワンピースヒストリーオブゾロ,870533,0.9706237177771831
0,346,48,一番くじワンピースヒストリーオブゾロ,870879,0.9710094995986085
0,364,49,一番くじワンピースヒストリーオブゾロ,871243,0.9714153509945589
0,594,50,一番くじワンピースヒストリーオブゾロ,871837,0.9720776469538845
0,430,51,一番くじワンピースヒストリーオブゾロ,872267,0.97255708678976
0,278,52,一番くじワンピースヒストリーオブゾロ,872545,0.9728670502185354
0,287,53,一番くじワンピースヒストリーオブゾロ,872832,0.9731870484345732
0,271,54,一番くじワンピースヒストリーオブゾロ,873103,0.973489207028811
0,258,55,一番くじワンピースヒストリーオブゾロ,873361,0.9737768709303363
0,298,56,一番くじワンピースヒストリーオブゾロ,873659,0.9741091338863616
0,274,57,一番くじワンピースヒストリーオブゾロ,873933,0.9744146374096869
0,213,58,一番くじワンピースヒストリーオブゾロ,874146,0.9746521273748997
0,352,59,一番くじワンピースヒストリーオブゾロ,874498,0.9750445990545
0,4335,0,一番くじワンピース～ＶＳ海軍編～,4335,0.0029437969072136946
743622,48236,1,一番くじワンピース～ＶＳ海軍編～,52571,0.03569973407361733
728768,152293,2,一番くじワンピース～ＶＳ海軍編～,204864,0.13911834131474657
198,149639,3,一番くじワンピース～ＶＳ海軍編～,354503,0.24073467935362777
0,124265,4,一番くじワンピース～ＶＳ海軍編～,478768,0.3251201286442644
0,93367,5,一番くじワンピース～ＶＳ海軍編～,572135,0.38852347024422307
0,61860,6,一番くじワンピース～ＶＳ海軍編～,633995,0.4305311465257085
0,53107,7,一番くじワンピース～ＶＳ海軍編～,687102,0.4665948656379109
0,43909,8,一番くじワンピース～ＶＳ海軍編～,731011,0.4964124385096171
0,44249,9,一番くじワンピース～ＶＳ海軍編～,775260,0.5264608974132615
0,52642,10,一番くじワンピース～ＶＳ海軍編～,827902,0.5622088459229602
0,45293,11,一番くじワンピース～ＶＳ海軍編～,873195,0.5929662607599682
0,27876,12,一番くじワンピース～ＶＳ海軍編～,901071,0.611896199072653
0,23021,13,一番くじワンピース～ＶＳ海軍編～,924092,0.6275292206645715
0,23086,14,一番くじワンピース～ＶＳ海軍編～,947178,0.643206382233184
0,20092,15,一番くじワンピース～ＶＳ海軍編～,967270,0.6568503885676102
0,18812,16,一番くじワンピース～ＶＳ海軍編～,986082,0.669625176899445
0,21149,17,一番くじワンピース～ＶＳ海軍編～,1007231,0.6839869671625737
0,17754,18,一番くじワンピース～ＶＳ海軍編～,1024985,0.6960432924891415
0,11335,19,一番くじワンピース～ＶＳ海軍編～,1036320,0.7037406253480267
0,10328,20,一番くじワンピース～ＶＳ海軍編～,1046648,0.7107541281064358
0,10019,21,一番くじワンピース～ＶＳ海軍編～,1056667,0.7175577962064067
0,9509,22,一番くじワンピース～ＶＳ海軍編～,1066176,0.7240151352584702
0,9328,23,一番くじワンピース～ＶＳ海軍編～,1075504,0.7303495614523546
0,12821,24,一番くじワンピース～ＶＳ海軍編～,1088325,0.7390560020861232
0,11217,25,一番くじワンピース～ＶＳ海軍編～,1099542,0.7466732039103945
0,8609,26,一番くじワンピース～ＶＳ海軍編～,1108151,0.7525193740543858
0,7681,27,一番くじワンピース～ＶＳ海軍編～,1115832,0.7577353611464985
0,7866,28,一番くじワンピース～ＶＳ海軍編～,1123698,0.7630769774030483
0,7262,29,一番くじワンピース～ＶＳ海軍編～,1130960,0.7680084314146252
0,8142,30,一番くじワンピース～ＶＳ海軍編～,1139102,0.7735374728029836
0,10773,31,一番くじワンピース～ＶＳ海軍編～,1149875,0.780853164632606
0,10273,32,一番くじワンピース～ＶＳ海軍編～,1160148,0.7878293181799662
0,6497,33,一番くじワンピース～ＶＳ海軍編～,1166645,0.7922412786196819
0,6058,34,一番くじワンピース～ＶＳ海軍編～,1172703,0.7963551244475712
0,6190,35,一番くじワンピース～ＶＳ海軍編～,1178893,0.8005586083819779
0,5886,36,一番くじワンピース～ＶＳ海軍編～,1184779,0.804555653040769
0,5659,37,一番くじワンピース～ＶＳ海軍編～,1190438,0.8083985473194132
0,7059,38,一番くじワンピース～ＶＳ海軍編～,1197497,0.8131921487883916
0,6120,39,一番くじワンピース～ＶＳ海軍編～,1203617,0.8173480973632815
0,4393,40,一番くじワンピース～ＶＳ海軍編～,1208010,0.8203312807112376
0,4603,41,一番くじワンピース～ＶＳ海軍編～,1212613,0.8234570701377439
0,4244,42,一番くじワンピース～ＶＳ海軍編～,1216857,0.8263390710775859
0,3919,43,一番くじワンピース～ＶＳ海軍編～,1220776,0.8290003721339574
0,4248,44,一番くじワンピース～ＶＳ海軍編～,1225024,0.8318850893800575
0,5250,45,一番くじワンピース～ＶＳ海軍編～,1230274,0.8354502413438111
0,5053,46,一番くじワンピース～ＶＳ海軍編～,1235327,0.8388816152243533
0,3277,47,一番くじワンピース～ＶＳ海軍編～,1238604,0.8411069491263001
0,3070,48,一番くじワンピース～ＶＳ海軍編～,1241674,0.8431917141793903
0,2774,49,一番くじワンピース～ＶＳ海軍編～,1244448,0.8450754725693812
0,2699,50,一番くじワンピース～ＶＳ海軍編～,1247147,0.8469083002170329
0,3015,51,一番くじワンピース～ＶＳ海軍編～,1250162,0.8489557160590743
0,3738,52,一番くじワンピース～ＶＳ海軍編～,1253900,0.8514941042572668
0,3703,53,一番くじワンピース～ＶＳ海軍編～,1257603,0.854008724775701
0,3073,54,一番くじワンピース～ＶＳ海軍編～,1260676,0.8560955270584848
0,2609,55,一番くじワンピース～ＶＳ海軍編～,1263285,0.8578672378153293
0,2923,56,一番くじワンピース～ＶＳ海軍編～,1266208,0.8598521786134343
0,2800,57,一番くじワンピース～ＶＳ海軍編～,1269008,0.8617535929941029
0,2767,58,一番くじワンピース～ＶＳ海軍編～,1271775,0.8636325978481422
0,3082,59,一番くじワンピース～ＶＳ海軍編～,1274857,0.8657255118200067
0,913,0,一番くじスターウォーズハロウィン,913,0.0015521904927057247
299201,12676,1,一番くじスターウォーズハロウィン,13589,0.023102646884313356
288950,23398,2,一番くじスターウォーズハロウィン,36987,0.06288156599529753
50,28005,3,一番くじスターウォーズハロウィン,64992,0.11049284173267301
0,25849,4,一番くじスターウォーズハロウィン,90841,0.15443870377643015
0,21249,5,一番くじスターウォーズハロウィン,112090,0.19056410988760644
0,14563,6,一番くじスターウォーズハロウィン,126653,0.215322653310688
0,14061,7,一番くじスターウォーズハロウィン,140714,0.2392277469776488
0,12632,8,一番くじスターウォーズハロウィン,153346,0.2607033990081622
0,14168,9,一番くじスターウォーズハロウィン,167514,0.28479040328051125
0,17497,10,一番くじスターウォーズハロウィン,185011,0.3145370375092868
0,15596,11,一番くじスターウォーズハロウィン,200607,0.3410517833189675
0,9708,12,一番くじスターウォーズハロウィン,210315,0.3575563455349447
0,9619,13,一番くじスターウォーズハロウィン,219934,0.3739095989296176
0,9569,14,一番くじスターウォーズハロウィン,229503,0.3901778473685016
0,9526,15,一番くじスターウォーズハロウィン,239029,0.40637299154540707
0,10064,16,一番くじスターウォーズハロウィン,249093,0.4234827890466014
0,12511,17,一番くじスターウォーズハロウィン,261604,0.4447527290841056
0,11165,18,一番くじスターウォーズハロウィン,272769,0.46373433571177197
0,7261,19,一番くじスターウォーズハロウィン,280030,0.47607875539143935
0,7159,20,一番くじスターウォーズハロウィン,287189,0.48824976496129724
0,7492,21,一番くじスターウォーズハロウィン,294681,0.5009869075367094
0,7106,22,一番くじスターウォーズハロウィン,301787,0.5130678118534311
0,6968,23,一番くじスターウォーズハロウィン,308755,0.5249141024921753
0,10070,24,一番くじスターウォーズハロウィン,318825,0.5420341005880643
0,9654,25,一番くじスターウォーズハロウィン,328479,0.5584468574517895
0,6478,26,一番くじスターウォーズハロウィン,334957,0.5694600995238023
0,6563,27,一番くじスターウォーズハロウィン,341520,0.5806178500206562
0,6377,28,一番くじスターウォーズハロウィン,347897,0.5914593820819753
0,7946,29,一番くじスターウォーズハロウィン,355843,0.6049683696559509
0,5595,30,一番くじスターウォーズハロウィン,361438,0.6144804242087314
0,6507,31,一番くじスターウォーズハロウィン,367945,0.6255429691551018
0,5774,32,一番くじスターウォーズハロウィン,373719,0.6353593414496065
0,4068,33,一番くじスターウォーズハロウィン,377787,0.6422753446525933
0,3475,34,一番くじスターウォーズハロウィン,381262,0.6481831890799233
0,3319,35,一番くじスターウォーズハロウィン,384581,0.653825818045192
0,3434,36,一番くじスターウォーズハロウィン,388015,0.6596639584087752
0,3909,37,一番くじスターウォーズハロウィン,391924,0.6663096458523532
0,5092,38,一番くじスターウォーズハロウィン,397016,0.6749665505498971
0,4396,39,一番くじスターウォーズハロウィン,401412,0.6824401862628591
0,2796,40,一番くじスターウォーズハロウィン,404208,0.6871936633905756
0,2918,41,一番くじスターウォーズハロウィン,407126,0.6921545526104171
0,2791,42,一番くじスターウォーズハロウィン,409917,0.6968995292425548
0,2823,43,一番くじスターウォーズハロウィン,412740,0.7016989090463974
0,2959,44,一番くじスターウォーズハロウィン,415699,0.7067295023299859
0,3549,45,一番くじスターウォーズハロウィン,419248,0.7127631540918835
0,3061,46,一番くじスターウォーズハロウィン,422309,0.7179671574852814
0,2153,47,一番くじスターウォーズハロウィン,424462,0.7216274708815524
0,2226,48,一番くじスターウォーズハロウィン,426688,0.7254118915132752
0,2423,49,一番くじスターウォーズハロウィン,429111,0.7295312316708064
0,1666,50,一番くじスターウォーズハロウィン,430777,0.7323635967976933
0,2419,51,一番くじスターウォーズハロウィン,433196,0.7364761365587614
0,2746,52,一番くじスターウォーズハロウィン,435942,0.741144608730689
0,2523,53,一番くじスターウォーズハロウィン,438465,0.745433958799798
0,1759,54,一番くじスターウォーズハロウィン,440224,0.7484244331444523
0,1743,55,一番くじスターウォーズハロウィン,441967,0.7513877059032542
0,1603,56,一番くじスターウォーズハロウィン,443570,0.754112964785847
0,1573,57,一番くじスターウォーズハロウィン,445143,0.7567872206949665
0,1915,58,一番くじスターウォーズハロウィン,447058,0.7600429105016823
0,2440,59,一番くじスターウォーズハロウィン,449498,0.7641911523441817
132,2754,0,一番くじくまのプーさん,2754,0.003248775515981994
399036,37133,1,一番くじくまのプーさん,39887,0.0470529807574342
377322,64313,2,一番くじくまのプーさん,104200,0.12292026462066948
0,53506,3,一番くじくまのプーさん,157706,0.18603899474344818
0,46196,4,一番くじくまのプーさん,203902,0.24053443182997838
66,39832,5,一番くじくまのプーさん,243734,0.28752253144965695
0,37821,6,一番くじくまのプーさん,281555,0.3321383407415796
0,38080,7,一番くじくまのプーさん,319635,0.3770596812094788
66,39565,8,一番くじくまのプーさん,359200,0.42373281239678
22770,30678,9,一番くじくまのプーさん,389878,0.45992233137982125
0,23020,10,一番くじくまのプーさん,412898,0.4870780366731784
0,22130,11,一番くじくまのプーさん,435028,0.5131838471919443
0,19652,12,一番くじくまのプーさん,454680,0.5363664675405566
25344,19744,13,一番くじくまのプーさん,474424,0.5596576163377783
22704,20864,14,一番くじくまのプーさん,495288,0.5842699810311146
132,23216,15,一番くじくまのプーさん,518504,0.6116568991062918
132,21375,16,一番くじくまのプーさん,539879,0.6368720685522304
0,17424,17,一番くじくまのプーさん,557303,0.6574264129932146
0,12027,18,一番くじくまのプーさん,569330,0.6716141483347962
0,11850,19,一番くじくまのプーさん,581180,0.6855930843785095
0,10592,20,一番くじくまのプーさん,591772,0.698088011853194
0,10583,21,一番くじくまのプーさん,602355,0.7105723224144277
0,12487,22,一番くじくまのプーさん,614842,0.7253026999990563
0,11049,23,一番くじくまのプーさん,625891,0.7383367307456377
0,8187,24,一番くじくまのプーさん,634078,0.7479945830148259
0,7595,25,一番くじくまのプーさん,641673,0.7569540783103537
0,6850,26,一番くじくまのプーさん,648523,0.765034729103555
0,6890,27,一番くじくまのプーさん,655413,0.7731625661787606
0,6738,28,一番くじくまのプーさん,662151,0.7811110953823505
0,7920,29,一番くじくまのプーさん,670071,0.7904539792191614
0,7229,30,一番くじくまのプーさん,677300,0.7989817200343516
0,4215,31,一番くじくまのプーさん,681515,0.8039539745005332
0,3933,32,一番くじくまのプーさん,685448,0.8085935656785859
0,4251,33,一番くじくまのプーさん,689699,0.8136082877985712
0,4544,34,一番くじくまのプーさん,694243,0.8189686494342365
0,4220,35,一番くじくまのプーさん,698463,0.8239468021856686
0,5481,36,一番くじくまのプーさん,703944,0.8304125024772798
0,4912,37,一番くじくまのプーさん,708856,0.8362069779073827
0,2740,38,一番くじくまのプーさん,711596,0.8394392382246634
0,2841,39,一番くじくまのプーさん,714437,0.8427906439040043
0,2942,40,一番くじくまのプーさん,717379,0.8462611949454055
0,2510,41,一番くじくまのプーさん,719889,0.8492221341411624
0,2742,42,一番くじくまのプーさん,722631,0.8524567537725433
0,3224,43,一番くじくまのプーさん,725855,0.8562599681020734
0,2568,44,一番くじくまのプーさん,728423,0.8592893274067364
0,1956,45,一番くじくまのプーさん,730379,0.8615967365967366
0,1792,46,一番くじくまのプーさん,732171,0.86371068203052
0,1726,47,一番くじくまのプーさん,733897,0.8657467700989968
0,1777,48,一番くじくまのプーさん,735674,0.8678430206770288
0,1946,49,一番くじくまのプーさん,737620,0.8701386332965281
0,2499,50,一番くじくまのプーさん,740119,0.873086596264734
0,2207,51,一番くじくまのプーさん,742326,0.8756900993743099
0,1544,52,一番くじくまのプーさん,743870,0.877511489859668
0,1283,53,一番くじくまのプーさん,745153,0.8790249898549494
0,1377,54,一番くじくまのプーさん,746530,0.8806493776129404
0,1268,55,一番くじくまのプーさん,747798,0.8821451827524702
0,1179,56,一番くじくまのプーさん,748977,0.8835359984145409
0,1388,57,一番くじくまのプーさん,750365,0.885173362400083
0,1502,58,一番くじくまのプーさん,751867,0.8869452072893368
0,893,59,一番くじくまのプーさん,752760,0.8879986410350783
1100,21,0,＃とるパカ！夏目友人帳エコバッグ,21,0.015107913669064749
290,466,1,＃とるパカ！夏目友人帳エコバッグ,487,0.35035971223021584
0,144,2,＃とるパカ！夏目友人帳エコバッグ,631,0.4539568345323741
0,61,3,＃とるパカ！夏目友人帳エコバッグ,692,0.497841726618705
0,23,4,＃とるパカ！夏目友人帳エコバッグ,715,0.5143884892086331
0,27,5,＃とるパカ！夏目友人帳エコバッグ,742,0.5338129496402878
0,14,6,＃とるパカ！夏目友人帳エコバッグ,756,0.543884892086331
0,32,7,＃とるパカ！夏目友人帳エコバッグ,788,0.5669064748201439
0,19,8,＃とるパカ！夏目友人帳エコバッグ,807,0.5805755395683453
0,28,9,＃とるパカ！夏目友人帳エコバッグ,835,0.6007194244604317
0,14,10,＃とるパカ！夏目友人帳エコバッグ,849,0.6107913669064748
0,22,11,＃とるパカ！夏目友人帳エコバッグ,871,0.6266187050359712
0,11,12,＃とるパカ！夏目友人帳エコバッグ,882,0.6345323741007194
0,14,13,＃とるパカ！夏目友人帳エコバッグ,896,0.6446043165467625
0,9,14,＃とるパカ！夏目友人帳エコバッグ,905,0.6510791366906474
0,9,15,＃とるパカ！夏目友人帳エコバッグ,914,0.6575539568345323
0,8,16,＃とるパカ！夏目友人帳エコバッグ,922,0.6633093525179856
0,6,17,＃とるパカ！夏目友人帳エコバッグ,928,0.6676258992805756
0,6,18,＃とるパカ！夏目友人帳エコバッグ,934,0.6719424460431654
0,3,19,＃とるパカ！夏目友人帳エコバッグ,937,0.6741007194244605
0,1,20,＃とるパカ！夏目友人帳エコバッグ,938,0.6748201438848921
0,6,21,＃とるパカ！夏目友人帳エコバッグ,944,0.679136690647482
0,3,22,＃とるパカ！夏目友人帳エコバッグ,947,0.681294964028777
0,2,23,＃とるパカ！夏目友人帳エコバッグ,949,0.6827338129496403
0,6,24,＃とるパカ！夏目友人帳エコバッグ,955,0.6870503597122302
0,6,25,＃とるパカ！夏目友人帳エコバッグ,961,0.6913669064748201
0,3,26,＃とるパカ！夏目友人帳エコバッグ,964,0.6935251798561151
0,1,27,＃とるパカ！夏目友人帳エコバッグ,965,0.6942446043165468
0,6,28,＃とるパカ！夏目友人帳エコバッグ,971,0.6985611510791367
0,3,29,＃とるパカ！夏目友人帳エコバッグ,974,0.7007194244604317
0,5,30,＃とるパカ！夏目友人帳エコバッグ,979,0.7043165467625899
0,4,31,＃とるパカ！夏目友人帳エコバッグ,983,0.7071942446043166
0,2,32,＃とるパカ！夏目友人帳エコバッグ,985,0.7086330935251799
0,7,33,＃とるパカ！夏目友人帳エコバッグ,992,0.7136690647482015
0,4,34,＃とるパカ！夏目友人帳エコバッグ,996,0.7165467625899281
0,4,35,＃とるパカ！夏目友人帳エコバッグ,1000,0.7194244604316546
0,5,36,＃とるパカ！夏目友人帳エコバッグ,1005,0.7230215827338129
0,4,37,＃とるパカ！夏目友人帳エコバッグ,1009,0.7258992805755395
0,5,38,＃とるパカ！夏目友人帳エコバッグ,1014,0.7294964028776978
0,9,39,＃とるパカ！夏目友人帳エコバッグ,1023,0.7359712230215827
0,8,40,＃とるパカ！夏目友人帳エコバッグ,1031,0.741726618705036
0,2,41,＃とるパカ！夏目友人帳エコバッグ,1033,0.7431654676258993
0,3,42,＃とるパカ！夏目友人帳エコバッグ,1036,0.7453237410071942
0,3,43,＃とるパカ！夏目友人帳エコバッグ,1039,0.7474820143884892
0,4,44,＃とるパカ！夏目友人帳エコバッグ,1043,0.7503597122302158
0,2,45,＃とるパカ！夏目友人帳エコバッグ,1045,0.7517985611510791
0,6,46,＃とるパカ！夏目友人帳エコバッグ,1051,0.7561151079136691
0,4,47,＃とるパカ！夏目友人帳エコバッグ,1055,0.7589928057553957
0,3,48,＃とるパカ！夏目友人帳エコバッグ,1058,0.7611510791366907
0,4,49,＃とるパカ！夏目友人帳エコバッグ,1062,0.7640287769784173
0,3,50,＃とるパカ！夏目友人帳エコバッグ,1065,0.7661870503597122
0,4,51,＃とるパカ！夏目友人帳エコバッグ,1069,0.7690647482014389
0,8,52,＃とるパカ！夏目友人帳エコバッグ,1077,0.7748201438848921
0,3,53,＃とるパカ！夏目友人帳エコバッグ,1080,0.7769784172661871
0,2,54,＃とるパカ！夏目友人帳エコバッグ,1082,0.7784172661870503
0,2,55,＃とるパカ！夏目友人帳エコバッグ,1084,0.7798561151079136
0,0,56,＃とるパカ！夏目友人帳エコバッグ,1084,0.7798561151079136
0,5,57,＃とるパカ！夏目友人帳エコバッグ,1089,0.7834532374100719
0,1,58,＃とるパカ！夏目友人帳エコバッグ,1090,0.7841726618705036
0,7,59,＃とるパカ！夏目友人帳エコバッグ,1097,0.7892086330935252
0,2833,0,一番くじモンスターハンター４,2833,0.0031014626029076896
451600,44002,1,一番くじモンスターハンター４,46835,0.051273208968295673
461680,92526,2,一番くじモンスターハンター４,139361,0.15256721842704501
80,75437,3,一番くじモンスターハンター４,214798,0.2351528288667017
0,48894,4,一番くじモンスターハンター４,263692,0.2886801541425819
0,47705,5,一番くじモンスターハンター４,311397,0.3409058066211245
0,49239,6,一番くじモンスターハンター４,360636,0.39481082501313713
0,35857,7,一番くじモンスターハンター４,396493,0.4340657295498336
0,35709,8,一番くじモンスターハンター４,432202,0.4731586092135225
0,38147,9,一番くじモンスターハンター４,470349,0.5149205202312138
0,32320,10,一番くじモンスターハンター４,502669,0.5503032492555614
0,27490,11,一番くじモンスターハンター４,530159,0.580398274654055
80,25772,12,一番くじモンスターハンター４,555931,0.6086124978104747
0,22264,13,一番くじモンスターハンター４,578195,0.6329862935715537
0,20461,14,一番くじモンスターハンター４,598656,0.6553862322648449
0,19189,15,一番くじモンスターハンター４,617845,0.6763936328603959
0,20130,16,一番くじモンスターハンター４,637975,0.6984312051147311
0,17194,17,一番くじモンスターハンター４,655169,0.7172545542126467
0,13324,18,一番くじモンスターハンター４,668493,0.7318411718339464
0,10992,19,一番くじモンスターハンター４,679485,0.743874802942722
0,10760,20,一番くじモンスターハンター４,690245,0.7556544491154318
0,9530,21,一番くじモンスターハンター４,699775,0.7660875372219302
0,9372,22,一番くじモンスターハンター４,709147,0.7763476528288668
0,8513,23,一番くじモンスターハンター４,717660,0.7856673673147662
0,7330,24,一番くじモンスターハンター４,724990,0.7936919775792608
0,5425,25,一番くじモンスターハンター４,730415,0.7996310649851113
0,4531,26,一番くじモンスターハンター４,734946,0.8045914345769837
0,4884,27,一番くじモンスターハンター４,739830,0.8099382553862323
0,4434,28,一番くじモンスターハンター４,744264,0.8147924330005255
0,4736,29,一番くじモンスターハンター４,749000,0.8199772289367665
0,6910,30,一番くじモンスターハンター４,755910,0.8275420388859696
0,5815,31,一番くじモンスターハンター４,761725,0.8339080837274478
0,3739,32,一番くじモンスターハンター４,765464,0.8380014012961989
0,3026,33,一番くじモンスターハンター４,768490,0.8413141530916097
0,3076,34,一番くじモンスターハンター４,771566,0.8446816430197933
0,2882,35,一番くじモンスターハンター４,774448,0.8478367489928184
0,3052,36,一番くじモンスターハンター４,777500,0.851177964617271
0,4069,37,一番くじモンスターハンター４,781569,0.8556325538623226
0,3541,38,一番くじモンスターハンター４,785110,0.8595091084252934
0,2448,39,一番くじモンスターハンター４,787558,0.8621890874058504
0,2221,40,一番くじモンスターハンター４,789779,0.8646205552636188
0,1974,41,一番くじモンスターハンター４,791753,0.8667816167454896
0,2126,42,一番くじモンスターハンター４,793879,0.8691090821509897
0,2296,43,一番くじモンスターハンター４,796175,0.8716226572079173
0,2937,44,一番くじモンスターハンター４,799112,0.8748379751269925
0,2656,45,一番くじモンスターハンター４,801768,0.8777456647398844
0,2421,46,一番くじモンスターハンター４,804189,0.8803960851287441
0,1608,47,一番くじモンスターハンター４,805797,0.8821564634787178
0,1508,48,一番くじモンスターハンター４,807305,0.8838073655631459
0,1737,49,一番くじモンスターハンター４,809042,0.8857089682956735
0,2187,50,一番くじモンスターハンター４,811229,0.8881032142231564
0,2051,51,一番くじモンスターハンター４,813280,0.8903485724294973
0,2224,52,一番くじモンスターハンター４,815504,0.8927833245752321
0,1634,53,一番くじモンスターハンター４,817138,0.8945721667542477
0,1057,54,一番くじモンスターハンター４,818195,0.895729330881065
0,993,55,一番くじモンスターハンター４,819188,0.8968164301979331
0,1075,56,一番くじモンスターハンター４,820263,0.8979933000525486
0,1208,57,一番くじモンスターハンター４,821471,0.8993157733403399
0,1457,58,一番くじモンスターハンター４,822928,0.9009108425293396
0,1484,59,一番くじモンスターハンター４,824412,0.9025354703100368
1400,16273,0,一番くじアイドリッシュセブン＆すみっコぐらし,16273,0.06398883252723055
141050,84721,1,一番くじアイドリッシュセブン＆すみっコぐらし,100994,0.39712948763320355
111790,60882,2,一番くじアイドリッシュセブン＆すみっコぐらし,161876,0.6365302190240258
0,25058,3,一番くじアイドリッシュセブン＆すみっコぐらし,186934,0.7350635051708545
0,12795,4,一番くじアイドリッシュセブン＆すみっコぐらし,199729,0.7853761157642247
0,7737,5,一番くじアイドリッシュセブン＆すみっコぐらし,207466,0.8157996146435453
0,4862,6,一番くじアイドリッシュセブン＆すみっコぐらし,212328,0.8349180134481539
0,4812,7,一番くじアイドリッシュセブン＆すみっコぐらし,217140,0.8538398018166804
0,3215,8,一番くじアイドリッシュセブン＆すみっコぐらし,220355,0.8664818528567496
70,2991,9,一番くじアイドリッシュセブン＆すみっコぐらし,223346,0.8782430891431717
0,2083,10,一番くじアイドリッシュセブン＆すみっコぐらし,225429,0.8864338799103456
0,1474,11,一番くじアイドリッシュセブン＆すみっコぐらし,226903,0.8922299555660415
0,1309,12,一番くじアイドリッシュセブン＆すみっコぐらし,228212,0.8973772167826668
0,1153,13,一番くじアイドリッシュセブン＆すみっコぐらし,229365,0.9019110534387166
0,1016,14,一番くじアイドリッシュセブン＆すみっコぐらし,230381,0.9059061774999017
0,933,15,一番くじアイドリッシュセブン＆すみっコぐらし,231314,0.9095749282371909
0,1398,16,一番くじアイドリッシュセブン＆すみっコぐらし,232712,0.9150721560300421
0,1890,17,一番くじアイドリッシュセブン＆すみっコぐらし,234602,0.9225040305139397
0,532,18,一番くじアイドリッシュセブン＆すみっコぐらし,235134,0.9245959655538516
0,674,19,一番くじアイドリッシュセブン＆すみっコぐらし,235808,0.9272462742322363
0,625,20,一番くじアイドリッシュセブン＆すみっコぐらし,236433,0.9297039046832606
0,1375,21,一番くじアイドリッシュセブン＆すみっコぐらし,237808,0.9351106916755141
0,741,22,一番くじアイドリッシュセブン＆すみっコぐらし,238549,0.9380244583382485
0,437,23,一番くじアイドリッシュセブン＆すみっコぐらし,238986,0.9397428335496049
0,553,24,一番くじアイドリッシュセブン＆すみっコぐらし,239539,0.9419173449726711
0,267,25,一番くじアイドリッシュセブン＆すみっコぐらし,239806,0.9429672447013487
0,313,26,一番くじアイドリッシュセブン＆すみっコぐらし,240119,0.9441980260312217
0,245,27,一番くじアイドリッシュセブン＆すみっコぐらし,240364,0.9451614171680233
0,246,28,一番くじアイドリッシュセブン＆すみっコぐらし,240610,0.9461287405135465
0,427,29,一番くじアイドリッシュセブン＆すみっコぐらし,241037,0.9478077936376863
0,295,30,一番くじアイドリッシュセブン＆すみっコぐらし,241332,0.9489677952105697
0,299,31,一番くじアイドリッシュセブン＆すみっコぐらし,241631,0.9501435256183398
0,188,32,一番くじアイドリッシュセブン＆すみっコぐらし,241819,0.9508827808580079
0,282,33,一番くじアイドリッシュセブン＆すみっコぐらし,242101,0.9519916637175101
0,167,34,一番くじアイドリッシュセブン＆すみっコぐらし,242268,0.9526483425740239
0,215,35,一番くじアイドリッシュセブン＆すみっコぐらし,242483,0.9534937674491762
0,201,36,一番くじアイドリッシュセブン＆すみっコぐらし,242684,0.9542841414022256
0,226,37,一番くじアイドリッシュセブン＆すみっコぐらし,242910,0.955172820573316
0,265,38,一番くじアイドリッシュセブン＆すみっコぐらし,243175,0.9562148558845504
0,152,39,一番くじアイドリッシュセブン＆すみっコぐらし,243327,0.9568125516102395
0,179,40,一番くじアイドリッシュセブン＆すみっコぐらし,243506,0.9575164169714129
0,168,41,一番くじアイドリッシュセブン＆すみっコぐらし,243674,0.9581770280366482
0,148,42,一番くじアイドリッシュセブン＆すみっコぐらし,243822,0.9587589949274508
0,325,43,一番くじアイドリッシュセブン＆すみっコぐらし,244147,0.9600369627619834
0,148,44,一番くじアイドリッシュセブン＆すみっコぐらし,244295,0.960618929652786
0,91,45,一番くじアイドリッシュセブン＆すみっコぐらし,244386,0.9609767606464551
0,139,46,一番くじアイドリッシュセブン＆すみっコぐらし,244525,0.961523337658763
0,113,47,一番くじアイドリッシュセブン＆すみっコぐらし,244638,0.9619676772443081
0,221,48,一番くじアイドリッシュセブン＆すみっコぐらし,244859,0.9628366953717903
0,159,49,一番くじアイドリッシュセブン＆すみっコぐらし,245018,0.963461916558531
0,207,50,一番くじアイドリッシュセブン＆すみっコぐらし,245225,0.9642758837639102
0,141,51,一番くじアイドリッシュセブン＆すみっコぐらし,245366,0.9648303251936613
0,74,52,一番くじアイドリッシュセブン＆すみっコぐらし,245440,0.9651213086390625
0,120,53,一番くじアイドリッシュセブン＆すみっコぐらし,245560,0.9655931736856592
0,124,54,一番くじアイドリッシュセブン＆すみっコぐらし,245684,0.9660807675671425
0,122,55,一番くじアイドリッシュセブン＆すみっコぐらし,245806,0.9665604970311824
0,95,56,一番くじアイドリッシュセブン＆すみっコぐらし,245901,0.9669340568597381
0,184,57,一番くじアイドリッシュセブン＆すみっコぐらし,246085,0.9676575832645197
0,146,58,一番くじアイドリッシュセブン＆すみっコぐらし,246231,0.968231685737879
0,49,59,一番くじアイドリッシュセブン＆すみっコぐらし,246280,0.9684243639652392
0,0,0,一番くじマクロスＦシェリル・ノーム●,0,0.0
396,19,1,一番くじマクロスＦシェリル・ノーム●,19,0.021111111111111112
270,2,2,一番くじマクロスＦシェリル・ノーム●,21,0.023333333333333334
0,1,3,一番くじマクロスＦシェリル・ノーム●,22,0.024444444444444446
0,9,4,一番くじマクロスＦシェリル・ノーム●,31,0.034444444444444444
0,5,5,一番くじマクロスＦシェリル・ノーム●,36,0.04
0,18,6,一番くじマクロスＦシェリル・ノーム●,54,0.06
0,7,7,一番くじマクロスＦシェリル・ノーム●,61,0.06777777777777778
0,3,8,一番くじマクロスＦシェリル・ノーム●,64,0.07111111111111111
0,4,9,一番くじマクロスＦシェリル・ノーム●,68,0.07555555555555556
0,4,10,一番くじマクロスＦシェリル・ノーム●,72,0.08
0,9,11,一番くじマクロスＦシェリル・ノーム●,81,0.09
90,8,12,一番くじマクロスＦシェリル・ノーム●,89,0.09888888888888889
144,7,13,一番くじマクロスＦシェリル・ノーム●,96,0.10666666666666667
0,6,14,一番くじマクロスＦシェリル・ノーム●,102,0.11333333333333333
0,10,15,一番くじマクロスＦシェリル・ノーム●,112,0.12444444444444444
0,7,16,一番くじマクロスＦシェリル・ノーム●,119,0.1322222222222222
0,2,17,一番くじマクロスＦシェリル・ノーム●,121,0.13444444444444445
0,5,18,一番くじマクロスＦシェリル・ノーム●,126,0.14
0,0,19,一番くじマクロスＦシェリル・ノーム●,126,0.14
0,2,20,一番くじマクロスＦシェリル・ノーム●,128,0.14222222222222222
0,4,21,一番くじマクロスＦシェリル・ノーム●,132,0.14666666666666667
0,2,22,一番くじマクロスＦシェリル・ノーム●,134,0.14888888888888888
0,4,23,一番くじマクロスＦシェリル・ノーム●,138,0.15333333333333332
0,3,24,一番くじマクロスＦシェリル・ノーム●,141,0.15666666666666668
0,1,25,一番くじマクロスＦシェリル・ノーム●,142,0.15777777777777777
0,1,26,一番くじマクロスＦシェリル・ノーム●,143,0.15888888888888889
0,3,27,一番くじマクロスＦシェリル・ノーム●,146,0.1622222222222222
0,1,28,一番くじマクロスＦシェリル・ノーム●,147,0.16333333333333333
0,1,29,一番くじマクロスＦシェリル・ノーム●,148,0.16444444444444445
0,1,30,一番くじマクロスＦシェリル・ノーム●,149,0.16555555555555557
0,4,31,一番くじマクロスＦシェリル・ノーム●,153,0.17
0,1,32,一番くじマクロスＦシェリル・ノーム●,154,0.1711111111111111
0,1,33,一番くじマクロスＦシェリル・ノーム●,155,0.17222222222222222
0,2,34,一番くじマクロスＦシェリル・ノーム●,157,0.17444444444444446
0,0,35,一番くじマクロスＦシェリル・ノーム●,157,0.17444444444444446
0,3,36,一番くじマクロスＦシェリル・ノーム●,160,0.17777777777777778
0,1,37,一番くじマクロスＦシェリル・ノーム●,161,0.17888888888888888
0,0,38,一番くじマクロスＦシェリル・ノーム●,161,0.17888888888888888
0,2,39,一番くじマクロスＦシェリル・ノーム●,163,0.1811111111111111
0,5,40,一番くじマクロスＦシェリル・ノーム●,168,0.18666666666666668
0,3,41,一番くじマクロスＦシェリル・ノーム●,171,0.19
0,3,42,一番くじマクロスＦシェリル・ノーム●,174,0.19333333333333333
0,8,43,一番くじマクロスＦシェリル・ノーム●,182,0.20222222222222222
0,0,44,一番くじマクロスＦシェリル・ノーム●,182,0.20222222222222222
0,1,45,一番くじマクロスＦシェリル・ノーム●,183,0.20333333333333334
0,3,46,一番くじマクロスＦシェリル・ノーム●,186,0.20666666666666667
0,0,47,一番くじマクロスＦシェリル・ノーム●,186,0.20666666666666667
0,1,48,一番くじマクロスＦシェリル・ノーム●,187,0.20777777777777778
0,0,49,一番くじマクロスＦシェリル・ノーム●,187,0.20777777777777778
0,20,50,一番くじマクロスＦシェリル・ノーム●,207,0.23
0,0,51,一番くじマクロスＦシェリル・ノーム●,207,0.23
0,2,52,一番くじマクロスＦシェリル・ノーム●,209,0.23222222222222222
0,1,53,一番くじマクロスＦシェリル・ノーム●,210,0.23333333333333334
0,1,54,一番くじマクロスＦシェリル・ノーム●,211,0.23444444444444446
0,6,55,一番くじマクロスＦシェリル・ノーム●,217,0.2411111111111111
0,6,56,一番くじマクロスＦシェリル・ノーム●,223,0.2477777777777778
0,6,57,一番くじマクロスＦシェリル・ノーム●,229,0.2544444444444444
0,1,58,一番くじマクロスＦシェリル・ノーム●,230,0.25555555555555554
0,4,59,一番くじマクロスＦシェリル・ノーム●,234,0.26
0,2466,0,一番くじ妖怪ウォッチスター登場ＵＳＡピョン,2466,0.0023079514824797843
533120,32474,1,一番くじ妖怪ウォッチスター登場ＵＳＡピョン,34940,0.032700658879904164
534800,55102,2,一番くじ妖怪ウォッチスター登場ＵＳＡピョン,90042,0.08427111410601977
210,55177,3,一番くじ妖怪ウォッチスター登場ＵＳＡピョン,145219,0.13591176250374365
210,48338,4,一番くじ妖怪ウォッチスター登場ＵＳＡピョン,193557,0.18115172955974843
70,43323,5,一番くじ妖怪ウォッチスター登場ＵＳＡピョン,236880,0.22169811320754718
70,48832,6,一番くじ妖怪ウォッチスター登場ＵＳＡピョン,285712,0.26740041928721175
0,69607,7,一番くじ妖怪ウォッチスター登場ＵＳＡピョン,355319,0.332546233902366
0,54117,8,一番くじ妖怪ウォッチスター登場ＵＳＡピョン,409436,0.38319481880802636
0,28977,9,一番くじ妖怪ウォッチスター登場ＵＳＡピョン,438413,0.41031465259059596
0,23819,10,一番くじ妖怪ウォッチスター登場ＵＳＡピョン,462232,0.4326070679844265
0,24445,11,一番くじ妖怪ウォッチスター登場ＵＳＡピョン,486677,0.45548536238394727
0,24900,12,一番くじ妖怪ウォッチスター登場ＵＳＡピョン,511577,0.47878949535789156
0,27422,13,一番くじ妖怪ウォッチスター登場ＵＳＡピョン,538999,0.5044539907157831
0,40361,14,一番くじ妖怪ウォッチスター登場ＵＳＡピョン,579360,0.5422282120395328
0,33649,15,一番くじ妖怪ウォッチスター登場ＵＳＡピョン,613009,0.57372061245882
0,16370,16,一番くじ妖怪ウォッチスター登場ＵＳＡピョン,629379,0.5890414420485175
0,15765,17,一番くじ妖怪ウォッチスター登場ＵＳＡピョン,645144,0.6037960467205751
0,14985,18,一番くじ妖怪ウォッチスター登場ＵＳＡピョン,660129,0.6178206424079066
0,12527,19,一番くじ妖怪ウォッチスター登場ＵＳＡピョン,672656,0.6295447738843966
0,14707,20,一番くじ妖怪ウォッチスター登場ＵＳＡピョン,687363,0.6433091868823001
0,22365,21,一番くじ妖怪ウォッチスター登場ＵＳＡピョン,709728,0.664240790655885
0,21786,22,一番くじ妖怪ウォッチスター登場ＵＳＡピョン,731514,0.6846305031446541
0,18252,23,一番くじ妖怪ウォッチスター登場ＵＳＡピョン,749766,0.7017127133872417
0,16326,24,一番くじ妖怪ウォッチスター登場ＵＳＡピョン,766092,0.716992362982929
0,13115,25,一番くじ妖怪ウォッチスター登場ＵＳＡピョン,779207,0.7292668089248278
0,7006,26,一番くじ妖怪ウォッチスター登場ＵＳＡピョン,786213,0.7358237870619946
0,8023,27,一番くじ妖怪ウォッチスター登場ＵＳＡピョン,794236,0.7433325846061695
0,12878,28,一番くじ妖怪ウォッチスター登場ＵＳＡピョン,807114,0.7553852201257861
0,11749,29,一番くじ妖怪ウォッチスター登場ＵＳＡピョン,818863,0.7663812144354597
0,6586,30,一番くじ妖怪ウォッチスター登場ＵＳＡピョン,825449,0.7725451108116203
0,5544,31,一番くじ妖怪ウォッチスター登場ＵＳＡピョン,830993,0.7777337900569032
0,5804,32,一番くじ妖怪ウォッチスター登場ＵＳＡピョン,836797,0.7831658056304283
0,5180,33,一番くじ妖怪ウォッチスター登場ＵＳＡピョン,841977,0.7880138140161725
0,6110,34,一番くじ妖怪ウォッチスター登場ＵＳＡピョン,848087,0.7937322177298592
0,9517,35,一番くじ妖怪ウォッチスター登場ＵＳＡピョン,857604,0.8026392632524708
0,8574,36,一番くじ妖怪ウォッチスター登場ＵＳＡピョン,866178,0.8106637466307277
0,4655,37,一番くじ妖怪ウォッチスター登場ＵＳＡピョン,870833,0.8150204028152142
0,3961,38,一番くじ妖怪ウォッチスター登場ＵＳＡピョン,874794,0.8187275381850854
0,3905,39,一番くじ妖怪ウォッチスター登場ＵＳＡピョン,878699,0.822382262653489
0,3760,40,一番くじ妖怪ウォッチスター登場ＵＳＡピョン,882459,0.8259012803234501
0,4633,41,一番くじ妖怪ウォッチスター登場ＵＳＡピョン,887092,0.8302373465109314
0,6628,42,一番くじ妖怪ウォッチスター登場ＵＳＡピョン,893720,0.8364405510631926
0,5348,43,一番くじ妖怪ウォッチスター登場ＵＳＡピョン,899068,0.8414457921533394
0,4701,44,一番くじ妖怪ウォッチスター登場ＵＳＡピョン,903769,0.8458455001497455
0,2776,45,一番くじ妖怪ウォッチスター登場ＵＳＡピョン,906545,0.848443583408206
0,2502,46,一番くじ妖怪ウォッチスター登場ＵＳＡピョン,909047,0.8507852276130577
0,3019,47,一番くじ妖怪ウォッチスター登場ＵＳＡピョン,912066,0.8536107367475292
0,3319,48,一番くじ妖怪ウォッチスター登場ＵＳＡピョン,915385,0.8567170185684336
0,4975,49,一番くじ妖怪ウォッチスター登場ＵＳＡピョン,920360,0.8613731656184487
0,4370,50,一番くじ妖怪ウォッチスター登場ＵＳＡピョン,924730,0.8654630877508236
0,2217,51,一番くじ妖怪ウォッチスター登場ＵＳＡピョン,926947,0.8675379979035639
0,2087,52,一番くじ妖怪ウォッチスター登場ＵＳＡピョン,929034,0.8694912398921832
0,2378,53,一番くじ妖怪ウォッチスター登場ＵＳＡピョン,931412,0.8717168313866427
0,1897,54,一番くじ妖怪ウォッチスター登場ＵＳＡピョン,933309,0.8734922506738545
0,2360,55,一番くじ妖怪ウォッチスター登場ＵＳＡピョン,935669,0.8757009958071279
0,3487,56,一番くじ妖怪ウォッチスター登場ＵＳＡピョン,939156,0.8789645103324348
0,2796,57,一番くじ妖怪ウォッチスター登場ＵＳＡピョン,941952,0.881581311769991
0,1871,58,一番くじ妖怪ウォッチスター登場ＵＳＡピョン,943823,0.8833323974243785
0,1527,59,一番くじ妖怪ウォッチスター登場ＵＳＡピョン,945350,0.8847615303983228
0,1563,0,一番くじ白猫プロジェクト,1563,0.005582701127255583
144936,22958,1,一番くじ白猫プロジェクト,24521,0.08758375837583758
134838,23946,2,一番くじ白猫プロジェクト,48467,0.17311373994542312
0,14175,3,一番くじ白猫プロジェクト,62642,0.22374380295172375
66,8277,4,一番くじ白猫プロジェクト,70919,0.2533074736045033
0,9255,5,一番くじ白猫プロジェクト,80174,0.28636435072078636
0,6488,6,一番くじ白猫プロジェクト,86662,0.30953809666680954
66,6578,7,一番くじ白猫プロジェクト,93240,0.33303330333033304
0,9119,8,一番くじ白猫プロジェクト,102359,0.3656044175846156
0,8324,9,一番くじ白猫プロジェクト,110683,0.3953359621676453
0,8486,10,一番くじ白猫プロジェクト,119169,0.42564613604217566
0,5157,11,一番くじ白猫プロジェクト,124326,0.4440658351549441
0,4692,12,一番くじ白猫プロジェクト,129018,0.4608246538939608
0,3976,13,一番くじ白猫プロジェクト,132994,0.475026074035975
0,3898,14,一番くじ白猫プロジェクト,136892,0.48894889488948895
0,4825,15,一番くじ白猫プロジェクト,141717,0.5061827611332562
0,5019,16,一番くじ白猫プロジェクト,146736,0.5241095538125241
0,3825,17,一番くじ白猫プロジェクト,150561,0.5377716343062878
66,2627,18,一番くじ白猫プロジェクト,153188,0.5471547154715471
0,2310,19,一番くじ白猫プロジェクト,155498,0.5554055405540554
0,2019,20,一番くじ白猫プロジェクト,157517,0.5626169759833126
0,2382,21,一番くじ白猫プロジェクト,159899,0.5711249696398212
0,3274,22,一番くじ白猫プロジェクト,163173,0.5828189961853328
0,2831,23,一番くじ白猫プロジェクト,166004,0.592930721643593
0,2428,24,一番くじ白猫プロジェクト,168432,0.6016030174446017
0,2317,25,一番くじ白猫プロジェクト,170749,0.6098788450273599
0,1793,26,一番くじ白猫プロジェクト,172542,0.6162830568771163
0,1730,27,一番くじ白猫プロジェクト,174272,0.6224622462246224
0,2037,28,一番くじ白猫プロジェクト,176309,0.6297379737973797
0,1985,29,一番くじ白猫プロジェクト,178294,0.6368279685111369
0,1685,30,一番くじ白猫プロジェクト,179979,0.6428464274998928
0,1515,31,一番くじ白猫プロジェクト,181494,0.6482576829111483
0,1449,32,一番くじ白猫プロジェクト,182943,0.6534332004629034
0,1419,33,一番くじ白猫プロジェクト,184362,0.6585015644421585
0,1162,34,一番くじ白猫プロジェクト,185524,0.6626519794836626
0,1487,35,一番くじ白猫プロジェクト,187011,0.667963224893918
0,1852,36,一番くじ白猫プロジェクト,188863,0.6745781721029246
0,1913,37,一番くじ白猫プロジェクト,190776,0.6814109982426814
0,1482,38,一番くじ白猫プロジェクト,192258,0.6867043847241867
0,1159,39,一番くじ白猫プロジェクト,193417,0.6908440844084408
0,1013,40,一番くじ白猫プロジェクト,194430,0.6944623033731945
0,926,41,一番くじ白猫プロジェクト,195356,0.6977697769776978
0,792,42,一番くじ白猫プロジェクト,196148,0.7005986312917006
0,1356,43,一番くじ白猫プロジェクト,197504,0.7054419727687055
0,1268,44,一番くじ白猫プロジェクト,198772,0.70997099709971
0,965,45,一番くじ白猫プロジェクト,199737,0.7134177703484634
0,760,46,一番くじ白猫プロジェクト,200497,0.7161323275184661
0,901,47,一番くじ白猫プロジェクト,201398,0.7193505064792194
0,831,48,一番くじ白猫プロジェクト,202229,0.7223186604374723
0,598,49,一番くじ白猫プロジェクト,202827,0.7244545883159744
0,972,50,一番くじ白猫プロジェクト,203799,0.7279263640649779
0,948,51,一番くじ白猫プロジェクト,204747,0.7313124169559813
0,638,52,一番くじ白猫プロジェクト,205385,0.7335912162644835
0,573,53,一番くじ白猫プロジェクト,205958,0.7356378494992356
0,485,54,一番くじ白猫プロジェクト,206443,0.7373701655879874
0,850,55,一番くじ白猫プロジェクト,207293,0.7404061834754904
0,724,56,一番くじ白猫プロジェクト,208017,0.742992156358493
0,1198,57,一番くじ白猫プロジェクト,209215,0.7472711556869973
0,1007,58,一番くじ白猫プロジェクト,210222,0.7508679439372509
0,560,59,一番くじ白猫プロジェクト,210782,0.7528681439572529
0,7198,0,一番くじドラゴンボールバトルオブワールド,7198,0.006853606284218043
514869,83214,1,一番くじドラゴンボールバトルオブワールド,90412,0.08608616995953344
534721,128767,2,一番くじドラゴンボールバトルオブワールド,219179,0.2086922161390145
198,123463,3,一番くじドラゴンボールバトルオブワールド,342642,0.32624803618186143
132,136367,4,一番くじドラゴンボールバトルオブワールド,479009,0.4560904546536539
66,112006,5,一番くじドラゴンボールバトルオブワールド,591015,0.5627374434658414
0,60268,6,一番くじドラゴンボールバトルオブワールド,651283,0.6201218757438705
0,47834,7,一番くじドラゴンボールバトルオブワールド,699117,0.6656672220899785
0,41230,8,一番くじドラゴンボールバトルオブワールド,740347,0.7049245417757677
66,39496,9,一番くじドラゴンボールバトルオブワールド,779843,0.742530825993811
132,32928,10,一番くじドラゴンボールバトルオブワールド,812771,0.773883361104499
0,36464,11,一番くじドラゴンボールバトルオブワールド,849235,0.8086027136396097
0,29481,12,一番くじドラゴンボールバトルオブワールド,878716,0.8366731730540348
0,15074,13,一番くじドラゴンボールバトルオブワールド,893790,0.851025946203285
0,12384,14,一番くじドラゴンボールバトルオブワールド,906174,0.8628174244227564
0,13651,15,一番くじドラゴンボールバトルオブワールド,919825,0.8758152820756963
0,8798,16,一番くじドラゴンボールバトルオブワールド,928623,0.8841923351582957
0,9052,17,一番くじドラゴンボールバトルオブワールド,937675,0.8928112354201381
0,10886,18,一番くじドラゴンボールバトルオブワールド,948561,0.9031763865746251
0,8891,19,一番くじドラゴンボールバトルオブワールド,957452,0.9116419900023803
0,4823,20,一番くじドラゴンボールバトルオブワールド,962275,0.9162342299452512
0,4201,21,一番くじドラゴンボールバトルオブワールド,966476,0.9202342299452512
0,3865,22,一番くじドラゴンボールバトルオブワールド,970341,0.9239143061175911
0,3637,23,一番くじドラゴンボールバトルオブワールド,973978,0.9273772911211616
0,3886,24,一番くじドラゴンボールバトルオブワールド,977864,0.9310773625327303
0,4934,25,一番くじドラゴンボールバトルオブワールド,982798,0.9357752915972387
0,4242,26,一番くじドラゴンボールバトルオブワールド,987040,0.9398143299214473
0,2567,27,一番くじドラゴンボールバトルオブワールド,989607,0.9422585098786004
0,1973,28,一番くじドラゴンボールバトルオブワールド,991580,0.9441371102118543
0,1897,29,一番くじドラゴンボールバトルオブワールド,993477,0.9459433468221852
0,1811,30,一番くじドラゴンボールバトルオブワールド,995288,0.9476676981671031
0,1772,31,一番くじドラゴンボールバトルオブワールド,997060,0.9493549154963103
0,2204,32,一番くじドラゴンボールバトルオブワールド,999264,0.9514534634610807
0,1797,33,一番くじドラゴンボールバトルオブワールド,1001061,0.9531644846465127
0,1085,34,一番くじドラゴンボールバトルオブワールド,1002146,0.9541975720066651
0,1120,35,一番くじドラゴンボールバトルオブワールド,1003266,0.955263984765532
0,1156,36,一番くじドラゴンボールバトルオブワールド,1004422,0.9563646750773626
0,1385,37,一番くじドラゴンボールバトルオブワールド,1005807,0.9576834087122114
0,1699,38,一番くじドラゴンボールバトルオブワールド,1007506,0.9593011187812426
0,1344,39,一番くじドラゴンボールバトルオブワールド,1008850,0.9605808140918829
0,1277,40,一番くじドラゴンボールバトルオブワールド,1010127,0.961796715067841
0,647,41,一番くじドラゴンボールバトルオブワールド,1010774,0.9624127588669364
0,560,42,一番くじドラゴンボールバトルオブワールド,1011334,0.9629459652463699
0,718,43,一番くじドラゴンボールバトルオブワールド,1012052,0.9636296119971436
0,584,44,一番くじドラゴンボールバトルオブワールド,1012636,0.9641856700785527
0,890,45,一番くじドラゴンボールバトルオブワールド,1013526,0.9650330873601524
0,987,46,一番くじドラゴンボールバトルオブワールド,1014513,0.9659728636039039
0,1143,47,一番くじドラゴンボールバトルオブワールド,1015656,0.9670611759104975
0,595,48,一番くじドラゴンボールバトルオブワールド,1016251,0.9676277076886456
0,513,49,一番くじドラゴンボールバトルオブワールド,1016764,0.9681161628183765
0,566,50,一番くじドラゴンボールバトルオブワールド,1017330,0.968655082123304
0,499,51,一番くじドラゴンボールバトルオブワールド,1017829,0.9691302070935491
0,573,52,一番くじドラゴンボールバトルオブワールド,1018402,0.9696757914782195
0,585,53,一番くじドラゴンボールバトルオブワールド,1018987,0.9702328017138776
0,667,54,一番くじドラゴンボールバトルオブワールド,1019654,0.9708678885979529
0,396,55,一番くじドラゴンボールバトルオブワールド,1020050,0.9712449416805522
0,378,56,一番くじドラゴンボールバトルオブワールド,1020428,0.9716048559866698
0,383,57,一番くじドラゴンボールバトルオブワールド,1020811,0.9719695310640324
0,324,58,一番くじドラゴンボールバトルオブワールド,1021135,0.9722780290407046
0,500,59,一番くじドラゴンボールバトルオブワールド,1021635,0.9727541061651988
30,146,0,一番くじリトルマジックディズニー,146,0.0017781025453659724
38640,1654,1,一番くじリトルマジックディズニー,1800,0.021921812203142127
43440,3765,2,一番くじリトルマジックディズニー,5565,0.06777493606138107
0,3973,3,一番くじリトルマジックディズニー,9538,0.11616124710753867
0,3161,4,一番くじリトルマジックディズニー,12699,0.1546583850931677
0,2462,5,一番くじリトルマジックディズニー,15161,0.1846425526732432
0,2661,6,一番くじリトルマジックディズニー,17822,0.21705029838022166
0,1828,7,一番くじリトルマジックディズニー,19650,0.2393131165509682
0,2319,8,一番くじリトルマジックディズニー,21969,0.2675557179393497
0,2385,9,一番くじリトルマジックディズニー,24354,0.296602119108513
0,2251,10,一番くじリトルマジックディズニー,26605,0.32401656314699795
0,2077,11,一番くじリトルマジックディズニー,28682,0.3493118986725125
0,1900,12,一番くじリトルマジックディズニー,30582,0.3724515893313847
0,1583,13,一番くじリトルマジックディズニー,32165,0.3917306052855925
0,1279,14,一番くじリトルマジックディズニー,33444,0.4073072707343807
0,1040,15,一番くじリトルマジックディズニー,34484,0.4199732066739739
0,1211,16,一番くじリトルマジックディズニー,35695,0.43472171477286564
0,1361,17,一番くじリトルマジックディズニー,37056,0.4512970405553526
0,1322,18,一番くじリトルマジックディズニー,38378,0.46739739374010475
0,875,19,一番くじリトルマジックディズニー,39253,0.4780538302277433
0,901,20,一番くじリトルマジックディズニー,40154,0.48902691511387164
0,889,21,一番くじリトルマジックディズニー,41043,0.4998538545853124
0,823,22,一番くじリトルマジックディズニー,41866,0.5098769942759712
0,938,23,一番くじリトルマジックディズニー,42804,0.5213006941907198
0,1179,24,一番くじリトルマジックディズニー,43983,0.5356594811837778
0,1047,25,一番くじリトルマジックディズニー,45030,0.5484106686152722
0,692,26,一番くじリトルマジックディズニー,45722,0.5568383875289246
0,695,27,一番くじリトルマジックディズニー,46417,0.565302642796249
0,652,28,一番くじリトルマジックディズニー,47069,0.5732432103276093
0,625,29,一番くじリトルマジックディズニー,47694,0.5808549506759225
0,730,30,一番くじリトルマジックディズニー,48424,0.5897454634027524
0,616,31,一番くじリトルマジックディズニー,49040,0.59724759469005
0,618,32,一番くじリトルマジックディズニー,49658,0.6047740835464621
0,496,33,一番くじリトルマジックディズニー,50154,0.6108147606868835
0,389,34,一番くじリトルマジックディズニー,50543,0.6155523078796736
0,346,35,一番くじリトルマジックディズニー,50889,0.6197661673364998
0,368,36,一番くじリトルマジックディズニー,51257,0.6242479600535866
0,410,37,一番くじリトルマジックディズニー,51667,0.6292412617220802
0,473,38,一番くじリトルマジックディズニー,52140,0.6350018268176836
0,448,39,一番くじリトルマジックディズニー,52588,0.6404579222993545
0,310,40,一番くじリトルマジックディズニー,52898,0.6442333455121179
0,290,41,一番くじリトルマジックディズニー,53188,0.6477651930337353
0,257,42,一番くじリトルマジックディズニー,53445,0.6508951406649617
0,254,43,一番くじリトルマジックディズニー,53699,0.6539885519425161
0,258,44,一番くじリトルマジックディズニー,53957,0.6571306783582999
0,421,45,一番くじリトルマジックディズニー,54378,0.6622579466569236
0,391,46,一番くじリトルマジックディズニー,54769,0.6670198514188284
0,317,47,一番くじリトルマジックディズニー,55086,0.6708805261234929
0,264,48,一番くじリトルマジックディズニー,55350,0.6740957252466204
0,254,49,一番くじリトルマジックディズニー,55604,0.6771891365241749
0,350,50,一番くじリトルマジックディズニー,55954,0.6814517111192303
0,351,51,一番くじリトルマジックディズニー,56305,0.685726464498843
0,540,52,一番くじリトルマジックディズニー,56845,0.6923030081597856
0,431,53,一番くじリトルマジックディズニー,57276,0.6975520643039824
0,287,54,一番くじリトルマジックディズニー,57563,0.7010473754719279
0,330,55,一番くじリトルマジックディズニー,57893,0.7050663743758373
0,300,56,一番くじリトルマジックディズニー,58193,0.7087200097430276
0,302,57,一番くじリトルマジックディズニー,58495,0.7123980026793326
0,298,58,一番くじリトルマジックディズニー,58793,0.7160272804774084
0,348,59,一番くじリトルマジックディズニー,59141,0.7202654975033491
0,2029,0,一番くじアナと雪の女王エルサのサプライズ,2029,0.002427440001914196
413100,23369,1,一番くじアナと雪の女王エルサのサプライズ,25398,0.030385471251166463
422520,53039,2,一番くじアナと雪の女王エルサのサプライズ,78437,0.09383987749144594
120,47176,3,一番くじアナと雪の女王エルサのサプライズ,125613,0.150279951187998
60,34381,4,一番くじアナと雪の女王エルサのサプライズ,159994,0.19141243748953174
0,29947,5,一番くじアナと雪の女王エルサのサプライズ,189941,0.22724020769028305
60,26781,6,一番くじアナと雪の女王エルサのサプライズ,216722,0.25928026224487355
0,23894,7,一番くじアナと雪の女王エルサのサプライズ,240616,0.2878663891082239
0,24931,8,一番くじアナと雪の女王エルサのサプライズ,265547,0.31769315435599266
0,34203,9,一番くじアナと雪の女王エルサのサプライズ,299750,0.3586126863350322
0,28878,10,一番くじアナと雪の女王エルサのサプライズ,328628,0.39316153422822003
0,16632,11,一番くじアナと雪の女王エルサのサプライズ,345260,0.4130596032828464
0,14640,12,一番くじアナと雪の女王エルサのサプライズ,359900,0.430574498121695
0,14911,13,一番くじアナと雪の女王エルサのサプライズ,374811,0.44841360993467805
0,16449,14,一番くじアナと雪の女王エルサのサプライズ,391260,0.4680927428038188
0,15617,15,一番くじアナと雪の女王エルサのサプライズ,406877,0.48677649367118897
0,22594,16,一番くじアナと雪の女王エルサのサプライズ,429471,0.5138073361567727
0,19385,17,一番くじアナと雪の女王エルサのサプライズ,448856,0.5369990189744694
0,11458,18,一番くじアナと雪の女王エルサのサプライズ,460314,0.5507070562055847
0,10939,19,一番くじアナと雪の女王エルサのサプライズ,471253,0.5637941760581916
0,10699,20,一番くじアナと雪の女王エルサのサプライズ,481952,0.5765941664872107
0,9613,21,一番くじアナと雪の女王エルサのサプライズ,491565,0.5880948962744957
0,8815,22,一番くじアナと雪の女王エルサのサプライズ,500380,0.5986409207283516
0,10419,23,一番くじアナと雪の女王エルサのサプライズ,510799,0.6111059268298519
0,8853,24,一番くじアナと雪の女王エルサのサプライズ,519652,0.6216974134424426
0,5816,25,一番くじアナと雪の女王エルサのサプライズ,525468,0.6286555164740507
0,5367,26,一番くじアナと雪の女王エルサのサプライズ,530835,0.6350764482090302
0,5239,27,一番くじアナと雪の女王エルサのサプライズ,536074,0.6413442442514297
0,5050,28,一番くじアナと雪の女王エルサのサプライズ,541124,0.6473859258727538
0,6155,29,一番くじアナと雪の女王エルサのサプライズ,547279,0.6547495992151796
0,8114,30,一番くじアナと雪の女王エルサのサプライズ,555393,0.6644569664776397
0,7422,31,一番くじアナと雪の女王エルサのサプライズ,562815,0.6733364439020889
0,4330,32,一番くじアナと雪の女王エルサのサプライズ,567145,0.6785167372526499
0,4534,33,一番くじアナと雪の女王エルサのサプライズ,571679,0.6839410906132606
0,4774,34,一番くじアナと雪の女王エルサのサプライズ,576453,0.6896525733974589
0,4623,35,一番くじアナと雪の女王エルサのサプライズ,581076,0.6951834039193167
0,5283,36,一番くじアナと雪の女王エルサのサプライズ,586359,0.7015038403560405
0,5979,37,一番くじアナと雪の女王エルサのサプライズ,592338,0.7086569521211686
0,5986,38,一番くじアナと雪の女王エルサのサプライズ,598324,0.7158184384944847
0,4527,39,一番くじアナと雪の女王エルサのサプライズ,602851,0.7212344172469074
0,3379,40,一番くじアナと雪の女王エルサのサプライズ,606230,0.7252769602565022
0,3261,41,一番くじアナと雪の女王エルサのサプライズ,609491,0.7291783312994999
0,3370,42,一番くじアナと雪の女王エルサのサプライズ,612861,0.7332101069557103
0,3892,43,一番くじアナと雪の女王エルサのサプライズ,616753,0.7378663891082239
0,4636,44,一番くじアナと雪の女王エルサのサプライズ,621389,0.7434127724738593
0,4131,45,一番くじアナと雪の女王エルサのサプライズ,625520,0.7483549876773622
0,2929,46,一番くじアナと雪の女王エルサのサプライズ,628449,0.7518591630177303
0,3079,47,一番くじアナと雪の女王エルサのサプライズ,631528,0.7555427942478405
0,3118,48,一番くじアナと雪の女王エルサのサプライズ,634646,0.7592730840092838
0,2918,49,一番くじアナと雪の女王エルサのサプライズ,637564,0.7627640992510708
0,3358,50,一番くじアナと雪の女王エルサのサプライズ,640922,0.7667815184361018
0,3492,51,一番くじアナと雪の女王エルサのサプライズ,644414,0.7709592515493026
0,3492,52,一番くじアナと雪の女王エルサのサプライズ,647906,0.7751369846625032
0,2453,53,一番くじアナと雪の女王エルサのサプライズ,650359,0.7780716866460891
0,2432,54,一番くじアナと雪の女王エルサのサプライズ,652791,0.7809812648051109
0,2543,55,一番くじアナと雪の女王エルサのサプライズ,655334,0.784023640322542
0,2407,56,一番くじアナと雪の女王エルサのサプライズ,657741,0.7869033091666069
0,2593,57,一番くじアナと雪の女王エルサのサプライズ,660334,0.7900055033139521
0,2687,58,一番くじアナと雪の女王エルサのサプライズ,663021,0.7932201564855359
0,2743,59,一番くじアナと雪の女王エルサのサプライズ,665764,0.7965018065226234
396,3440,0,一番くじミッキー＆フレンズハロウィンサーカス,3440,0.003730659404894755
457842,50386,1,一番くじミッキー＆フレンズハロウィンサーカス,53826,0.058373974746472414
463653,93592,2,一番くじミッキー＆フレンズハロウィンサーカス,147418,0.15987393841592298
66,90016,3,一番くじミッキー＆フレンズハロウィンサーカス,237434,0.2574957514947039
0,69531,4,一番くじミッキー＆フレンズハロウィンサーカス,306965,0.3329017047161391
0,47061,5,一番くじミッキー＆フレンズハロウィンサーカス,354026,0.3839390774643229
0,41032,6,一番くじミッキー＆フレンズハロウィンサーカス,395058,0.4284380358078233
0,36371,7,一番くじミッキー＆フレンズハロウィンサーカス,431429,0.467882167556494
66,30487,8,一番くじミッキー＆フレンズハロウィンサーカス,461916,0.5009451365323738
0,29008,9,一番くじミッキー＆フレンズハロウィンサーカス,490924,0.5324041388629515
0,33346,10,一番くじミッキー＆フレンズハロウィンサーカス,524270,0.5685676762221434
0,23962,11,一番くじミッキー＆フレンズハロウィンサーカス,548232,0.5945543217628667
0,17083,12,一番くじミッキー＆フレンズハロウィンサーカス,565315,0.6130807329878135
0,16306,13,一番くじミッキー＆フレンズハロウィンサーカス,581621,0.63076449236462
66,15049,14,一番くじミッキー＆フレンズハロウィンサーカス,596670,0.6470850427670214
0,12971,15,一番くじミッキー＆フレンズハロウィンサーカス,609641,0.6611520146103034
0,14686,16,一番くじミッキー＆フレンズハロウィンサーカス,624327,0.6770788936859674
0,16422,17,一番くじミッキー＆フレンズハロウィンサーカス,640749,0.6948884543682876
0,14493,18,一番くじミッキー＆フレンズハロウィンサーカス,655242,0.7106060260994329
0,9409,19,一番くじミッキー＆フレンズハロウィンサーカス,664651,0.7208100302682279
0,7639,20,一番くじミッキー＆フレンズハロウィンサーカス,672290,0.729094480033923
0,7701,21,一番くじミッキー＆フレンズハロウィンサーカス,679991,0.7374461684284271
0,7320,22,一番くじミッキー＆フレンズハロウィンサーカス,687311,0.745384664603959
0,7114,23,一番くじミッキー＆フレンズハロウィンサーカス,694425,0.7530997550128025
0,9011,24,一番くじミッキー＆フレンズハロウィンサーカス,703436,0.7628721305644032
0,8250,25,一番くじミッキー＆フレンズハロウィンサーカス,711686,0.7718192061720723
0,5129,26,一番くじミッキー＆フレンズハロウィンサーカス,716815,0.7773815759650099
0,4774,27,一番くじミッキー＆フレンズハロウィンサーカス,721589,0.7825589503833144
0,4591,28,一番くじミッキー＆フレンズハロウィンサーカス,726180,0.7875378623972307
0,4481,29,一番くじミッキー＆フレンズハロウィンサーカス,730661,0.7923974800697112
0,5581,30,一番くじミッキー＆フレンズハロウィンサーカス,736242,0.7984500411565478
0,6967,31,一番くじミッキー＆フレンズハロウィンサーカス,743209,0.8060057109454727
0,6125,32,一番くじミッキー＆フレンズハロウィンサーカス,749334,0.8126482367754089
0,3980,33,一番くじミッキー＆フレンズハロウィンサーカス,753314,0.8169645229473511
0,3997,34,一番くじミッキー＆フレンズハロウィンサーカス,757311,0.8212992455175151
0,4485,35,一番くじミッキー＆フレンズハロウィンサーカス,761796,0.8261632011660479
0,4642,36,一番くじミッキー＆フレンズハロウィンサーカス,766438,0.8311974223746298
0,5189,37,一番くじミッキー＆フレンズハロウィンサーカス,771627,0.8368248618083504
0,5233,38,一番くじミッキー＆フレンズハロウィンサーカス,776860,0.8425000189786452
0,4518,39,一番くじミッキー＆フレンズハロウィンサーカス,781378,0.8473997629296087
0,3742,40,一番くじミッキー＆フレンズハロウィンサーカス,785120,0.8514579395264449
0,2524,41,一番くじミッキー＆フレンズハロウィンサーカス,787644,0.854195202415385
0,2311,42,一番くじミッキー＆フレンズハロウィンサーカス,789955,0.8567014680795455
0,2364,43,一番くじミッキー＆フレンズハロウィンサーカス,792319,0.8592652119263976
0,2295,44,一番くじミッキー＆フレンズハロウィンサーカス,794614,0.8617541256863491
0,2607,45,一番くじミッキー＆フレンズハロウィンサーカス,797221,0.8645814015783726
0,2360,46,一番くじミッキー＆フレンズハロウィンサーカス,799581,0.8671408074491724
0,1950,47,一番くじミッキー＆フレンズハロウィンサーカス,801531,0.8692555707746216
0,1656,48,一番くじミッキー＆フレンズハロウィンサーカス,803187,0.8710514928602336
0,1587,49,一番くじミッキー＆フレンズハロウィンサーカス,804774,0.8727725848589453
0,1436,50,一番くじミッキー＆フレンズハロウィンサーカス,806210,0.8743299182616863
0,1941,51,一番くじミッキー＆フレンズハロウィンサーカス,808151,0.8764349211410178
0,1585,52,一番くじミッキー＆フレンズハロウィンサーカス,809736,0.8781538441517034
0,1314,53,一番くじミッキー＆フレンズハロウィンサーカス,811050,0.8795788692848521
0,857,54,一番くじミッキー＆フレンズハロウィンサーカス,811907,0.8805082806540366
0,944,55,一番くじミッキー＆フレンズハロウィンサーカス,812851,0.8815320430023567
0,949,56,一番くじミッキー＆フレンズハロウィンサーカス,813800,0.8825612278207419
0,904,57,一番くじミッキー＆フレンズハロウィンサーカス,814704,0.8835416104085397
0,821,58,一番くじミッキー＆フレンズハロウィンサーカス,815525,0.8844319799932544
0,1171,59,一番くじミッキー＆フレンズハロウィンサーカス,816696,0.885701922482537
360,2635,0,一番くじ仮面ライダーライダーマシーンズ編,2635,0.0024410353324810555
546030,36854,1,一番くじ仮面ライダーライダーマシーンズ編,39489,0.036582179978878325
532710,72720,2,一番くじ仮面ライダーライダーマシーンズ編,112209,0.10394919682063254
90,75960,3,一番くじ仮面ライダーライダーマシーンズ編,188169,0.17431771441276195
90,69268,4,一番くじ仮面ライダーライダーマシーンズ編,257437,0.2384868360105979
0,64116,5,一番くじ仮面ライダーライダーマシーンズ編,321553,0.2978832008596891
90,63276,6,一番くじ仮面ライダーライダーマシーンズ編,384829,0.3565013988475719
0,70721,7,一番くじ仮面ライダーライダーマシーンズ編,455550,0.42201656383747427
90,55145,8,一番くじ仮面ライダーライダーマシーンズ編,510695,0.47310229188668407
0,48343,9,一番くじ仮面ライダーライダーマシーンズ編,559038,0.517886721138347
0,40821,10,一番くじ仮面ライダーライダーマシーンズ編,599859,0.5557028514257129
0,35654,11,一番くじ仮面ライダーライダーマシーンズ編,635513,0.5887323291275267
0,25607,12,一番くじ仮面ライダーライダーマシーンズ編,661120,0.612454375335816
0,23793,13,一番くじ仮面ライダーライダーマシーンズ編,684913,0.6344959516795434
0,19110,14,一番くじ仮面ライダーライダーマシーンズ編,704023,0.6521992477720342
0,18656,15,一番くじ仮面ライダーライダーマシーンズ編,722679,0.6694819632038241
0,19529,16,一番くじ仮面ライダーライダーマシーンズ編,742208,0.6875734163377986
0,24203,17,一番くじ仮面ライダーライダーマシーンズ編,766411,0.7099948122209253
0,21846,18,一番くじ仮面ライダーライダーマシーンズ編,788257,0.7302327089470662
0,18098,19,一番くじ仮面ライダーライダーマシーンズ編,806355,0.7469984992496248
0,10756,20,一番くじ仮面ライダーライダーマシーンズ編,817111,0.756962740629574
0,11238,21,一番くじ仮面ライダーライダーマシーンズ編,828349,0.7673735015655976
0,10224,22,一番くじ仮面ライダーライダーマシーンズ編,838573,0.7768449039334482
0,9828,23,一番くじ仮面ライダーライダーマシーンズ編,848401,0.7859494562095862
0,13232,24,一番くじ仮面ライダーライダーマシーンズ編,861633,0.7982074370518593
0,11456,25,一番くじ仮面ライダーライダーマシーンズ編,873089,0.8088201508161488
0,7373,26,一番くじ仮面ライダーライダーマシーンズ編,880462,0.8156504178014934
0,7089,27,一番くじ仮面ライダーライダーマシーンズ編,887551,0.8222175902766198
0,6918,28,一番くじ仮面ライダーライダーマシーンズ編,894469,0.8286263502121431
0,6551,29,一番くじ仮面ライダーライダーマシーンズ編,901020,0.834695125340448
0,7910,30,一番くじ仮面ライダーライダーマシーンズ編,908930,0.8420228632834936
0,9443,31,一番くじ仮面ライダーライダーマシーンズ編,918373,0.8507707557482445
0,8435,32,一番くじ仮面ライダーライダーマシーンズ編,926808,0.8585848479795454
0,5200,33,一番くじ仮面ライダーライダーマシーンズ編,932008,0.8634020714060734
0,4764,34,一番くじ仮面ライダーライダーマシーンズ編,936772,0.8678153891760695
0,4342,35,一番くじ仮面ライダーライダーマシーンズ編,941114,0.8718377707372205
0,3864,36,一番くじ仮面ライダーライダーマシーンズ編,944978,0.875417338298779
0,4275,37,一番くじ仮面ライダーライダーマシーンズ編,949253,0.8793776517888574
0,5790,38,一番くじ仮面ライダーライダーマシーンズ編,955043,0.8847414447964723
0,4314,39,一番くじ仮面ライダーライダーマシーンズ編,959357,0.8887378874622497
0,2976,40,一番くじ仮面ライダーライダーマシーンズ編,962333,0.8914948214848165
0,2389,41,一番くじ仮面ライダーライダーマシーンズ編,964722,0.8937079650936579
0,2256,42,一番くじ仮面ライダーライダーマシーンズ編,966978,0.8957978989494747
0,2112,43,一番くじ仮面ライダーライダーマシーンズ編,969090,0.8977544327719416
0,2222,44,一番くじ仮面ライダーライダーマシーンズ編,971312,0.8998128693976618
0,2255,45,一番くじ仮面ライダーライダーマシーンズ編,973567,0.9019018768643581
0,2478,46,一番くじ仮面ライダーライダーマシーンズ編,976045,0.9041974691049228
0,2028,47,一番くじ仮面ライダーライダーマシーンズ編,978073,0.9060761862412687
0,2762,48,一番くじ仮面ライダーライダーマシーンズ編,980835,0.9086348729920516
0,1702,49,一番くじ仮面ライダーライダーマシーンズ編,982537,0.9102115872751191
0,1775,50,一番くじ仮面ライダーライダーマシーンズ編,984312,0.911855927963982
0,1694,51,一番くじ仮面ライダーライダーマシーンズ編,986006,0.9134252311340856
0,1994,52,一番くじ仮面ライダーライダーマシーンズ編,988000,0.915272451040335
0,2372,53,一番くじ仮面ライダーライダーマシーンズ編,990372,0.9174698460341282
0,1758,54,一番くじ仮面ライダーライダーマシーンズ編,992130,0.9190984381079429
0,1602,55,一番くじ仮面ライダーライダーマシーンズ編,993732,0.9205825134789617
0,1678,56,一番くじ仮面ライダーライダーマシーンズ編,995410,0.9221369944231375
0,1468,57,一番くじ仮面ライダーライダーマシーンズ編,996878,0.9234969336520112
0,1704,58,一番くじ仮面ライダーライダーマシーンズ編,998582,0.9250755007133197
0,2089,59,一番くじ仮面ライダーライダーマシーンズ編,1000671,0.9270107275860152
